חודש,"מחוז למ""ס",סמל ישוב,יישוב,"סה""כ דורשי עבודה",גברים,נשים,אקדמאים,אינם אקדמאים,הבטחת הכנסה,דורשי עבודה שאינם עובדים,השמות מתוך הפניות,שיעור אבטלה מוערך ביישוב
2010-01,אזור יהודה והשומרון,3760,אורנית,83,34,49,36,47,4,83,2,2%
2010-01,אזור יהודה והשומרון,3750,אלפי מנשה,88,38,50,26,62,5,88,4,2%
2010-01,אזור יהודה והשומרון,3560,אלקנה,20,12,8,9,11,2,20,2,1%
2010-01,אזור יהודה והשומרון,3650,אפרתה,48,28,20,18,30,8,48,5,1%
2010-01,אזור יהודה והשומרון,3570,אריאל,410,189,221,111,299,156,410,16,4%
2010-01,אזור יהודה והשומרון,3574,בית אל,41,22,19,18,23,15,41,2,2%
2010-01,אזור יהודה והשומרון,3652,בית אריה,59,28,31,10,49,4,59,0,3%
2010-01,אזור יהודה והשומרון,3780,ביתר עילית,318,152,166,13,305,181,313,8,4%
2010-01,אזור יהודה והשומרון,3730,גבעת זאב,153,68,85,25,128,32,153,6,3%
2010-01,אזור יהודה והשומרון,3769,הר אדר,29,14,15,16,13,4,29,2,2%
2010-01,אזור יהודה והשומרון,3797,מודיעין עילית,261,98,163,14,247,93,261,8,3%
2010-01,אזור יהודה והשומרון,3616,מעלה אדומים,590,253,337,93,497,242,584,36,3%
2010-01,אזור יהודה והשומרון,3660,עמנואל,97,55,42,5,92,74,97,2,10%
2010-01,אזור יהודה והשומרון,3557,קדומים,22,11,11,7,15,6,22,2,1%
2010-01,אזור יהודה והשומרון,3611,קריית ארבע,121,64,57,24,97,67,121,4,4%
2010-01,אזור יהודה והשומרון,3640,קרני שומרון,76,42,34,13,63,23,76,3,2%
2010-01,הדרום,31,אופקים,1368,579,789,95,1273,1054,1358,39,12%
2010-01,הדרום,2600,אילת,1534,707,827,73,1461,732,1519,42,5%
2010-01,הדרום,70,אשדוד,7073,2794,4279,823,6250,4675,7025,180,7%
2010-01,הדרום,7100,אשקלון,3890,1604,2286,611,3279,2392,3833,214,7%
2010-01,הדרום,9000,באר שבע,7816,3354,4462,1013,6803,5568,7774,306,8%
2010-01,הדרום,2200,דימונה,2033,898,1135,138,1895,1502,2009,108,12%
2010-01,הדרום,1303,חורה,673,308,365,0,673,612,673,4,22%
2010-01,הדרום,831,ירוחם,428,219,209,32,396,306,419,26,10%
2010-01,הדרום,1059,כסיפה,947,425,522,1,946,853,946,14,26%
2010-01,הדרום,1271,להבים,48,24,24,27,21,3,48,4,2%
2010-01,הדרום,1060,לקיה,899,429,470,5,894,830,897,3,28%
2010-01,הדרום,1268,מיתר,57,25,32,25,32,6,57,5,2%
2010-01,הדרום,99,מצפה רמון,223,85,138,23,200,135,209,28,9%
2010-01,הדרום,246,נתיבות,865,374,491,43,822,538,857,25,7%
2010-01,הדרום,666,עומר,52,19,33,24,28,6,52,4,1%
2010-01,הדרום,2560,ערד,1033,421,612,202,831,736,1014,64,8%
2010-01,הדרום,1192,ערערה-בנגב,902,364,538,3,899,804,901,6,29%
2010-01,הדרום,2630,קריית גת,2478,987,1491,207,2271,1729,2474,107,10%
2010-01,הדרום,1034,קריית מלאכי,1191,525,666,32,1159,865,1180,41,11%
2010-01,הדרום,1161,רהט,2925,1206,1719,8,2917,2605,2922,51,21%
2010-01,הדרום,1286,שגב-שלום,530,220,310,1,529,483,529,5,26%
2010-01,הדרום,1031,שדרות,809,337,472,49,760,443,807,30,7%
2010-01,הדרום,1054,תל שבע,1153,555,598,5,1148,1035,1149,16,30%
2010-01,המרכז,182,אבן יהודה,142,68,74,44,98,24,142,4,2%
2010-01,המרכז,41,אליכין,47,20,27,4,43,13,47,1,3%
2010-01,המרכז,1309,אלעד,362,167,195,34,328,108,360,9,3%
2010-01,המרכז,2530,באר יעקב,238,111,127,36,202,88,232,8,3%
2010-01,המרכז,466,בית דגן,111,61,50,17,94,38,111,4,3%
2010-01,המרכז,1066,"בני עי""ש",189,87,102,37,152,95,185,6,5%
2010-01,המרכז,681,גבעת שמואל,248,121,127,94,154,53,248,15,2%
2010-01,המרכז,2550,גדרה,353,159,194,66,287,121,350,4,4%
2010-01,המרכז,627,ג'לג'וליה,50,26,24,0,50,27,50,0,2%
2010-01,המרכז,166,גן יבנה,325,132,193,42,283,107,324,18,3%
2010-01,המרכז,229,גני תקווה,169,81,88,43,126,25,168,3,2%
2010-01,המרכז,9700,הוד השרון,557,238,319,185,372,61,557,23,2%
2010-01,המרכז,1290,זמר,181,65,116,3,178,136,181,5,7%
2010-01,המרכז,2730,טייבה,2045,878,1167,7,2038,1745,2034,31,14%
2010-01,המרכז,2720,טירה,274,136,138,3,271,177,273,10,3%
2010-01,המרכז,2660,יבנה,959,434,525,69,890,526,953,36,5%
2010-01,המרכז,9400,יהוד,477,196,281,60,417,90,459,20,3%
2010-01,המרכז,1224,כוכב יאיר,85,35,50,47,38,4,85,1,2%
2010-01,המרכז,633,כפר ברא,23,12,11,0,23,9,23,0,2%
2010-01,המרכז,168,כפר יונה,352,146,206,50,302,99,348,17,4%
2010-01,המרכז,6900,כפר סבא,1130,518,612,326,804,260,1124,42,2%
2010-01,המרכז,634,כפר קאסם,175,88,87,2,173,104,175,1,3%
2010-01,המרכז,7000,לוד,2255,946,1309,191,2064,1429,2235,198,7%
2010-01,המרכז,1200,מודיעין-מכבים-רעות*,827,360,467,332,495,81,821,50,2%
2010-01,המרכז,28,מזכרת בתיה,158,70,88,33,125,42,155,0,3%
2010-01,המרכז,7200,נס ציונה,641,276,365,132,509,224,634,5,3%
2010-01,המרכז,7400,נתניה,4514,2028,2486,740,3774,2173,4463,191,5%
2010-01,המרכז,587,סביון*,16,7,9,7,9,1,16,0,1%
2010-01,המרכז,171,פרדסייה,77,31,46,11,66,10,76,2,2%
2010-01,המרכז,7900,פתח תקווה,3890,1742,2148,775,3115,1385,3871,86,4%
2010-01,המרכז,195,קדימה-צורן,235,103,132,70,165,49,233,17,3%
2010-01,המרכז,638,קלנסווה,930,376,554,1,929,763,922,19,13%
2010-01,המרכז,469,קריית עקרון,251,125,126,18,233,129,249,5,5%
2010-01,המרכז,2640,ראש העין,684,335,349,79,605,197,671,56,3%
2010-01,המרכז,8300,ראשון לציון,4459,1971,2488,917,3542,1977,4443,121,4%
2010-01,המרכז,8400,רחובות,2445,1088,1357,519,1926,1114,2412,63,4%
2010-01,המרכז,8500,רמלה,1772,814,958,116,1656,983,1725,86,5%
2010-01,המרכז,8700,רעננה,698,331,367,266,432,103,696,30,2%
2010-01,המרכז,1304,שוהם,165,69,96,80,85,3,165,22,2%
2010-01,המרכז,154,תל מונד,142,57,85,42,100,25,142,8,3%
2010-01,הצפון,473,אבו סנאן,679,257,422,10,669,555,675,4,14%
2010-01,הצפון,478,אכסאל,663,291,372,17,646,552,661,2,14%
2010-01,הצפון,529,אעבלין,669,280,389,12,657,577,669,1,14%
2010-01,הצפון,482,בועיינה-נוג'ידאת,503,214,289,5,498,425,499,1,16%
2010-01,הצפון,4001,בוקעאתא,373,170,203,2,371,308,365,0,16%
2010-01,הצפון,998,ביר אל-מכסור,425,177,248,2,423,324,424,0,14%
2010-01,הצפון,480,בית ג'ן,333,110,223,3,330,242,331,2,8%
2010-01,הצפון,9200,בית שאן,786,335,451,18,768,453,782,47,8%
2010-01,הצפון,944,בסמת טבעון,308,117,191,3,305,243,308,3,11%
2010-01,הצפון,483,בענה,464,193,271,1,463,419,464,1,17%
2010-01,הצפון,1292,ג'דיידה-מכר,1393,595,798,6,1387,1178,1393,9,18%
2010-01,הצפון,485,ג'ולס,182,65,117,6,176,117,182,3,8%
2010-01,הצפון,487,ג'ש (גוש חלב),56,22,34,3,53,31,56,1,4%
2010-01,הצפון,489,דבורייה,421,203,218,14,407,329,421,2,12%
2010-01,הצפון,490,דייר אל-אסד,444,185,259,7,437,359,444,1,11%
2010-01,הצפון,492,דייר חנא,666,298,368,13,653,517,666,4,17%
2010-01,הצפון,975,זרזיר,303,126,177,2,301,217,299,9,12%
2010-01,הצפון,496,חורפיש,138,50,88,7,131,100,138,1,7%
2010-01,הצפון,2034,חצור הגלילית,285,127,158,13,272,155,282,22,7%
2010-01,הצפון,6700,טבריה,1874,833,1041,110,1764,1297,1789,41,9%
2010-01,הצפון,962,טובא-זנגרייה,355,163,192,3,352,266,352,19,13%
2010-01,הצפון,498,טורעאן,565,219,346,11,554,470,563,8,12%
2010-01,הצפון,8900,טמרה,2064,904,1160,20,2044,1832,2059,5,18%
2010-01,הצפון,1295,יאנוח-ג'ת,159,56,103,5,154,115,159,6,8%
2010-01,הצפון,46,יבנאל,109,68,41,6,103,79,103,0,8%
2010-01,הצפון,499,יפיע,684,305,379,14,670,533,679,9,10%
2010-01,הצפון,240,יקנעם עילית,535,190,345,106,429,256,532,35,5%
2010-01,הצפון,502,ירכא,429,175,254,3,426,330,429,3,10%
2010-01,הצפון,504,כאבול,777,365,412,22,755,644,774,0,19%
2010-01,הצפון,505,כאוכב אבו אל-היג'א,230,84,146,5,225,185,230,0,16%
2010-01,הצפון,1296,כסרא-סמיע,248,85,163,4,244,197,247,12,9%
2010-01,הצפון,978,כעביה-טבאש-חג'אג'רה,225,99,126,2,223,159,224,4,12%
2010-01,הצפון,1263,כפר ורדים,58,24,34,26,32,8,58,2,2%
2010-01,הצפון,507,כפר יאסיף,443,187,256,4,439,359,443,5,11%
2010-01,הצפון,508,כפר כמא,91,43,48,4,87,47,89,1,7%
2010-01,הצפון,509,כפר כנא,1238,530,708,13,1225,1048,1223,17,17%
2010-01,הצפון,510,כפר מנדא,880,428,452,13,867,673,869,8,15%
2010-01,הצפון,47,כפר תבור,41,18,23,11,30,6,41,2,2%
2010-01,הצפון,1139,כרמיאל,1729,660,1069,347,1382,1036,1684,60,7%
2010-01,הצפון,481,מגאר,1451,596,855,34,1417,1246,1448,1,20%
2010-01,הצפון,516,מג'ד אל-כרום,694,317,377,9,685,549,693,0,13%
2010-01,הצפון,874,מגדל העמק,975,411,564,93,882,531,952,74,8%
2010-01,הצפון,4201,מג'דל שמס,461,171,290,21,440,388,456,1,12%
2010-01,הצפון,517,מזרעה,179,70,109,1,178,145,177,0,11%
2010-01,הצפון,4203,מסעדה,181,66,115,3,178,153,180,0,13%
2010-01,הצפון,518,מעיליא,66,29,37,7,59,36,66,2,5%
2010-01,הצפון,1063,מעלות-תרשיחא,1072,444,628,140,932,717,1066,67,9%
2010-01,הצפון,520,משהד,329,128,201,7,322,282,323,3,12%
2010-01,הצפון,9100,נהרייה,2124,962,1162,251,1873,1419,2110,44,8%
2010-01,הצפון,522,נחף,480,203,277,10,470,410,478,0,12%
2010-01,הצפון,7300,נצרת,2006,979,1027,42,1964,1430,1999,7,7%
2010-01,הצפון,1061,נצרת עילית,1626,709,917,254,1372,920,1567,118,7%
2010-01,הצפון,525,סאג'ור,115,44,71,1,114,86,113,0,8%
2010-01,הצפון,7500,סח'נין,2005,917,1088,27,1978,1720,2005,7,18%
2010-01,הצפון,4501,ע'ג'ר,134,53,81,5,129,105,133,0,15%
2010-01,הצפון,530,עיילבון,202,86,116,9,193,165,200,1,9%
2010-01,הצפון,511,עילוט,329,143,186,2,327,258,329,2,14%
2010-01,הצפון,532,עין מאהל,483,258,225,1,482,370,478,6,12%
2010-01,הצפון,7600,עכו,3367,1521,1846,147,3220,2640,3345,40,14%
2010-01,הצפון,7700,עפולה,1753,766,987,216,1537,1035,1704,51,8%
2010-01,הצפון,531,עראבה,1340,580,760,31,1309,1150,1339,3,17%
2010-01,הצפון,535,פסוטה,143,64,79,8,135,106,143,2,10%
2010-01,הצפון,536,פקיעין (בוקייעה),156,80,76,7,149,115,154,3,7%
2010-01,הצפון,8000,צפת,989,469,520,88,901,687,984,19,9%
2010-01,הצפון,4100,קצרין,209,90,119,43,166,109,208,11,6%
2010-01,הצפון,2800,קריית שמונה,821,405,416,71,750,392,801,52,7%
2010-01,הצפון,543,ראמה,322,138,184,8,314,258,319,2,10%
2010-01,הצפון,26,ראש פינה,54,25,29,7,47,21,53,5,4%
2010-01,הצפון,542,ריינה,645,280,365,9,636,504,640,14,12%
2010-01,הצפון,122,רמת ישי,93,34,59,31,62,10,91,7,3%
2010-01,הצפון,913,שבלי - אום אל-גנם,286,143,143,4,282,205,283,2,13%
2010-01,הצפון,812,שלומי,287,122,165,13,274,167,285,7,9%
2010-01,הצפון,538,שעב,465,194,271,6,459,406,464,3,19%
2010-01,הצפון,8800,שפרעם,2143,906,1237,26,2117,1810,2135,4,14%
2010-01,חיפה,2710,אום אל-פחם,3339,1398,1941,10,3329,2821,3335,47,20%
2010-01,חיפה,1020,אור עקיבא,576,258,318,53,523,221,562,17,6%
2010-01,חיפה,6000,באקה אל-גרביה,492,278,214,5,487,289,491,15,NULL
2010-01,חיפה,9800,בנימינה-גבעת עדה*,191,83,108,64,127,47,190,7,3%
2010-01,חיפה,1326,"בסמ""ה",274,146,128,5,269,200,274,8,9%
2010-01,חיפה,541,ג'סר א-זרקא,341,206,135,3,338,242,339,10,7%
2010-01,חיפה,628,ג'ת,154,78,76,2,152,95,154,4,NULL
2010-01,חיפה,494,דאלית אל-כרמל,489,208,281,8,481,321,487,2,7%
2010-01,חיפה,9300,זכרון יעקב,216,85,131,62,154,45,216,9,2%
2010-01,חיפה,6500,חדרה,2029,853,1176,259,1770,850,2006,56,5%
2010-01,חיפה,4000,חיפה,8722,3695,5027,1673,7049,5994,8678,94,7%
2010-01,חיפה,1247,חריש-קציר,26,12,14,4,22,14,26,0,2%
2010-01,חיפה,2100,טירת כרמל,803,353,450,25,778,559,800,2,8%
2010-01,חיפה,654,כפר קרע,285,140,145,8,277,149,284,11,4%
2010-01,חיפה,1327,מעלה עירון,801,343,458,1,800,654,799,7,17%
2010-01,חיפה,2500,נשר,621,275,346,140,481,339,619,11,5%
2010-01,חיפה,534,עספיא,329,132,197,7,322,217,328,1,7%
2010-01,חיפה,637,ערערה,418,204,214,5,413,251,418,11,6%
2010-01,חיפה,537,פוריידיס,338,168,170,4,334,249,337,2,7%
2010-01,חיפה,7800,פרדס חנה-כרכור,670,298,372,108,562,209,665,29,4%
2010-01,חיפה,6800,קריית אתא,1989,782,1207,164,1825,1341,1981,34,7%
2010-01,חיפה,9500,קריית ביאליק,1312,513,799,158,1154,788,1304,33,7%
2010-01,חיפה,2300,קריית טבעון,195,87,108,62,133,60,195,7,3%
2010-01,חיפה,9600,קריית ים,1930,822,1108,191,1739,1352,1924,48,10%
2010-01,חיפה,8200,קריית מוצקין,1289,495,794,203,1086,775,1281,22,6%
2010-01,חיפה,922,רכסים,157,83,74,11,146,108,155,1,6%
2010-01,ירושלים,472,אבו גוש,272,129,143,1,271,187,272,4,11%
2010-01,ירושלים,2610,בית שמש,1134,479,655,114,1020,637,1118,52,5%
2010-01,ירושלים,3000,ירושלים,7949,3468,4481,1128,6821,4818,7913,211,3%
2010-01,ירושלים,1015,מבשרת ציון,306,141,165,65,241,142,305,8,3%
2010-01,ירושלים,1137,קריית יערים,19,6,13,3,16,9,19,0,2%
2010-01,תל אביב,2400,אור יהודה,811,373,438,50,761,365,799,28,5%
2010-01,תל אביב,565,אזור,148,74,74,20,128,50,148,4,3%
2010-01,תל אביב,6100,בני ברק,2139,1005,1134,128,2011,1420,2127,93,5%
2010-01,תל אביב,6200,בת ים,3544,1499,2045,581,2963,1861,3474,157,5%
2010-01,תל אביב,6300,גבעתיים,656,292,364,254,402,129,654,30,2%
2010-01,תל אביב,6400,הרצלייה,1112,483,629,305,807,195,1085,62,2%
2010-01,תל אביב,6600,חולון,3129,1433,1696,504,2625,1214,3089,110,3%
2010-01,תל אביב,2620,קריית אונו,407,180,227,167,240,69,406,10,3%
2010-01,תל אביב,8600,רמת גן,2025,898,1127,610,1415,606,2008,84,3%
2010-01,תל אביב,2650,רמת השרון,393,160,233,161,232,48,391,13,2%
2010-01,תל אביב,5000,תל אביב -יפו,7402,3584,3818,1959,5443,3153,7339,220,3%
2010-02,אזור יהודה והשומרון,3760,אורנית,85,37,48,37,48,3,85,3,2%
2010-02,אזור יהודה והשומרון,3750,אלפי מנשה,98,42,56,28,70,7,96,2,2%
2010-02,אזור יהודה והשומרון,3560,אלקנה,27,16,11,9,18,3,27,0,2%
2010-02,אזור יהודה והשומרון,3650,אפרתה,60,31,29,24,36,10,60,8,2%
2010-02,אזור יהודה והשומרון,3570,אריאל,456,213,243,124,332,140,455,58,5%
2010-02,אזור יהודה והשומרון,3574,בית אל,46,22,24,19,27,16,46,2,2%
2010-02,אזור יהודה והשומרון,3652,בית אריה,69,31,38,10,59,4,69,3,3%
2010-02,אזור יהודה והשומרון,3780,ביתר עילית,348,166,182,14,334,183,343,14,4%
2010-02,אזור יהודה והשומרון,3730,גבעת זאב,177,80,97,23,154,36,175,15,3%
2010-02,אזור יהודה והשומרון,3769,הר אדר,33,14,19,21,12,4,33,1,2%
2010-02,אזור יהודה והשומרון,3797,מודיעין עילית,271,101,170,16,255,80,270,14,3%
2010-02,אזור יהודה והשומרון,3616,מעלה אדומים,651,272,379,96,555,241,643,60,4%
2010-02,אזור יהודה והשומרון,3660,עמנואל,106,60,46,6,100,76,106,6,11%
2010-02,אזור יהודה והשומרון,3557,קדומים,26,14,12,9,17,5,26,0,2%
2010-02,אזור יהודה והשומרון,3611,קריית ארבע,125,66,59,23,102,66,125,8,4%
2010-02,אזור יהודה והשומרון,3640,קרני שומרון,79,47,32,16,63,21,79,4,2%
2010-02,הדרום,31,אופקים,1426,615,811,98,1328,1037,1416,76,13%
2010-02,הדרום,2600,אילת,1691,809,882,83,1608,719,1670,128,5%
2010-02,הדרום,70,אשדוד,7532,3034,4498,870,6662,4675,7467,485,7%
2010-02,הדרום,7100,אשקלון,4053,1696,2357,632,3421,2295,3988,309,7%
2010-02,הדרום,9000,באר שבע,8177,3558,4619,1039,7138,5465,8126,585,9%
2010-02,הדרום,2200,דימונה,2138,945,1193,145,1993,1519,2106,140,12%
2010-02,הדרום,1303,חורה,696,317,379,0,696,626,696,4,23%
2010-02,הדרום,831,ירוחם,450,223,227,32,418,304,443,69,11%
2010-02,הדרום,1059,כסיפה,983,442,541,1,982,876,982,28,26%
2010-02,הדרום,1271,להבים,51,27,24,27,24,5,51,1,2%
2010-02,הדרום,1060,לקיה,920,444,476,5,915,840,918,11,29%
2010-02,הדרום,1268,מיתר,60,25,35,23,37,8,60,2,2%
2010-02,הדרום,99,מצפה רמון,253,94,159,21,232,133,230,43,10%
2010-02,הדרום,246,נתיבות,923,397,526,50,873,540,915,95,8%
2010-02,הדרום,666,עומר,61,24,37,25,36,6,61,1,2%
2010-02,הדרום,2560,ערד,1053,444,609,191,862,685,1027,121,8%
2010-02,הדרום,1192,ערערה-בנגב,926,368,558,3,923,821,925,7,29%
2010-02,הדרום,2630,קריית גת,2572,1029,1543,215,2357,1702,2562,185,10%
2010-02,הדרום,1034,קריית מלאכי,1280,574,706,36,1244,871,1267,113,12%
2010-02,הדרום,1161,רהט,2999,1246,1753,9,2990,2639,2996,28,21%
2010-02,הדרום,1286,שגב-שלום,554,235,319,2,552,495,553,9,27%
2010-02,הדרום,1031,שדרות,899,375,524,52,847,438,896,60,8%
2010-02,הדרום,1054,תל שבע,1184,572,612,5,1179,1058,1180,12,31%
2010-02,המרכז,182,אבן יהודה,170,83,87,58,112,25,169,14,3%
2010-02,המרכז,41,אליכין,57,29,28,5,52,13,57,4,4%
2010-02,המרכז,1309,אלעד,377,174,203,33,344,101,373,20,4%
2010-02,המרכז,2530,באר יעקב,264,117,147,35,229,85,258,20,4%
2010-02,המרכז,466,בית דגן,130,69,61,22,108,37,129,6,4%
2010-02,המרכז,1066,"בני עי""ש",222,94,128,43,179,97,216,15,6%
2010-02,המרכז,681,גבעת שמואל,260,125,135,102,158,52,260,12,3%
2010-02,המרכז,2550,גדרה,395,166,229,78,317,119,389,21,4%
2010-02,המרכז,627,ג'לג'וליה,59,29,30,0,59,31,59,2,2%
2010-02,המרכז,166,גן יבנה,358,139,219,48,310,108,357,21,4%
2010-02,המרכז,229,גני תקווה,183,87,96,50,133,26,181,13,3%
2010-02,המרכז,9700,הוד השרון,605,262,343,205,400,60,603,37,2%
2010-02,המרכז,1290,זמר,184,64,120,1,183,140,184,8,8%
2010-02,המרכז,2730,טייבה,2131,930,1201,8,2123,1755,2121,36,14%
2010-02,המרכז,2720,טירה,309,164,145,7,302,185,308,13,3%
2010-02,המרכז,2660,יבנה,1100,524,576,73,1027,512,1097,100,6%
2010-02,המרכז,9400,יהוד,587,245,342,81,506,89,560,59,4%
2010-02,המרכז,1224,כוכב יאיר,97,40,57,43,54,4,96,2,2%
2010-02,המרכז,633,כפר ברא,20,11,9,1,19,7,20,2,2%
2010-02,המרכז,168,כפר יונה,386,157,229,61,325,99,380,40,4%
2010-02,המרכז,6900,כפר סבא,1271,574,697,369,902,248,1262,80,3%
2010-02,המרכז,634,כפר קאסם,216,112,104,2,214,112,215,5,3%
2010-02,המרכז,7000,לוד,2331,1023,1308,197,2134,1350,2318,172,7%
2010-02,המרכז,1200,מודיעין-מכבים-רעות*,900,385,515,348,552,68,892,105,2%
2010-02,המרכז,28,מזכרת בתיה,165,74,91,34,131,40,163,10,3%
2010-02,המרכז,7200,נס ציונה,716,323,393,164,552,216,709,33,4%
2010-02,המרכז,7400,נתניה,4889,2248,2641,795,4094,2012,4825,427,5%
2010-02,המרכז,587,סביון*,19,10,9,8,11,0,19,0,1%
2010-02,המרכז,171,פרדסייה,85,31,54,15,70,10,83,4,2%
2010-02,המרכז,7900,פתח תקווה,4364,1932,2432,857,3507,1370,4336,357,4%
2010-02,המרכז,195,קדימה-צורן,245,109,136,72,173,44,244,21,3%
2010-02,המרכז,638,קלנסווה,915,374,541,2,913,741,909,16,13%
2010-02,המרכז,469,קריית עקרון,278,138,140,20,258,132,272,11,5%
2010-02,המרכז,2640,ראש העין,739,374,365,81,658,193,722,80,4%
2010-02,המרכז,8300,ראשון לציון,4809,2138,2671,972,3837,1894,4778,438,4%
2010-02,המרכז,8400,רחובות,2680,1213,1467,572,2108,1079,2648,120,5%
2010-02,המרכז,8500,רמלה,1972,905,1067,131,1841,930,1920,151,6%
2010-02,המרכז,8700,רעננה,793,369,424,296,497,91,790,44,2%
2010-02,המרכז,1304,שוהם,199,81,118,91,108,2,199,19,2%
2010-02,המרכז,154,תל מונד,150,66,84,43,107,24,150,4,3%
2010-02,הצפון,473,אבו סנאן,711,268,443,10,701,560,707,19,15%
2010-02,הצפון,478,אכסאל,663,285,378,15,648,549,661,5,14%
2010-02,הצפון,529,אעבלין,702,299,403,16,686,583,701,12,15%
2010-02,הצפון,482,בועיינה-נוג'ידאת,519,219,300,4,515,438,515,1,16%
2010-02,הצפון,4001,בוקעאתא,406,186,220,2,404,330,396,2,17%
2010-02,הצפון,998,ביר אל-מכסור,450,191,259,2,448,345,449,6,15%
2010-02,הצפון,480,בית ג'ן,351,124,227,5,346,246,349,8,8%
2010-02,הצפון,9200,בית שאן,904,382,522,20,884,484,900,90,10%
2010-02,הצפון,944,בסמת טבעון,326,129,197,2,324,256,326,13,12%
2010-02,הצפון,483,בענה,470,196,274,1,469,422,470,7,17%
2010-02,הצפון,1292,ג'דיידה-מכר,1445,615,830,8,1437,1196,1445,38,19%
2010-02,הצפון,485,ג'ולס,207,79,128,8,199,127,207,19,9%
2010-02,הצפון,487,ג'ש (גוש חלב),59,21,38,5,54,33,59,1,4%
2010-02,הצפון,489,דבורייה,440,222,218,19,421,330,440,10,12%
2010-02,הצפון,490,דייר אל-אסד,451,182,269,10,441,351,451,11,11%
2010-02,הצפון,492,דייר חנא,688,310,378,16,672,532,688,26,17%
2010-02,הצפון,975,זרזיר,331,144,187,3,328,222,328,13,13%
2010-02,הצפון,496,חורפיש,150,55,95,7,143,105,150,7,7%
2010-02,הצפון,2034,חצור הגלילית,308,125,183,14,294,155,297,28,7%
2010-02,הצפון,6700,טבריה,2023,908,1115,108,1915,1310,1934,101,10%
2010-02,הצפון,962,טובא-זנגרייה,374,171,203,3,371,268,368,14,14%
2010-02,הצפון,498,טורעאן,573,226,347,11,562,475,571,16,12%
2010-02,הצפון,8900,טמרה,2164,965,1199,24,2140,1892,2157,36,18%
2010-02,הצפון,1295,יאנוח-ג'ת,185,68,117,7,178,126,185,5,9%
2010-02,הצפון,46,יבנאל,112,67,45,7,105,81,106,0,8%
2010-02,הצפון,499,יפיע,701,314,387,16,685,527,696,39,11%
2010-02,הצפון,240,יקנעם עילית,583,220,363,118,465,259,580,55,6%
2010-02,הצפון,502,ירכא,460,189,271,3,457,351,459,20,10%
2010-02,הצפון,504,כאבול,784,367,417,22,762,650,779,13,19%
2010-02,הצפון,505,כאוכב אבו אל-היג'א,236,88,148,6,230,187,236,5,16%
2010-02,הצפון,1296,כסרא-סמיע,259,92,167,3,256,208,258,13,10%
2010-02,הצפון,978,כעביה-טבאש-חג'אג'רה,225,102,123,2,223,157,223,6,12%
2010-02,הצפון,1263,כפר ורדים,59,25,34,26,33,7,59,3,2%
2010-02,הצפון,507,כפר יאסיף,461,197,264,5,456,360,459,8,11%
2010-02,הצפון,508,כפר כמא,98,44,54,4,94,47,97,0,7%
2010-02,הצפון,509,כפר כנא,1257,536,721,21,1236,1056,1240,42,17%
2010-02,הצפון,510,כפר מנדא,922,447,475,14,908,695,911,57,15%
2010-02,הצפון,47,כפר תבור,48,22,26,14,34,7,48,3,3%
2010-02,הצפון,1139,כרמיאל,1914,757,1157,366,1548,1040,1861,125,8%
2010-02,הצפון,481,מגאר,1513,613,900,35,1478,1282,1510,38,20%
2010-02,הצפון,516,מג'ד אל-כרום,708,321,387,10,698,545,707,19,13%
2010-02,הצפון,874,מגדל העמק,1098,456,642,108,990,549,1068,144,9%
2010-02,הצפון,4201,מג'דל שמס,489,183,306,20,469,405,484,4,12%
2010-02,הצפון,517,מזרעה,200,85,115,2,198,155,198,7,12%
2010-02,הצפון,4203,מסעדה,201,72,129,4,197,171,200,1,14%
2010-02,הצפון,518,מעיליא,68,32,36,9,59,36,68,2,5%
2010-02,הצפון,1063,מעלות-תרשיחא,1081,478,603,134,947,691,1077,68,9%
2010-02,הצפון,520,משהד,346,133,213,7,339,291,342,5,13%
2010-02,הצפון,9100,נהרייה,2289,1047,1242,267,2022,1432,2276,136,8%
2010-02,הצפון,522,נחף,483,205,278,13,470,405,481,12,12%
2010-02,הצפון,7300,נצרת,2079,1022,1057,49,2030,1428,2074,71,7%
2010-02,הצפון,1061,נצרת עילית,1722,788,934,248,1474,861,1656,188,7%
2010-02,הצפון,525,סאג'ור,116,47,69,2,114,84,115,6,8%
2010-02,הצפון,7500,סח'נין,2062,958,1104,37,2025,1741,2062,39,18%
2010-02,הצפון,4501,ע'ג'ר,140,56,84,5,135,109,139,6,16%
2010-02,הצפון,530,עיילבון,210,88,122,11,199,163,208,6,10%
2010-02,הצפון,511,עילוט,331,141,190,4,327,259,330,12,14%
2010-02,הצפון,532,עין מאהל,490,263,227,1,489,369,485,9,12%
2010-02,הצפון,7600,עכו,3538,1603,1935,160,3378,2715,3516,169,14%
2010-02,הצפון,7700,עפולה,1993,872,1121,226,1767,1077,1928,149,9%
2010-02,הצפון,531,עראבה,1400,613,787,40,1360,1185,1399,49,17%
2010-02,הצפון,535,פסוטה,149,69,80,10,139,102,149,4,10%
2010-02,הצפון,536,פקיעין (בוקייעה),157,79,78,7,150,118,155,8,7%
2010-02,הצפון,8000,צפת,1024,500,524,79,945,683,1016,27,9%
2010-02,הצפון,4100,קצרין,218,94,124,43,175,118,216,25,6%
2010-02,הצפון,2800,קריית שמונה,869,422,447,75,794,374,849,106,7%
2010-02,הצפון,543,ראמה,340,146,194,7,333,261,337,3,10%
2010-02,הצפון,26,ראש פינה,53,22,31,10,43,22,52,4,4%
2010-02,הצפון,542,ריינה,681,295,386,9,672,526,674,26,12%
2010-02,הצפון,122,רמת ישי,106,38,68,35,71,8,104,5,3%
2010-02,הצפון,913,שבלי - אום אל-גנם,298,149,149,6,292,207,295,21,13%
2010-02,הצפון,812,שלומי,313,134,179,14,299,178,310,18,9%
2010-02,הצפון,538,שעב,494,205,289,7,487,416,493,17,20%
2010-02,הצפון,8800,שפרעם,2232,955,1277,33,2199,1852,2224,108,15%
2010-02,חיפה,2710,אום אל-פחם,3446,1478,1968,12,3434,2871,3443,52,20%
2010-02,חיפה,1020,אור עקיבא,607,263,344,51,556,199,593,43,7%
2010-02,חיפה,6000,באקה אל-גרביה,528,300,228,7,521,291,527,34,NULL
2010-02,חיפה,9800,בנימינה-גבעת עדה*,202,82,120,69,133,47,202,14,3%
2010-02,חיפה,1326,"בסמ""ה",290,161,129,6,284,197,290,11,9%
2010-02,חיפה,541,ג'סר א-זרקא,353,214,139,4,349,245,350,14,7%
2010-02,חיפה,628,ג'ת,164,84,80,3,161,100,164,8,NULL
2010-02,חיפה,494,דאלית אל-כרמל,542,231,311,11,531,323,539,23,8%
2010-02,חיפה,9300,זכרון יעקב,233,97,136,66,167,42,232,14,3%
2010-02,חיפה,6500,חדרה,2256,976,1280,261,1995,798,2220,170,5%
2010-02,חיפה,4000,חיפה,9233,3932,5301,1718,7515,5999,9184,559,7%
2010-02,חיפה,1247,חריש-קציר,32,15,17,3,29,11,32,3,2%
2010-02,חיפה,2100,טירת כרמל,859,376,483,26,833,573,855,69,9%
2010-02,חיפה,654,כפר קרע,298,151,147,10,288,151,296,18,4%
2010-02,חיפה,1327,מעלה עירון,841,366,475,2,839,666,839,14,18%
2010-02,חיפה,2500,נשר,656,286,370,141,515,334,654,54,5%
2010-02,חיפה,534,עספיא,361,154,207,9,352,225,360,23,8%
2010-02,חיפה,637,ערערה,436,208,228,6,430,248,436,38,7%
2010-02,חיפה,537,פוריידיס,352,180,172,5,347,248,351,14,8%
2010-02,חיפה,7800,פרדס חנה-כרכור,776,349,427,132,644,199,771,77,5%
2010-02,חיפה,6800,קריית אתא,2123,856,1267,180,1943,1335,2113,133,8%
2010-02,חיפה,9500,קריית ביאליק,1413,562,851,180,1233,784,1402,101,7%
2010-02,חיפה,2300,קריית טבעון,215,93,122,78,137,63,215,16,3%
2010-02,חיפה,9600,קריית ים,2010,867,1143,194,1816,1332,2002,114,10%
2010-02,חיפה,8200,קריית מוצקין,1336,519,817,198,1138,760,1324,100,6%
2010-02,חיפה,922,רכסים,160,77,83,8,152,111,159,17,6%
2010-02,ירושלים,472,אבו גוש,288,149,139,6,282,185,287,11,12%
2010-02,ירושלים,2610,בית שמש,1240,536,704,119,1121,632,1220,112,5%
2010-02,ירושלים,3000,ירושלים,8652,3882,4770,1211,7441,4655,8604,552,3%
2010-02,ירושלים,1015,מבשרת ציון,338,157,181,71,267,138,336,33,3%
2010-02,ירושלים,1137,קריית יערים,29,9,20,6,23,10,29,2,3%
2010-02,תל אביב,2400,אור יהודה,895,411,484,56,839,362,878,68,5%
2010-02,תל אביב,565,אזור,173,82,91,24,149,50,171,16,3%
2010-02,תל אביב,6100,בני ברק,2216,1048,1168,133,2083,1361,2201,132,5%
2010-02,תל אביב,6200,בת ים,3738,1663,2075,553,3185,1731,3660,292,5%
2010-02,תל אביב,6300,גבעתיים,743,330,413,301,442,127,740,58,3%
2010-02,תל אביב,6400,הרצלייה,1227,537,690,317,910,189,1191,164,3%
2010-02,תל אביב,6600,חולון,3466,1576,1890,541,2925,1214,3414,374,4%
2010-02,תל אביב,2620,קריית אונו,438,198,240,171,267,63,433,27,3%
2010-02,תל אביב,8600,רמת גן,2190,986,1204,669,1521,576,2168,155,3%
2010-02,תל אביב,2650,רמת השרון,455,185,270,175,280,48,451,53,2%
2010-02,תל אביב,5000,תל אביב -יפו,8160,3967,4193,2193,5967,3052,8078,586,4%
2010-03,אזור יהודה והשומרון,3760,אורנית,82,34,48,38,44,4,82,8,2%
2010-03,אזור יהודה והשומרון,3750,אלפי מנשה,93,36,57,28,65,6,93,7,2%
2010-03,אזור יהודה והשומרון,3560,אלקנה,26,17,9,12,14,3,26,3,2%
2010-03,אזור יהודה והשומרון,3650,אפרתה,49,28,21,24,25,5,49,5,1%
2010-03,אזור יהודה והשומרון,3570,אריאל,433,216,217,117,316,134,433,41,4%
2010-03,אזור יהודה והשומרון,3574,בית אל,42,20,22,19,23,15,42,2,2%
2010-03,אזור יהודה והשומרון,3652,בית אריה,67,29,38,9,58,3,66,5,3%
2010-03,אזור יהודה והשומרון,3780,ביתר עילית,332,161,171,16,316,188,326,20,4%
2010-03,אזור יהודה והשומרון,3730,גבעת זאב,176,84,92,23,153,36,175,18,3%
2010-03,אזור יהודה והשומרון,3769,הר אדר,32,13,19,18,14,3,32,1,2%
2010-03,אזור יהודה והשומרון,3797,מודיעין עילית,298,94,204,20,278,83,298,16,3%
2010-03,אזור יהודה והשומרון,3616,מעלה אדומים,631,261,370,90,541,229,625,63,4%
2010-03,אזור יהודה והשומרון,3660,עמנואל,95,52,43,4,91,69,95,4,10%
2010-03,אזור יהודה והשומרון,3557,קדומים,30,21,9,10,20,6,30,4,2%
2010-03,אזור יהודה והשומרון,3611,קריית ארבע,113,51,62,24,89,66,113,9,4%
2010-03,אזור יהודה והשומרון,3640,קרני שומרון,85,51,34,19,66,23,85,3,3%
2010-03,הדרום,31,אופקים,1367,588,779,95,1272,1038,1356,50,12%
2010-03,הדרום,2600,אילת,1532,727,805,77,1455,693,1518,140,5%
2010-03,הדרום,70,אשדוד,7331,2906,4425,850,6481,4606,7267,475,7%
2010-03,הדרום,7100,אשקלון,3989,1678,2311,650,3339,2295,3931,393,7%
2010-03,הדרום,9000,באר שבע,7984,3517,4467,1059,6925,5344,7931,612,8%
2010-03,הדרום,2200,דימונה,2073,918,1155,138,1935,1499,2044,148,12%
2010-03,הדרום,1303,חורה,706,313,393,0,706,640,706,9,23%
2010-03,הדרום,831,ירוחם,433,206,227,31,402,296,426,51,10%
2010-03,הדרום,1059,כסיפה,977,431,546,1,976,876,975,16,26%
2010-03,הדרום,1271,להבים,57,27,30,35,22,6,57,4,2%
2010-03,הדרום,1060,לקיה,918,433,485,3,915,845,916,13,29%
2010-03,הדרום,1268,מיתר,57,23,34,23,34,7,57,5,2%
2010-03,הדרום,99,מצפה רמון,249,92,157,21,228,132,228,31,10%
2010-03,הדרום,246,נתיבות,885,412,473,51,834,520,878,69,8%
2010-03,הדרום,666,עומר,60,24,36,26,34,7,60,4,2%
2010-03,הדרום,2560,ערד,1013,412,601,182,831,667,986,180,8%
2010-03,הדרום,1192,ערערה-בנגב,940,377,563,2,938,837,939,4,30%
2010-03,הדרום,2630,קריית גת,2511,1017,1494,208,2303,1689,2502,203,10%
2010-03,הדרום,1034,קריית מלאכי,1277,581,696,30,1247,873,1257,112,12%
2010-03,הדרום,1161,רהט,3024,1253,1771,10,3014,2669,3021,78,21%
2010-03,הדרום,1286,שגב-שלום,556,238,318,2,554,500,555,8,27%
2010-03,הדרום,1031,שדרות,907,404,503,50,857,439,905,68,8%
2010-03,הדרום,1054,תל שבע,1202,584,618,6,1196,1075,1199,16,31%
2010-03,המרכז,182,אבן יהודה,147,70,77,58,89,25,147,9,2%
2010-03,המרכז,41,אליכין,61,32,29,5,56,14,61,3,4%
2010-03,המרכז,1309,אלעד,368,172,196,34,334,107,366,16,3%
2010-03,המרכז,2530,באר יעקב,242,105,137,40,202,86,237,14,3%
2010-03,המרכז,466,בית דגן,120,63,57,18,102,34,119,9,4%
2010-03,המרכז,1066,"בני עי""ש",207,96,111,38,169,88,203,9,5%
2010-03,המרכז,681,גבעת שמואל,274,140,134,111,163,53,273,14,3%
2010-03,המרכז,2550,גדרה,390,171,219,86,304,118,386,16,4%
2010-03,המרכז,627,ג'לג'וליה,52,23,29,0,52,30,52,5,2%
2010-03,המרכז,166,גן יבנה,352,135,217,52,300,100,351,28,4%
2010-03,המרכז,229,גני תקווה,170,75,95,50,120,24,169,9,2%
2010-03,המרכז,9700,הוד השרון,607,265,342,210,397,71,604,28,2%
2010-03,המרכז,1290,זמר,182,61,121,2,180,139,182,7,7%
2010-03,המרכז,2730,טייבה,2136,939,1197,5,2131,1786,2125,53,14%
2010-03,המרכז,2720,טירה,322,170,152,9,313,196,320,9,4%
2010-03,המרכז,2660,יבנה,996,479,517,69,927,488,991,99,6%
2010-03,המרכז,9400,יהוד,556,236,320,88,468,92,529,43,4%
2010-03,המרכז,1224,כוכב יאיר,102,44,58,50,52,4,102,3,2%
2010-03,המרכז,633,כפר ברא,21,9,12,0,21,7,21,2,2%
2010-03,המרכז,168,כפר יונה,352,136,216,56,296,90,348,26,4%
2010-03,המרכז,6900,כפר סבא,1286,604,682,374,912,239,1280,77,3%
2010-03,המרכז,634,כפר קאסם,207,104,103,2,205,107,207,12,3%
2010-03,המרכז,7000,לוד,2275,993,1282,213,2062,1305,2262,182,7%
2010-03,המרכז,1200,מודיעין-מכבים-רעות*,869,384,485,352,517,64,860,76,2%
2010-03,המרכז,28,מזכרת בתיה,154,70,84,32,122,39,152,3,3%
2010-03,המרכז,7200,נס ציונה,699,304,395,162,537,210,692,28,3%
2010-03,המרכז,7400,נתניה,4740,2162,2578,810,3930,2008,4680,407,5%
2010-03,המרכז,587,סביון*,15,5,10,7,8,0,15,1,1%
2010-03,המרכז,171,פרדסייה,79,28,51,14,65,10,78,6,2%
2010-03,המרכז,7900,פתח תקווה,4365,1977,2388,877,3488,1350,4336,313,4%
2010-03,המרכז,195,קדימה-צורן,249,112,137,74,175,42,248,17,3%
2010-03,המרכז,638,קלנסווה,919,372,547,1,918,743,914,17,13%
2010-03,המרכז,469,קריית עקרון,252,128,124,16,236,124,250,16,5%
2010-03,המרכז,2640,ראש העין,725,372,353,81,644,193,709,70,4%
2010-03,המרכז,8300,ראשון לציון,4771,2114,2657,953,3818,1830,4743,297,4%
2010-03,המרכז,8400,רחובות,2665,1197,1468,572,2093,1060,2630,99,5%
2010-03,המרכז,8500,רמלה,1907,895,1012,122,1785,919,1860,150,6%
2010-03,המרכז,8700,רעננה,767,366,401,292,475,84,765,41,2%
2010-03,המרכז,1304,שוהם,190,82,108,90,100,2,190,12,2%
2010-03,המרכז,154,תל מונד,150,65,85,44,106,22,150,5,3%
2010-03,הצפון,473,אבו סנאן,720,276,444,10,710,572,716,16,15%
2010-03,הצפון,478,אכסאל,679,296,383,19,660,558,677,9,14%
2010-03,הצפון,529,אעבלין,703,301,402,15,688,583,703,25,15%
2010-03,הצפון,482,בועיינה-נוג'ידאת,542,230,312,4,538,449,537,3,17%
2010-03,הצפון,4001,בוקעאתא,401,183,218,2,399,329,391,7,17%
2010-03,הצפון,998,ביר אל-מכסור,442,186,256,3,439,345,441,10,15%
2010-03,הצפון,480,בית ג'ן,355,131,224,4,351,241,352,4,9%
2010-03,הצפון,9200,בית שאן,844,345,499,20,824,457,837,97,9%
2010-03,הצפון,944,בסמת טבעון,303,118,185,2,301,242,303,12,11%
2010-03,הצפון,483,בענה,469,190,279,2,467,422,469,8,17%
2010-03,הצפון,1292,ג'דיידה-מכר,1443,612,831,7,1436,1214,1443,36,19%
2010-03,הצפון,485,ג'ולס,202,77,125,7,195,126,202,13,9%
2010-03,הצפון,487,ג'ש (גוש חלב),64,26,38,6,58,36,64,4,4%
2010-03,הצפון,489,דבורייה,453,225,228,20,433,338,452,8,12%
2010-03,הצפון,490,דייר אל-אסד,452,175,277,9,443,354,452,14,11%
2010-03,הצפון,492,דייר חנא,684,307,377,18,666,543,684,26,17%
2010-03,הצפון,975,זרזיר,309,126,183,2,307,217,305,15,13%
2010-03,הצפון,496,חורפיש,148,60,88,6,142,101,148,8,7%
2010-03,הצפון,2034,חצור הגלילית,291,129,162,9,282,158,283,32,7%
2010-03,הצפון,6700,טבריה,1907,835,1072,111,1796,1273,1816,122,9%
2010-03,הצפון,962,טובא-זנגרייה,378,170,208,4,374,257,374,20,14%
2010-03,הצפון,498,טורעאן,576,222,354,8,568,483,574,28,13%
2010-03,הצפון,8900,טמרה,2143,941,1202,22,2121,1877,2141,84,18%
2010-03,הצפון,1295,יאנוח-ג'ת,177,63,114,8,169,124,177,7,8%
2010-03,הצפון,46,יבנאל,116,72,44,6,110,85,110,1,8%
2010-03,הצפון,499,יפיע,671,298,373,14,657,507,667,32,10%
2010-03,הצפון,240,יקנעם עילית,539,204,335,105,434,238,537,33,5%
2010-03,הצפון,502,ירכא,457,195,262,3,454,357,456,22,10%
2010-03,הצפון,504,כאבול,783,353,430,19,764,649,781,15,19%
2010-03,הצפון,505,כאוכב אבו אל-היג'א,233,91,142,6,227,189,233,5,16%
2010-03,הצפון,1296,כסרא-סמיע,255,95,160,2,253,211,254,12,9%
2010-03,הצפון,978,כעביה-טבאש-חג'אג'רה,229,102,127,2,227,157,226,2,12%
2010-03,הצפון,1263,כפר ורדים,67,30,37,31,36,9,67,4,2%
2010-03,הצפון,507,כפר יאסיף,476,207,269,4,472,378,474,14,11%
2010-03,הצפון,508,כפר כמא,100,44,56,4,96,48,98,2,7%
2010-03,הצפון,509,כפר כנא,1253,515,738,24,1229,1055,1239,52,17%
2010-03,הצפון,510,כפר מנדא,908,421,487,13,895,691,896,36,15%
2010-03,הצפון,47,כפר תבור,48,22,26,17,31,6,48,2,3%
2010-03,הצפון,1139,כרמיאל,1839,705,1134,351,1488,1023,1797,106,7%
2010-03,הצפון,481,מגאר,1500,598,902,35,1465,1288,1497,57,20%
2010-03,הצפון,516,מג'ד אל-כרום,696,302,394,11,685,545,695,25,13%
2010-03,הצפון,874,מגדל העמק,1040,440,600,104,936,528,1012,119,8%
2010-03,הצפון,4201,מג'דל שמס,491,180,311,22,469,418,486,8,12%
2010-03,הצפון,517,מזרעה,190,74,116,2,188,149,189,10,12%
2010-03,הצפון,4203,מסעדה,212,76,136,4,208,177,211,3,14%
2010-03,הצפון,518,מעיליא,68,35,33,9,59,34,68,4,5%
2010-03,הצפון,1063,מעלות-תרשיחא,1042,467,575,127,915,692,1038,53,9%
2010-03,הצפון,520,משהד,336,126,210,6,330,284,331,8,13%
2010-03,הצפון,9100,נהרייה,2232,1023,1209,273,1959,1401,2217,108,8%
2010-03,הצפון,522,נחף,472,197,275,15,457,397,471,8,12%
2010-03,הצפון,7300,נצרת,2082,1009,1073,54,2028,1448,2077,71,7%
2010-03,הצפון,1061,נצרת עילית,1664,747,917,246,1418,846,1613,184,7%
2010-03,הצפון,525,סאג'ור,117,45,72,3,114,88,116,1,8%
2010-03,הצפון,7500,סח'נין,2071,961,1110,44,2027,1760,2071,58,18%
2010-03,הצפון,4501,ע'ג'ר,137,52,85,4,133,107,136,4,15%
2010-03,הצפון,530,עיילבון,209,91,118,10,199,161,207,12,10%
2010-03,הצפון,511,עילוט,340,144,196,4,336,267,339,5,15%
2010-03,הצפון,532,עין מאהל,478,246,232,1,477,366,473,8,11%
2010-03,הצפון,7600,עכו,3462,1584,1878,149,3313,2677,3442,134,14%
2010-03,הצפון,7700,עפולה,1901,865,1036,220,1681,1045,1843,156,8%
2010-03,הצפון,531,עראבה,1374,592,782,34,1340,1167,1373,48,17%
2010-03,הצפון,535,פסוטה,143,69,74,8,135,100,143,5,10%
2010-03,הצפון,536,פקיעין (בוקייעה),155,79,76,6,149,114,153,6,7%
2010-03,הצפון,8000,צפת,984,484,500,79,905,678,978,44,9%
2010-03,הצפון,4100,קצרין,206,87,119,34,172,114,203,14,5%
2010-03,הצפון,2800,קריית שמונה,823,394,429,75,748,363,805,89,7%
2010-03,הצפון,543,ראמה,343,153,190,9,334,266,341,6,11%
2010-03,הצפון,26,ראש פינה,49,20,29,5,44,21,49,7,4%
2010-03,הצפון,542,ריינה,669,284,385,9,660,527,664,32,12%
2010-03,הצפון,122,רמת ישי,104,42,62,34,70,10,104,7,3%
2010-03,הצפון,913,שבלי - אום אל-גנם,292,145,147,6,286,208,288,6,13%
2010-03,הצפון,812,שלומי,297,126,171,13,284,174,295,15,9%
2010-03,הצפון,538,שעב,494,209,285,7,487,417,493,16,20%
2010-03,הצפון,8800,שפרעם,2153,895,1258,31,2122,1785,2146,64,14%
2010-03,חיפה,2710,אום אל-פחם,3475,1483,1992,12,3463,2919,3472,56,21%
2010-03,חיפה,1020,אור עקיבא,585,267,318,50,535,199,574,53,6%
2010-03,חיפה,6000,באקה אל-גרביה,498,282,216,8,490,297,497,39,NULL
2010-03,חיפה,9800,בנימינה-גבעת עדה*,196,78,118,68,128,45,196,9,3%
2010-03,חיפה,1326,"בסמ""ה",285,156,129,4,281,198,285,6,9%
2010-03,חיפה,541,ג'סר א-זרקא,355,218,137,2,353,245,352,16,7%
2010-03,חיפה,628,ג'ת,163,80,83,4,159,99,163,5,NULL
2010-03,חיפה,494,דאלית אל-כרמל,542,234,308,12,530,324,539,21,8%
2010-03,חיפה,9300,זכרון יעקב,223,95,128,67,156,44,222,22,2%
2010-03,חיפה,6500,חדרה,2159,928,1231,268,1891,794,2119,198,5%
2010-03,חיפה,4000,חיפה,9107,3914,5193,1703,7404,5931,9052,514,7%
2010-03,חיפה,1247,חריש-קציר,27,13,14,3,24,10,27,3,2%
2010-03,חיפה,2100,טירת כרמל,832,371,461,27,805,554,827,49,9%
2010-03,חיפה,654,כפר קרע,295,146,149,8,287,152,294,19,4%
2010-03,חיפה,1327,מעלה עירון,846,362,484,2,844,682,844,20,18%
2010-03,חיפה,2500,נשר,646,286,360,142,504,339,645,42,5%
2010-03,חיפה,534,עספיא,361,154,207,10,351,226,360,31,8%
2010-03,חיפה,637,ערערה,428,206,222,6,422,253,428,24,7%
2010-03,חיפה,537,פוריידיס,364,191,173,5,359,260,363,10,8%
2010-03,חיפה,7800,פרדס חנה-כרכור,766,342,424,137,629,214,763,85,5%
2010-03,חיפה,6800,קריית אתא,2087,855,1232,179,1908,1318,2078,113,8%
2010-03,חיפה,9500,קריית ביאליק,1367,551,816,172,1195,761,1360,95,7%
2010-03,חיפה,2300,קריית טבעון,210,92,118,69,141,60,210,17,3%
2010-03,חיפה,9600,קריית ים,1970,861,1109,186,1784,1319,1965,120,10%
2010-03,חיפה,8200,קריית מוצקין,1282,503,779,195,1087,736,1272,98,6%
2010-03,חיפה,922,רכסים,161,75,86,10,151,112,160,4,6%
2010-03,ירושלים,472,אבו גוש,284,142,142,5,279,181,284,17,12%
2010-03,ירושלים,2610,בית שמש,1153,498,655,110,1043,602,1137,119,5%
2010-03,ירושלים,3000,ירושלים,8446,3784,4662,1225,7221,4706,8411,451,3%
2010-03,ירושלים,1015,מבשרת ציון,342,163,179,78,264,131,341,21,3%
2010-03,ירושלים,1137,קריית יערים,29,12,17,5,24,12,28,2,3%
2010-03,תל אביב,2400,אור יהודה,846,395,451,59,787,343,831,57,5%
2010-03,תל אביב,565,אזור,179,86,93,27,152,48,178,16,3%
2010-03,תל אביב,6100,בני ברק,2158,1037,1121,132,2026,1340,2147,126,5%
2010-03,תל אביב,6200,בת ים,3608,1613,1995,540,3068,1676,3531,292,5%
2010-03,תל אביב,6300,גבעתיים,745,333,412,315,430,120,739,51,3%
2010-03,תל אביב,6400,הרצלייה,1220,551,669,355,865,199,1187,141,3%
2010-03,תל אביב,6600,חולון,3315,1523,1792,539,2776,1134,3268,278,4%
2010-03,תל אביב,2620,קריית אונו,426,193,233,156,270,61,421,18,3%
2010-03,תל אביב,8600,רמת גן,2215,1002,1213,710,1505,577,2198,152,3%
2010-03,תל אביב,2650,רמת השרון,425,167,258,177,248,43,424,38,2%
2010-03,תל אביב,5000,תל אביב -יפו,8170,3937,4233,2442,5728,3011,8089,598,4%
2010-04,אזור יהודה והשומרון,3760,אורנית,76,36,40,31,45,4,76,8,2%
2010-04,אזור יהודה והשומרון,3750,אלפי מנשה,95,35,60,31,64,4,95,2,2%
2010-04,אזור יהודה והשומרון,3560,אלקנה,31,18,13,16,15,3,31,0,2%
2010-04,אזור יהודה והשומרון,3650,אפרתה,46,28,18,22,24,5,46,1,1%
2010-04,אזור יהודה והשומרון,3570,אריאל,424,212,212,102,322,128,424,37,4%
2010-04,אזור יהודה והשומרון,3574,בית אל,48,22,26,24,24,14,47,0,2%
2010-04,אזור יהודה והשומרון,3652,בית אריה,63,31,32,8,55,4,63,2,3%
2010-04,אזור יהודה והשומרון,3780,ביתר עילית,338,153,185,15,323,180,334,9,4%
2010-04,אזור יהודה והשומרון,3730,גבעת זאב,179,78,101,21,158,39,178,13,3%
2010-04,אזור יהודה והשומרון,3769,הר אדר,27,13,14,15,12,2,27,1,2%
2010-04,אזור יהודה והשומרון,3797,מודיעין עילית,291,98,193,16,275,82,290,18,3%
2010-04,אזור יהודה והשומרון,3616,מעלה אדומים,645,267,378,99,546,230,638,69,4%
2010-04,אזור יהודה והשומרון,3660,עמנואל,90,46,44,3,87,65,90,11,10%
2010-04,אזור יהודה והשומרון,3557,קדומים,31,19,12,11,20,5,31,2,2%
2010-04,אזור יהודה והשומרון,3611,קריית ארבע,111,58,53,22,89,68,111,10,4%
2010-04,אזור יהודה והשומרון,3640,קרני שומרון,84,43,41,15,69,26,84,4,3%
2010-04,הדרום,31,אופקים,1350,569,781,84,1266,1011,1339,35,12%
2010-04,הדרום,2600,אילת,1410,648,762,78,1332,687,1399,88,5%
2010-04,הדרום,70,אשדוד,7178,2824,4354,829,6349,4487,7117,425,7%
2010-04,הדרום,7100,אשקלון,3929,1604,2325,646,3283,2279,3875,244,7%
2010-04,הדרום,9000,באר שבע,7839,3415,4424,1021,6818,5289,7788,467,8%
2010-04,הדרום,2200,דימונה,2063,915,1148,134,1929,1485,2040,103,12%
2010-04,הדרום,1303,חורה,693,305,388,0,693,637,693,8,23%
2010-04,הדרום,831,ירוחם,431,212,219,27,404,286,424,43,10%
2010-04,הדרום,1059,כסיפה,968,417,551,1,967,873,967,16,26%
2010-04,הדרום,1271,להבים,58,29,29,30,28,6,57,6,2%
2010-04,הדרום,1060,לקיה,899,417,482,3,896,833,897,5,28%
2010-04,הדרום,1268,מיתר,64,29,35,26,38,5,63,6,2%
2010-04,הדרום,99,מצפה רמון,238,87,151,19,219,130,224,25,10%
2010-04,הדרום,246,נתיבות,880,395,485,51,829,525,877,50,8%
2010-04,הדרום,666,עומר,66,32,34,27,39,6,66,8,2%
2010-04,הדרום,2560,ערד,955,391,564,166,789,651,932,104,8%
2010-04,הדרום,1192,ערערה-בנגב,932,375,557,2,930,842,931,6,29%
2010-04,הדרום,2630,קריית גת,2452,984,1468,201,2251,1658,2446,181,10%
2010-04,הדרום,1034,קריית מלאכי,1311,580,731,34,1277,873,1292,127,12%
2010-04,הדרום,1161,רהט,2939,1224,1715,10,2929,2622,2936,104,21%
2010-04,הדרום,1286,שגב-שלום,547,231,316,2,545,493,546,3,26%
2010-04,הדרום,1031,שדרות,889,389,500,52,837,443,885,68,8%
2010-04,הדרום,1054,תל שבע,1186,575,611,5,1181,1068,1183,22,31%
2010-04,המרכז,182,אבן יהודה,145,62,83,58,87,25,145,11,2%
2010-04,המרכז,41,אליכין,80,38,42,7,73,17,80,6,5%
2010-04,המרכז,1309,אלעד,360,175,185,28,332,108,359,11,3%
2010-04,המרכז,2530,באר יעקב,255,122,133,40,215,88,250,20,4%
2010-04,המרכז,466,בית דגן,115,59,56,16,99,36,115,6,4%
2010-04,המרכז,1066,"בני עי""ש",205,97,108,38,167,96,202,7,5%
2010-04,המרכז,681,גבעת שמואל,265,128,137,106,159,56,265,16,3%
2010-04,המרכז,2550,גדרה,361,157,204,82,279,113,356,12,4%
2010-04,המרכז,627,ג'לג'וליה,53,24,29,1,52,29,53,2,2%
2010-04,המרכז,166,גן יבנה,352,134,218,54,298,98,351,16,4%
2010-04,המרכז,229,גני תקווה,176,79,97,52,124,24,175,11,3%
2010-04,המרכז,9700,הוד השרון,637,272,365,215,422,73,635,46,3%
2010-04,המרכז,1290,זמר,180,59,121,1,179,137,180,7,7%
2010-04,המרכז,2730,טייבה,2084,912,1172,8,2076,1765,2066,43,14%
2010-04,המרכז,2720,טירה,319,161,158,11,308,198,319,14,4%
2010-04,המרכז,2660,יבנה,1047,499,548,76,971,490,1041,81,6%
2010-04,המרכז,9400,יהוד,554,241,313,90,464,92,525,38,4%
2010-04,המרכז,1224,כוכב יאיר,101,42,59,56,45,4,101,6,2%
2010-04,המרכז,633,כפר ברא,17,7,10,0,17,6,17,0,2%
2010-04,המרכז,168,כפר יונה,375,142,233,57,318,97,368,35,4%
2010-04,המרכז,6900,כפר סבא,1207,556,651,370,837,229,1197,83,3%
2010-04,המרכז,634,כפר קאסם,204,100,104,3,201,105,204,6,3%
2010-04,המרכז,7000,לוד,2220,945,1275,207,2013,1279,2210,153,7%
2010-04,המרכז,1200,מודיעין-מכבים-רעות*,870,358,512,349,521,71,862,107,2%
2010-04,המרכז,28,מזכרת בתיה,150,59,91,30,120,40,148,8,3%
2010-04,המרכז,7200,נס ציונה,673,304,369,151,522,212,666,25,3%
2010-04,המרכז,7400,נתניה,4679,2126,2553,768,3911,1936,4615,386,5%
2010-04,המרכז,587,סביון*,15,6,9,7,8,1,15,0,1%
2010-04,המרכז,171,פרדסייה,78,31,47,15,63,10,77,10,2%
2010-04,המרכז,7900,פתח תקווה,4176,1855,2321,848,3328,1299,4146,284,4%
2010-04,המרכז,195,קדימה-צורן,236,108,128,71,165,40,232,16,3%
2010-04,המרכז,638,קלנסווה,885,348,537,2,883,737,880,32,12%
2010-04,המרכז,469,קריית עקרון,260,129,131,12,248,130,258,9,5%
2010-04,המרכז,2640,ראש העין,719,363,356,73,646,193,707,75,4%
2010-04,המרכז,8300,ראשון לציון,4642,2061,2581,924,3718,1873,4614,333,4%
2010-04,המרכז,8400,רחובות,2566,1114,1452,537,2029,1044,2531,95,4%
2010-04,המרכז,8500,רמלה,1854,846,1008,125,1729,915,1812,144,6%
2010-04,המרכז,8700,רעננה,721,350,371,277,444,83,717,40,2%
2010-04,המרכז,1304,שוהם,197,86,111,96,101,2,197,15,2%
2010-04,המרכז,154,תל מונד,150,63,87,46,104,19,150,14,3%
2010-04,הצפון,473,אבו סנאן,717,267,450,8,709,588,713,24,15%
2010-04,הצפון,478,אכסאל,675,289,386,22,653,559,674,6,14%
2010-04,הצפון,529,אעבלין,668,287,381,13,655,559,668,10,14%
2010-04,הצפון,482,בועיינה-נוג'ידאת,525,217,308,5,520,436,520,1,16%
2010-04,הצפון,4001,בוקעאתא,398,178,220,2,396,327,388,0,17%
2010-04,הצפון,998,ביר אל-מכסור,416,161,255,4,412,331,416,6,14%
2010-04,הצפון,480,בית ג'ן,343,115,228,4,339,250,340,5,8%
2010-04,הצפון,9200,בית שאן,836,362,474,19,817,465,832,102,9%
2010-04,הצפון,944,בסמת טבעון,292,114,178,1,291,230,292,4,11%
2010-04,הצפון,483,בענה,456,183,273,2,454,415,456,7,16%
2010-04,הצפון,1292,ג'דיידה-מכר,1427,605,822,6,1421,1211,1427,24,19%
2010-04,הצפון,485,ג'ולס,210,80,130,7,203,125,210,4,9%
2010-04,הצפון,487,ג'ש (גוש חלב),59,23,36,5,54,35,59,2,4%
2010-04,הצפון,489,דבורייה,430,205,225,22,408,326,427,11,12%
2010-04,הצפון,490,דייר אל-אסד,436,173,263,8,428,349,436,8,11%
2010-04,הצפון,492,דייר חנא,653,289,364,15,638,534,653,18,17%
2010-04,הצפון,975,זרזיר,296,119,177,2,294,208,293,9,12%
2010-04,הצפון,496,חורפיש,140,52,88,6,134,102,140,2,7%
2010-04,הצפון,2034,חצור הגלילית,307,122,185,5,302,160,298,38,7%
2010-04,הצפון,6700,טבריה,1853,802,1051,104,1749,1259,1755,127,9%
2010-04,הצפון,962,טובא-זנגרייה,358,154,204,2,356,246,351,15,13%
2010-04,הצפון,498,טורעאן,549,201,348,7,542,475,547,24,12%
2010-04,הצפון,8900,טמרה,2059,875,1184,20,2039,1815,2057,37,18%
2010-04,הצפון,1295,יאנוח-ג'ת,160,50,110,5,155,118,160,4,8%
2010-04,הצפון,46,יבנאל,125,77,48,5,120,92,118,3,9%
2010-04,הצפון,499,יפיע,646,278,368,9,637,498,643,29,10%
2010-04,הצפון,240,יקנעם עילית,538,204,334,109,429,240,536,41,5%
2010-04,הצפון,502,ירכא,439,173,266,2,437,355,438,7,10%
2010-04,הצפון,504,כאבול,756,336,420,15,741,639,754,14,18%
2010-04,הצפון,505,כאוכב אבו אל-היג'א,223,80,143,4,219,185,223,8,16%
2010-04,הצפון,1296,כסרא-סמיע,255,92,163,1,254,210,254,10,9%
2010-04,הצפון,978,כעביה-טבאש-חג'אג'רה,222,105,117,1,221,149,220,7,12%
2010-04,הצפון,1263,כפר ורדים,62,29,33,27,35,10,62,4,2%
2010-04,הצפון,507,כפר יאסיף,453,199,254,2,451,367,451,13,11%
2010-04,הצפון,508,כפר כמא,87,40,47,4,83,45,85,3,6%
2010-04,הצפון,509,כפר כנא,1223,494,729,21,1202,1038,1210,52,17%
2010-04,הצפון,510,כפר מנדא,879,404,475,10,869,685,867,37,15%
2010-04,הצפון,47,כפר תבור,43,15,28,19,24,6,43,1,3%
2010-04,הצפון,1139,כרמיאל,1790,694,1096,348,1442,995,1742,111,7%
2010-04,הצפון,481,מגאר,1447,568,879,32,1415,1267,1443,28,20%
2010-04,הצפון,516,מג'ד אל-כרום,675,290,385,9,666,539,674,10,13%
2010-04,הצפון,874,מגדל העמק,1059,442,617,99,960,529,1027,127,8%
2010-04,הצפון,4201,מג'דל שמס,466,166,300,22,444,408,461,2,12%
2010-04,הצפון,517,מזרעה,172,64,108,3,169,137,171,3,11%
2010-04,הצפון,4203,מסעדה,213,78,135,4,209,179,212,1,14%
2010-04,הצפון,518,מעיליא,65,34,31,12,53,34,65,4,5%
2010-04,הצפון,1063,מעלות-תרשיחא,1000,436,564,127,873,660,997,63,9%
2010-04,הצפון,520,משהד,336,126,210,6,330,281,333,10,13%
2010-04,הצפון,9100,נהרייה,2171,989,1182,255,1916,1383,2159,93,8%
2010-04,הצפון,522,נחף,465,198,267,12,453,396,464,9,11%
2010-04,הצפון,7300,נצרת,2031,985,1046,54,1977,1430,2026,60,7%
2010-04,הצפון,1061,נצרת עילית,1633,733,900,220,1413,838,1581,161,7%
2010-04,הצפון,525,סאג'ור,115,41,74,4,111,85,114,2,8%
2010-04,הצפון,7500,סח'נין,2019,918,1101,42,1977,1741,2019,42,18%
2010-04,הצפון,4501,ע'ג'ר,131,52,79,5,126,108,130,8,15%
2010-04,הצפון,530,עיילבון,193,82,111,11,182,150,191,4,9%
2010-04,הצפון,511,עילוט,332,141,191,4,328,258,331,13,14%
2010-04,הצפון,532,עין מאהל,463,234,229,2,461,370,458,13,11%
2010-04,הצפון,7600,עכו,3366,1519,1847,149,3217,2638,3347,135,14%
2010-04,הצפון,7700,עפולה,1888,810,1078,216,1672,1064,1839,138,8%
2010-04,הצפון,531,עראבה,1351,579,772,34,1317,1165,1350,41,17%
2010-04,הצפון,535,פסוטה,134,64,70,9,125,98,134,2,9%
2010-04,הצפון,536,פקיעין (בוקייעה),150,75,75,5,145,112,148,4,6%
2010-04,הצפון,8000,צפת,997,492,505,81,916,697,992,36,9%
2010-04,הצפון,4100,קצרין,187,78,109,35,152,107,186,7,5%
2010-04,הצפון,2800,קריית שמונה,835,371,464,67,768,368,820,93,7%
2010-04,הצפון,543,ראמה,333,141,192,9,324,259,331,5,10%
2010-04,הצפון,26,ראש פינה,45,17,28,7,38,19,45,2,3%
2010-04,הצפון,542,ריינה,636,259,377,9,627,513,632,30,11%
2010-04,הצפון,122,רמת ישי,107,43,64,36,71,10,107,4,3%
2010-04,הצפון,913,שבלי - אום אל-גנם,251,112,139,7,244,195,247,18,12%
2010-04,הצפון,812,שלומי,274,115,159,9,265,164,272,17,8%
2010-04,הצפון,538,שעב,482,200,282,5,477,417,481,12,19%
2010-04,הצפון,8800,שפרעם,2100,863,1237,25,2075,1749,2093,61,14%
2010-04,חיפה,2710,אום אל-פחם,3428,1441,1987,11,3417,2924,3424,52,20%
2010-04,חיפה,1020,אור עקיבא,628,289,339,47,581,212,609,54,7%
2010-04,חיפה,6000,באקה אל-גרביה,473,257,216,10,463,288,472,27,NULL
2010-04,חיפה,9800,בנימינה-גבעת עדה*,184,77,107,64,120,42,184,10,3%
2010-04,חיפה,1326,"בסמ""ה",280,152,128,3,277,197,280,10,9%
2010-04,חיפה,541,ג'סר א-זרקא,337,204,133,2,335,235,335,8,7%
2010-04,חיפה,628,ג'ת,158,77,81,4,154,95,158,4,NULL
2010-04,חיפה,494,דאלית אל-כרמל,499,211,288,14,485,307,497,30,7%
2010-04,חיפה,9300,זכרון יעקב,228,107,121,69,159,48,226,17,3%
2010-04,חיפה,6500,חדרה,2172,899,1273,259,1913,804,2133,161,5%
2010-04,חיפה,4000,חיפה,8783,3745,5038,1641,7142,5816,8734,434,7%
2010-04,חיפה,1247,חריש-קציר,25,12,13,2,23,10,25,1,2%
2010-04,חיפה,2100,טירת כרמל,817,358,459,25,792,548,812,48,8%
2010-04,חיפה,654,כפר קרע,284,138,146,7,277,151,283,13,4%
2010-04,חיפה,1327,מעלה עירון,823,347,476,2,821,679,821,18,17%
2010-04,חיפה,2500,נשר,616,275,341,133,483,331,615,31,5%
2010-04,חיפה,534,עספיא,326,135,191,9,317,212,325,8,7%
2010-04,חיפה,637,ערערה,415,193,222,5,410,248,415,26,6%
2010-04,חיפה,537,פוריידיס,356,187,169,5,351,250,355,15,8%
2010-04,חיפה,7800,פרדס חנה-כרכור,766,345,421,131,635,212,759,64,5%
2010-04,חיפה,6800,קריית אתא,2012,830,1182,162,1850,1269,2005,93,7%
2010-04,חיפה,9500,קריית ביאליק,1331,540,791,166,1165,759,1323,94,7%
2010-04,חיפה,2300,קריית טבעון,200,90,110,67,133,55,200,11,3%
2010-04,חיפה,9600,קריית ים,1924,819,1105,170,1754,1293,1917,137,10%
2010-04,חיפה,8200,קריית מוצקין,1258,475,783,181,1077,710,1248,77,6%
2010-04,חיפה,922,רכסים,157,73,84,9,148,110,156,2,6%
2010-04,ירושלים,472,אבו גוש,262,124,138,5,257,177,262,13,11%
2010-04,ירושלים,2610,בית שמש,1179,511,668,118,1061,597,1168,114,5%
2010-04,ירושלים,3000,ירושלים,8494,3769,4725,1193,7301,4693,8451,564,3%
2010-04,ירושלים,1015,מבשרת ציון,333,156,177,73,260,135,332,27,3%
2010-04,ירושלים,1137,קריית יערים,33,12,21,7,26,13,33,3,3%
2010-04,תל אביב,2400,אור יהודה,839,379,460,52,787,347,825,59,5%
2010-04,תל אביב,565,אזור,163,81,82,28,135,42,160,13,3%
2010-04,תל אביב,6100,בני ברק,2112,1010,1102,128,1984,1327,2101,90,5%
2010-04,תל אביב,6200,בת ים,3494,1544,1950,544,2950,1658,3425,255,5%
2010-04,תל אביב,6300,גבעתיים,699,311,388,299,400,120,690,33,3%
2010-04,תל אביב,6400,הרצלייה,1167,525,642,350,817,178,1138,123,3%
2010-04,תל אביב,6600,חולון,3146,1439,1707,517,2629,1119,3108,231,3%
2010-04,תל אביב,2620,קריית אונו,403,173,230,150,253,60,400,10,2%
2010-04,תל אביב,8600,רמת גן,2111,955,1156,673,1438,547,2090,147,3%
2010-04,תל אביב,2650,רמת השרון,407,166,241,166,241,40,407,29,2%
2010-04,תל אביב,5000,תל אביב -יפו,7892,3816,4076,2345,5547,3000,7826,477,3%
2010-05,אזור יהודה והשומרון,3760,אורנית,80,43,37,29,51,5,80,3,2%
2010-05,אזור יהודה והשומרון,3750,אלפי מנשה,103,39,64,30,73,5,103,6,3%
2010-05,אזור יהודה והשומרון,3560,אלקנה,32,18,14,15,17,3,32,3,2%
2010-05,אזור יהודה והשומרון,3650,אפרתה,46,26,20,19,27,4,46,2,1%
2010-05,אזור יהודה והשומרון,3570,אריאל,436,206,230,108,328,134,436,63,4%
2010-05,אזור יהודה והשומרון,3574,בית אל,45,18,27,23,22,15,44,4,2%
2010-05,אזור יהודה והשומרון,3652,בית אריה,63,31,32,10,53,5,63,5,3%
2010-05,אזור יהודה והשומרון,3780,ביתר עילית,363,166,197,17,346,195,359,19,4%
2010-05,אזור יהודה והשומרון,3730,גבעת זאב,166,74,92,19,147,38,165,12,3%
2010-05,אזור יהודה והשומרון,3769,הר אדר,24,9,15,14,10,3,24,2,1%
2010-05,אזור יהודה והשומרון,3797,מודיעין עילית,286,99,187,14,272,81,284,13,3%
2010-05,אזור יהודה והשומרון,3616,מעלה אדומים,675,266,409,103,572,238,666,65,4%
2010-05,אזור יהודה והשומרון,3660,עמנואל,85,44,41,4,81,61,85,4,9%
2010-05,אזור יהודה והשומרון,3557,קדומים,31,17,14,10,21,6,31,1,2%
2010-05,אזור יהודה והשומרון,3611,קריית ארבע,115,58,57,20,95,71,115,12,4%
2010-05,אזור יהודה והשומרון,3640,קרני שומרון,78,40,38,18,60,24,78,6,2%
2010-05,הדרום,31,אופקים,1408,580,828,88,1320,1017,1399,77,12%
2010-05,הדרום,2600,אילת,1419,657,762,76,1343,691,1400,96,5%
2010-05,הדרום,70,אשדוד,7309,2850,4459,839,6470,4523,7239,464,7%
2010-05,הדרום,7100,אשקלון,4641,1775,2866,709,3932,2885,4542,423,8%
2010-05,הדרום,9000,באר שבע,7989,3534,4455,1028,6961,5363,7935,567,8%
2010-05,הדרום,2200,דימונה,2126,945,1181,130,1996,1520,2097,110,12%
2010-05,הדרום,1303,חורה,704,304,400,0,704,643,704,5,23%
2010-05,הדרום,831,ירוחם,445,221,224,24,421,278,439,52,11%
2010-05,הדרום,1059,כסיפה,974,429,545,1,973,881,973,40,26%
2010-05,הדרום,1271,להבים,51,24,27,27,24,5,51,9,2%
2010-05,הדרום,1060,לקיה,903,426,477,2,901,831,901,8,28%
2010-05,הדרום,1268,מיתר,64,28,36,29,35,6,63,13,2%
2010-05,הדרום,99,מצפה רמון,235,90,145,21,214,124,217,36,10%
2010-05,הדרום,246,נתיבות,955,432,523,51,904,552,949,63,8%
2010-05,הדרום,666,עומר,56,26,30,25,31,7,56,3,2%
2010-05,הדרום,2560,ערד,954,393,561,165,789,636,931,86,8%
2010-05,הדרום,1192,ערערה-בנגב,952,385,567,2,950,859,951,8,30%
2010-05,הדרום,2630,קריית גת,2470,1021,1449,203,2267,1656,2461,169,10%
2010-05,הדרום,1034,קריית מלאכי,1304,571,733,32,1272,889,1284,102,12%
2010-05,הדרום,1161,רהט,2964,1204,1760,6,2958,2611,2961,88,21%
2010-05,הדרום,1286,שגב-שלום,561,244,317,3,558,499,560,7,27%
2010-05,הדרום,1031,שדרות,1112,451,661,60,1052,631,1109,54,10%
2010-05,הדרום,1054,תל שבע,1197,592,605,6,1191,1073,1194,8,31%
2010-05,המרכז,182,אבן יהודה,149,71,78,54,95,24,148,7,2%
2010-05,המרכז,41,אליכין,70,40,30,8,62,17,70,3,4%
2010-05,המרכז,1309,אלעד,363,165,198,25,338,116,362,21,3%
2010-05,המרכז,2530,באר יעקב,254,121,133,39,215,81,249,19,4%
2010-05,המרכז,466,בית דגן,109,53,56,17,92,38,108,12,3%
2010-05,המרכז,1066,"בני עי""ש",194,90,104,34,160,93,191,12,5%
2010-05,המרכז,681,גבעת שמואל,252,125,127,100,152,51,252,17,2%
2010-05,המרכז,2550,גדרה,337,143,194,76,261,107,333,8,3%
2010-05,המרכז,627,ג'לג'וליה,53,23,30,2,51,28,52,3,2%
2010-05,המרכז,166,גן יבנה,345,128,217,47,298,101,344,25,4%
2010-05,המרכז,229,גני תקווה,178,78,100,44,134,28,177,14,3%
2010-05,המרכז,9700,הוד השרון,626,280,346,206,420,77,622,44,2%
2010-05,המרכז,1290,זמר,175,55,120,1,174,138,175,7,7%
2010-05,המרכז,2730,טייבה,2075,902,1173,9,2066,1763,2064,43,14%
2010-05,המרכז,2720,טירה,329,162,167,10,319,201,328,12,4%
2010-05,המרכז,2660,יבנה,1031,489,542,75,956,491,1026,97,6%
2010-05,המרכז,9400,יהוד,569,261,308,91,478,85,540,40,4%
2010-05,המרכז,1224,כוכב יאיר,106,48,58,52,54,4,106,6,2%
2010-05,המרכז,633,כפר ברא,19,9,10,0,19,7,19,2,2%
2010-05,המרכז,168,כפר יונה,354,129,225,51,303,99,349,35,4%
2010-05,המרכז,6900,כפר סבא,1203,549,654,365,838,235,1194,77,3%
2010-05,המרכז,634,כפר קאסם,212,109,103,2,210,111,212,1,3%
2010-05,המרכז,7000,לוד,2246,985,1261,201,2045,1307,2235,186,7%
2010-05,המרכז,1200,מודיעין-מכבים-רעות*,911,373,538,360,551,73,900,90,2%
2010-05,המרכז,28,מזכרת בתיה,167,65,102,23,144,37,166,5,3%
2010-05,המרכז,7200,נס ציונה,682,313,369,149,533,217,677,33,3%
2010-05,המרכז,7400,נתניה,5173,2232,2941,787,4386,2369,5096,624,5%
2010-05,המרכז,587,סביון*,14,6,8,7,7,1,13,4,1%
2010-05,המרכז,171,פרדסייה,76,32,44,18,58,9,75,9,2%
2010-05,המרכז,7900,פתח תקווה,4278,1940,2338,849,3429,1289,4249,335,4%
2010-05,המרכז,195,קדימה-צורן,239,115,124,75,164,39,236,18,3%
2010-05,המרכז,638,קלנסווה,857,328,529,1,856,727,853,14,12%
2010-05,המרכז,469,קריית עקרון,265,126,139,14,251,125,263,17,5%
2010-05,המרכז,2640,ראש העין,775,403,372,79,696,189,759,71,4%
2010-05,המרכז,8300,ראשון לציון,4855,2123,2732,923,3932,1882,4829,389,4%
2010-05,המרכז,8400,רחובות,2575,1131,1444,536,2039,1061,2538,127,4%
2010-05,המרכז,8500,רמלה,1904,883,1021,120,1784,901,1866,181,6%
2010-05,המרכז,8700,רעננה,745,354,391,287,458,87,740,47,2%
2010-05,המרכז,1304,שוהם,197,89,108,92,105,2,197,15,2%
2010-05,המרכז,154,תל מונד,142,66,76,46,96,18,142,10,3%
2010-05,הצפון,473,אבו סנאן,712,267,445,9,703,589,708,14,15%
2010-05,הצפון,478,אכסאל,663,282,381,19,644,556,662,18,14%
2010-05,הצפון,529,אעבלין,679,290,389,14,665,564,679,14,14%
2010-05,הצפון,482,בועיינה-נוג'ידאת,537,227,310,5,532,448,533,3,17%
2010-05,הצפון,4001,בוקעאתא,401,176,225,2,399,332,391,3,17%
2010-05,הצפון,998,ביר אל-מכסור,417,157,260,4,413,334,417,7,14%
2010-05,הצפון,480,בית ג'ן,330,109,221,3,327,247,326,10,8%
2010-05,הצפון,9200,בית שאן,787,355,432,18,769,450,783,93,9%
2010-05,הצפון,944,בסמת טבעון,307,126,181,2,305,243,307,11,11%
2010-05,הצפון,483,בענה,459,181,278,1,458,410,459,8,16%
2010-05,הצפון,1292,ג'דיידה-מכר,1448,609,839,7,1441,1240,1448,30,19%
2010-05,הצפון,485,ג'ולס,230,77,153,4,226,136,230,12,10%
2010-05,הצפון,487,ג'ש (גוש חלב),62,26,36,8,54,32,62,3,4%
2010-05,הצפון,489,דבורייה,408,188,220,23,385,316,407,7,11%
2010-05,הצפון,490,דייר אל-אסד,431,170,261,5,426,350,431,7,10%
2010-05,הצפון,492,דייר חנא,659,294,365,15,644,526,659,21,17%
2010-05,הצפון,975,זרזיר,283,118,165,1,282,202,280,7,12%
2010-05,הצפון,496,חורפיש,138,49,89,4,134,101,138,4,7%
2010-05,הצפון,2034,חצור הגלילית,294,121,173,7,287,147,289,53,7%
2010-05,הצפון,6700,טבריה,1827,769,1058,104,1723,1252,1733,106,9%
2010-05,הצפון,962,טובא-זנגרייה,383,161,222,2,381,249,378,11,14%
2010-05,הצפון,498,טורעאן,529,192,337,10,519,469,527,9,12%
2010-05,הצפון,8900,טמרה,2031,851,1180,20,2011,1795,2029,34,17%
2010-05,הצפון,1295,יאנוח-ג'ת,163,49,114,5,158,119,163,7,8%
2010-05,הצפון,46,יבנאל,117,75,42,5,112,95,111,2,8%
2010-05,הצפון,499,יפיע,637,267,370,9,628,499,632,20,10%
2010-05,הצפון,240,יקנעם עילית,502,195,307,101,401,218,501,50,5%
2010-05,הצפון,502,ירכא,468,184,284,3,465,370,467,15,10%
2010-05,הצפון,504,כאבול,740,317,423,15,725,639,738,11,18%
2010-05,הצפון,505,כאוכב אבו אל-היג'א,220,81,139,4,216,183,220,10,16%
2010-05,הצפון,1296,כסרא-סמיע,255,97,158,1,254,205,254,8,9%
2010-05,הצפון,978,כעביה-טבאש-חג'אג'רה,211,95,116,2,209,147,209,5,11%
2010-05,הצפון,1263,כפר ורדים,58,29,29,25,33,6,58,3,2%
2010-05,הצפון,507,כפר יאסיף,456,199,257,2,454,371,452,11,11%
2010-05,הצפון,508,כפר כמא,77,35,42,3,74,44,75,3,6%
2010-05,הצפון,509,כפר כנא,1184,480,704,17,1167,1019,1173,30,16%
2010-05,הצפון,510,כפר מנדא,870,389,481,9,861,687,859,28,15%
2010-05,הצפון,47,כפר תבור,48,19,29,22,26,7,48,3,3%
2010-05,הצפון,1139,כרמיאל,1780,688,1092,341,1439,989,1723,126,7%
2010-05,הצפון,481,מגאר,1487,584,903,33,1454,1278,1483,68,20%
2010-05,הצפון,516,מג'ד אל-כרום,663,276,387,8,655,532,662,16,13%
2010-05,הצפון,874,מגדל העמק,1073,457,616,99,974,531,1041,149,8%
2010-05,הצפון,4201,מג'דל שמס,486,173,313,21,465,417,479,4,12%
2010-05,הצפון,517,מזרעה,161,60,101,3,158,133,160,4,10%
2010-05,הצפון,4203,מסעדה,213,78,135,6,207,180,212,1,14%
2010-05,הצפון,518,מעיליא,62,33,29,9,53,36,62,2,4%
2010-05,הצפון,1063,מעלות-תרשיחא,1023,456,567,117,906,664,1020,63,9%
2010-05,הצפון,520,משהד,328,125,203,5,323,264,327,12,13%
2010-05,הצפון,9100,נהרייה,2178,978,1200,252,1926,1394,2163,112,8%
2010-05,הצפון,522,נחף,463,190,273,10,453,396,462,7,11%
2010-05,הצפון,7300,נצרת,2777,1240,1537,60,2717,2148,2760,210,10%
2010-05,הצפון,1061,נצרת עילית,2025,818,1207,244,1781,1273,1930,386,8%
2010-05,הצפון,525,סאג'ור,123,49,74,4,119,89,122,2,9%
2010-05,הצפון,7500,סח'נין,2043,940,1103,43,2000,1768,2043,50,18%
2010-05,הצפון,4501,ע'ג'ר,125,46,79,2,123,104,124,11,14%
2010-05,הצפון,530,עיילבון,195,82,113,11,184,153,194,6,9%
2010-05,הצפון,511,עילוט,334,141,193,5,329,258,333,14,14%
2010-05,הצפון,532,עין מאהל,625,284,341,3,622,530,617,54,14%
2010-05,הצפון,7600,עכו,3390,1544,1846,152,3238,2651,3370,138,14%
2010-05,הצפון,7700,עפולה,1916,814,1102,207,1709,1062,1858,164,9%
2010-05,הצפון,531,עראבה,1371,583,788,34,1337,1176,1370,47,17%
2010-05,הצפון,535,פסוטה,133,64,69,8,125,95,133,0,9%
2010-05,הצפון,536,פקיעין (בוקייעה),155,78,77,6,149,116,153,1,7%
2010-05,הצפון,8000,צפת,982,501,481,79,903,714,978,34,9%
2010-05,הצפון,4100,קצרין,186,75,111,35,151,102,184,8,5%
2010-05,הצפון,2800,קריית שמונה,804,367,437,52,752,371,787,122,6%
2010-05,הצפון,543,ראמה,334,146,188,6,328,259,330,8,10%
2010-05,הצפון,26,ראש פינה,48,18,30,6,42,21,48,5,4%
2010-05,הצפון,542,ריינה,642,264,378,11,631,517,637,30,11%
2010-05,הצפון,122,רמת ישי,106,42,64,32,74,9,105,9,3%
2010-05,הצפון,913,שבלי - אום אל-גנם,235,109,126,8,227,187,232,10,11%
2010-05,הצפון,812,שלומי,278,115,163,11,267,162,276,14,8%
2010-05,הצפון,538,שעב,474,195,279,5,469,414,473,18,19%
2010-05,הצפון,8800,שפרעם,2103,852,1251,18,2085,1757,2096,82,14%
2010-05,חיפה,2710,אום אל-פחם,3446,1440,2006,11,3435,2946,3442,66,20%
2010-05,חיפה,1020,אור עקיבא,666,285,381,46,620,266,652,104,7%
2010-05,חיפה,6000,באקה אל-גרביה,549,275,274,14,535,348,548,27,NULL
2010-05,חיפה,9800,בנימינה-גבעת עדה*,182,77,105,59,123,48,182,16,3%
2010-05,חיפה,1326,"בסמ""ה",339,165,174,4,335,253,339,23,11%
2010-05,חיפה,541,ג'סר א-זרקא,386,209,177,1,385,250,384,13,8%
2010-05,חיפה,628,ג'ת,191,88,103,5,186,124,191,21,NULL
2010-05,חיפה,494,דאלית אל-כרמל,523,223,300,13,510,311,518,25,8%
2010-05,חיפה,9300,זכרון יעקב,214,98,116,58,156,46,214,18,2%
2010-05,חיפה,6500,חדרה,2445,954,1491,268,2177,1040,2404,210,5%
2010-05,חיפה,4000,חיפה,8776,3774,5002,1648,7128,5807,8720,506,7%
2010-05,חיפה,1247,חריש-קציר,27,11,16,2,25,13,26,1,2%
2010-05,חיפה,2100,טירת כרמל,817,358,459,26,791,540,812,44,8%
2010-05,חיפה,654,כפר קרע,312,147,165,9,303,177,310,16,5%
2010-05,חיפה,1327,מעלה עירון,820,332,488,2,818,683,818,14,17%
2010-05,חיפה,2500,נשר,614,271,343,126,488,333,613,25,5%
2010-05,חיפה,534,עספיא,342,138,204,11,331,219,340,22,7%
2010-05,חיפה,637,ערערה,457,199,258,4,453,299,457,22,7%
2010-05,חיפה,537,פוריידיס,353,177,176,4,349,252,350,9,8%
2010-05,חיפה,7800,פרדס חנה-כרכור,839,353,486,136,703,270,831,102,5%
2010-05,חיפה,6800,קריית אתא,2007,814,1193,149,1858,1266,1996,132,7%
2010-05,חיפה,9500,קריית ביאליק,1330,527,803,174,1156,738,1323,99,7%
2010-05,חיפה,2300,קריית טבעון,199,89,110,71,128,51,199,11,3%
2010-05,חיפה,9600,קריית ים,1889,806,1083,164,1725,1289,1885,125,9%
2010-05,חיפה,8200,קריית מוצקין,1251,476,775,192,1059,688,1239,83,6%
2010-05,חיפה,922,רכסים,150,73,77,8,142,111,149,3,6%
2010-05,ירושלים,472,אבו גוש,260,123,137,5,255,175,260,12,11%
2010-05,ירושלים,2610,בית שמש,1149,513,636,112,1037,556,1138,120,5%
2010-05,ירושלים,3000,ירושלים,9712,4273,5439,1257,8455,5813,9624,768,4%
2010-05,ירושלים,1015,מבשרת ציון,348,163,185,82,266,139,347,20,3%
2010-05,ירושלים,1137,קריית יערים,29,10,19,8,21,12,29,2,3%
2010-05,תל אביב,2400,אור יהודה,824,371,453,42,782,343,807,59,5%
2010-05,תל אביב,565,אזור,161,75,86,30,131,47,160,21,3%
2010-05,תל אביב,6100,בני ברק,2112,1016,1096,113,1999,1322,2100,125,5%
2010-05,תל אביב,6200,בת ים,3576,1595,1981,551,3025,1669,3504,273,5%
2010-05,תל אביב,6300,גבעתיים,721,314,407,306,415,120,714,39,3%
2010-05,תל אביב,6400,הרצלייה,1175,551,624,346,829,178,1141,148,3%
2010-05,תל אביב,6600,חולון,3277,1511,1766,532,2745,1149,3224,302,3%
2010-05,תל אביב,2620,קריית אונו,445,206,239,149,296,63,440,37,3%
2010-05,תל אביב,8600,רמת גן,2115,949,1166,677,1438,566,2096,136,3%
2010-05,תל אביב,2650,רמת השרון,409,180,229,163,246,40,405,38,2%
2010-05,תל אביב,5000,תל אביב -יפו,7919,3855,4064,2332,5587,3022,7842,481,3%
2010-06,אזור יהודה והשומרון,3760,אורנית,115,62,53,30,85,6,115,12,3%
2010-06,אזור יהודה והשומרון,3750,אלפי מנשה,146,65,81,22,124,3,146,12,4%
2010-06,אזור יהודה והשומרון,3560,אלקנה,48,29,19,17,31,3,48,5,3%
2010-06,אזור יהודה והשומרון,3650,אפרתה,126,76,50,21,105,5,126,3,4%
2010-06,אזור יהודה והשומרון,3570,אריאל,498,240,258,102,396,130,497,56,5%
2010-06,אזור יהודה והשומרון,3574,בית אל,54,21,33,25,29,18,53,3,2%
2010-06,אזור יהודה והשומרון,3652,בית אריה,91,42,49,11,80,5,91,12,4%
2010-06,אזור יהודה והשומרון,3780,ביתר עילית,364,152,212,13,351,197,360,11,4%
2010-06,אזור יהודה והשומרון,3730,גבעת זאב,212,96,116,22,190,40,210,18,3%
2010-06,אזור יהודה והשומרון,3769,הר אדר,36,18,18,12,24,3,36,1,2%
2010-06,אזור יהודה והשומרון,3797,מודיעין עילית,292,100,192,14,278,89,290,14,3%
2010-06,אזור יהודה והשומרון,3616,מעלה אדומים,722,298,424,106,616,229,714,68,4%
2010-06,אזור יהודה והשומרון,3660,עמנואל,97,51,46,4,93,65,96,7,10%
2010-06,אזור יהודה והשומרון,3557,קדומים,38,19,19,13,25,5,38,1,2%
2010-06,אזור יהודה והשומרון,3611,קריית ארבע,123,60,63,20,103,66,123,13,4%
2010-06,אזור יהודה והשומרון,3640,קרני שומרון,101,49,52,18,83,20,101,7,3%
2010-06,הדרום,31,אופקים,1480,644,836,85,1395,1022,1469,73,13%
2010-06,הדרום,2600,אילת,1726,797,929,81,1645,694,1713,116,6%
2010-06,הדרום,70,אשדוד,7609,3012,4597,849,6760,4474,7532,461,8%
2010-06,הדרום,7100,אשקלון,5127,1955,3172,715,4412,2974,5013,661,9%
2010-06,הדרום,9000,באר שבע,8554,3817,4737,1014,7540,5335,8499,1218,9%
2010-06,הדרום,2200,דימונה,2234,1035,1199,128,2106,1535,2201,213,12%
2010-06,הדרום,1303,חורה,723,320,403,0,723,655,723,10,24%
2010-06,הדרום,831,ירוחם,515,264,251,24,491,284,509,85,12%
2010-06,הדרום,1059,כסיפה,952,426,526,1,951,873,951,10,26%
2010-06,הדרום,1271,להבים,68,35,33,22,46,4,68,33,2%
2010-06,הדרום,1060,לקיה,915,439,476,3,912,833,912,11,28%
2010-06,הדרום,1268,מיתר,86,35,51,25,61,5,85,46,2%
2010-06,הדרום,99,מצפה רמון,287,105,182,23,264,130,264,71,12%
2010-06,הדרום,246,נתיבות,1172,515,657,55,1117,566,1165,183,10%
2010-06,הדרום,666,עומר,89,37,52,25,64,7,89,36,2%
2010-06,הדרום,2560,ערד,1003,423,580,172,831,638,973,169,8%
2010-06,הדרום,1192,ערערה-בנגב,963,396,567,1,962,868,963,8,30%
2010-06,הדרום,2630,קריית גת,2617,1087,1530,207,2410,1683,2610,197,10%
2010-06,הדרום,1034,קריית מלאכי,1446,644,802,32,1414,881,1416,202,13%
2010-06,הדרום,1161,רהט,3061,1282,1779,6,3055,2653,3058,133,22%
2010-06,הדרום,1286,שגב-שלום,572,246,326,2,570,510,571,13,27%
2010-06,הדרום,1031,שדרות,1295,537,758,63,1232,641,1291,71,11%
2010-06,הדרום,1054,תל שבע,1222,614,608,5,1217,1088,1219,19,31%
2010-06,המרכז,182,אבן יהודה,164,83,81,48,116,21,164,8,3%
2010-06,המרכז,41,אליכין,67,35,32,7,60,15,67,5,4%
2010-06,המרכז,1309,אלעד,398,177,221,25,373,115,396,21,4%
2010-06,המרכז,2530,באר יעקב,272,127,145,36,236,86,266,16,4%
2010-06,המרכז,466,בית דגן,148,78,70,19,129,34,147,8,4%
2010-06,המרכז,1066,"בני עי""ש",218,105,113,32,186,88,216,13,6%
2010-06,המרכז,681,גבעת שמואל,377,177,200,100,277,48,377,15,4%
2010-06,המרכז,2550,גדרה,422,208,214,75,347,111,417,18,4%
2010-06,המרכז,627,ג'לג'וליה,77,42,35,3,74,29,77,4,3%
2010-06,המרכז,166,גן יבנה,392,142,250,53,339,101,391,22,4%
2010-06,המרכז,229,גני תקווה,238,113,125,48,190,28,237,14,3%
2010-06,המרכז,9700,הוד השרון,890,462,428,189,701,71,886,61,4%
2010-06,המרכז,1290,זמר,176,57,119,1,175,139,176,6,7%
2010-06,המרכז,2730,טייבה,2111,921,1190,4,2107,1754,2100,40,14%
2010-06,המרכז,2720,טירה,334,165,169,9,325,201,333,15,4%
2010-06,המרכז,2660,יבנה,1190,542,648,80,1110,482,1188,106,7%
2010-06,המרכז,9400,יהוד,678,315,363,91,587,90,652,86,4%
2010-06,המרכז,1224,כוכב יאיר,137,64,73,45,92,4,137,11,3%
2010-06,המרכז,633,כפר ברא,19,9,10,0,19,9,19,2,2%
2010-06,המרכז,168,כפר יונה,429,157,272,61,368,93,426,29,4%
2010-06,המרכז,6900,כפר סבא,1521,724,797,357,1164,233,1511,130,3%
2010-06,המרכז,634,כפר קאסם,225,119,106,3,222,115,225,6,3%
2010-06,המרכז,7000,לוד,2419,1071,1348,200,2219,1295,2403,185,7%
2010-06,המרכז,1200,מודיעין-מכבים-רעות*,1497,676,821,347,1150,79,1483,196,4%
2010-06,המרכז,28,מזכרת בתיה,253,118,135,27,226,36,251,15,4%
2010-06,המרכז,7200,נס ציונה,811,386,425,143,668,212,806,31,4%
2010-06,המרכז,7400,נתניה,5743,2595,3148,758,4985,2255,5673,593,6%
2010-06,המרכז,587,סביון*,15,4,11,6,9,1,15,2,1%
2010-06,המרכז,171,פרדסייה,101,44,57,22,79,10,100,10,3%
2010-06,המרכז,7900,פתח תקווה,5604,2599,3005,789,4815,1261,5567,434,5%
2010-06,המרכז,195,קדימה-צורן,310,138,172,80,230,38,307,20,4%
2010-06,המרכז,638,קלנסווה,874,342,532,1,873,736,870,16,12%
2010-06,המרכז,469,קריית עקרון,323,158,165,11,312,123,320,18,6%
2010-06,המרכז,2640,ראש העין,1008,517,491,92,916,195,986,94,5%
2010-06,המרכז,8300,ראשון לציון,5694,2535,3159,917,4777,1853,5661,569,4%
2010-06,המרכז,8400,רחובות,2878,1282,1596,521,2357,1061,2844,136,5%
2010-06,המרכז,8500,רמלה,1984,929,1055,106,1878,885,1954,167,6%
2010-06,המרכז,8700,רעננה,1099,548,551,263,836,88,1095,61,3%
2010-06,המרכז,1304,שוהם,541,228,313,94,447,2,541,18,5%
2010-06,המרכז,154,תל מונד,158,64,94,43,115,22,158,9,3%
2010-06,הצפון,473,אבו סנאן,730,276,454,7,723,595,726,16,15%
2010-06,הצפון,478,אכסאל,639,265,374,19,620,530,638,31,14%
2010-06,הצפון,529,אעבלין,679,288,391,12,667,565,679,11,14%
2010-06,הצפון,482,בועיינה-נוג'ידאת,545,229,316,7,538,444,541,25,17%
2010-06,הצפון,4001,בוקעאתא,386,167,219,2,384,322,376,3,16%
2010-06,הצפון,998,ביר אל-מכסור,413,156,257,2,411,335,413,7,14%
2010-06,הצפון,480,בית ג'ן,342,107,235,5,337,252,337,4,8%
2010-06,הצפון,9200,בית שאן,885,398,487,15,870,459,883,100,9%
2010-06,הצפון,944,בסמת טבעון,302,122,180,3,299,240,302,9,11%
2010-06,הצפון,483,בענה,454,180,274,0,454,403,454,4,16%
2010-06,הצפון,1292,ג'דיידה-מכר,1461,616,845,6,1455,1248,1461,31,19%
2010-06,הצפון,485,ג'ולס,241,76,165,3,238,137,241,8,10%
2010-06,הצפון,487,ג'ש (גוש חלב),71,28,43,8,63,35,71,0,5%
2010-06,הצפון,489,דבורייה,439,207,232,24,415,322,438,10,12%
2010-06,הצפון,490,דייר אל-אסד,433,173,260,6,427,345,433,7,11%
2010-06,הצפון,492,דייר חנא,662,300,362,15,647,524,662,29,17%
2010-06,הצפון,975,זרזיר,272,122,150,1,271,191,268,8,11%
2010-06,הצפון,496,חורפיש,147,58,89,5,142,101,147,9,7%
2010-06,הצפון,2034,חצור הגלילית,352,159,193,9,343,150,345,49,8%
2010-06,הצפון,6700,טבריה,1969,842,1127,100,1869,1254,1867,155,9%
2010-06,הצפון,962,טובא-זנגרייה,403,175,228,5,398,262,397,9,15%
2010-06,הצפון,498,טורעאן,536,207,329,10,526,458,534,10,12%
2010-06,הצפון,8900,טמרה,2042,857,1185,27,2015,1790,2039,58,18%
2010-06,הצפון,1295,יאנוח-ג'ת,173,58,115,5,168,118,173,9,8%
2010-06,הצפון,46,יבנאל,132,83,49,5,127,103,126,1,10%
2010-06,הצפון,499,יפיע,670,305,365,13,657,501,667,27,10%
2010-06,הצפון,240,יקנעם עילית,588,251,337,98,490,228,586,45,6%
2010-06,הצפון,502,ירכא,516,194,322,3,513,384,515,14,11%
2010-06,הצפון,504,כאבול,753,328,425,14,739,646,751,11,18%
2010-06,הצפון,505,כאוכב אבו אל-היג'א,214,81,133,3,211,177,214,8,15%
2010-06,הצפון,1296,כסרא-סמיע,260,106,154,1,259,200,259,18,10%
2010-06,הצפון,978,כעביה-טבאש-חג'אג'רה,210,98,112,2,208,148,208,3,11%
2010-06,הצפון,1263,כפר ורדים,104,50,54,27,77,8,104,29,4%
2010-06,הצפון,507,כפר יאסיף,492,222,270,5,487,375,489,12,12%
2010-06,הצפון,508,כפר כמא,87,39,48,4,83,44,85,5,6%
2010-06,הצפון,509,כפר כנא,1214,509,705,14,1200,1012,1202,25,17%
2010-06,הצפון,510,כפר מנדא,872,381,491,6,866,688,863,25,15%
2010-06,הצפון,47,כפר תבור,64,28,36,19,45,8,64,2,4%
2010-06,הצפון,1139,כרמיאל,1907,757,1150,330,1577,986,1848,127,7%
2010-06,הצפון,481,מגאר,1471,580,891,34,1437,1246,1469,62,20%
2010-06,הצפון,516,מג'ד אל-כרום,683,291,392,6,677,540,682,9,13%
2010-06,הצפון,874,מגדל העמק,1178,505,673,97,1081,528,1143,170,9%
2010-06,הצפון,4201,מג'דל שמס,507,189,318,22,485,410,500,24,13%
2010-06,הצפון,517,מזרעה,164,63,101,4,160,130,163,6,10%
2010-06,הצפון,4203,מסעדה,210,82,128,5,205,178,209,8,14%
2010-06,הצפון,518,מעיליא,63,32,31,6,57,34,63,5,5%
2010-06,הצפון,1063,מעלות-תרשיחא,1029,456,573,114,915,641,1026,98,9%
2010-06,הצפון,520,משהד,334,130,204,3,331,270,333,17,13%
2010-06,הצפון,9100,נהרייה,2291,1041,1250,266,2025,1355,2272,167,8%
2010-06,הצפון,522,נחף,468,197,271,11,457,391,467,13,12%
2010-06,הצפון,7300,נצרת,2903,1354,1549,73,2830,2119,2890,155,10%
2010-06,הצפון,1061,נצרת עילית,2070,914,1156,223,1847,1149,1988,279,9%
2010-06,הצפון,525,סאג'ור,121,48,73,2,119,84,119,4,8%
2010-06,הצפון,7500,סח'נין,2049,945,1104,43,2006,1748,2049,71,18%
2010-06,הצפון,4501,ע'ג'ר,113,45,68,3,110,94,112,14,13%
2010-06,הצפון,530,עיילבון,205,87,118,11,194,160,204,19,10%
2010-06,הצפון,511,עילוט,332,143,189,4,328,261,331,10,14%
2010-06,הצפון,532,עין מאהל,614,282,332,6,608,531,604,34,14%
2010-06,הצפון,7600,עכו,3451,1595,1856,143,3308,2623,3435,148,14%
2010-06,הצפון,7700,עפולה,2168,949,1219,200,1968,1079,2109,192,10%
2010-06,הצפון,531,עראבה,1344,572,772,34,1310,1158,1343,37,17%
2010-06,הצפון,535,פסוטה,132,65,67,7,125,96,132,5,9%
2010-06,הצפון,536,פקיעין (בוקייעה),159,78,81,9,150,118,157,7,7%
2010-06,הצפון,8000,צפת,1025,537,488,75,950,711,1021,97,9%
2010-06,הצפון,4100,קצרין,250,114,136,32,218,103,248,7,7%
2010-06,הצפון,2800,קריית שמונה,852,408,444,61,791,351,836,115,7%
2010-06,הצפון,543,ראמה,342,147,195,7,335,267,341,6,11%
2010-06,הצפון,26,ראש פינה,51,18,33,6,45,19,51,4,4%
2010-06,הצפון,542,ריינה,659,281,378,13,646,508,654,31,12%
2010-06,הצפון,122,רמת ישי,131,53,78,35,96,9,131,10,4%
2010-06,הצפון,913,שבלי - אום אל-גנם,232,103,129,9,223,187,231,11,11%
2010-06,הצפון,812,שלומי,276,117,159,10,266,166,274,17,8%
2010-06,הצפון,538,שעב,474,199,275,3,471,411,473,7,19%
2010-06,הצפון,8800,שפרעם,2111,865,1246,20,2091,1727,2103,57,14%
2010-06,חיפה,2710,אום אל-פחם,3457,1472,1985,10,3447,2928,3454,49,21%
2010-06,חיפה,1020,אור עקיבא,730,320,410,47,683,251,711,83,8%
2010-06,חיפה,6000,באקה אל-גרביה,581,306,275,13,568,354,580,44,NULL
2010-06,חיפה,9800,בנימינה-גבעת עדה*,219,100,119,58,161,46,217,13,4%
2010-06,חיפה,1326,"בסמ""ה",353,175,178,4,349,264,353,10,11%
2010-06,חיפה,541,ג'סר א-זרקא,392,221,171,3,389,255,390,9,8%
2010-06,חיפה,628,ג'ת,198,98,100,7,191,123,198,20,NULL
2010-06,חיפה,494,דאלית אל-כרמל,502,213,289,12,490,303,499,25,7%
2010-06,חיפה,9300,זכרון יעקב,265,111,154,65,200,48,264,13,3%
2010-06,חיפה,6500,חדרה,2749,1111,1638,273,2476,1020,2701,247,6%
2010-06,חיפה,4000,חיפה,9297,4065,5232,1637,7660,5806,9246,750,7%
2010-06,חיפה,1247,חריש-קציר,27,13,14,2,25,15,27,3,2%
2010-06,חיפה,2100,טירת כרמל,842,378,464,22,820,533,834,57,9%
2010-06,חיפה,654,כפר קרע,340,169,171,10,330,188,338,27,5%
2010-06,חיפה,1327,מעלה עירון,835,332,503,1,834,693,833,15,18%
2010-06,חיפה,2500,נשר,703,314,389,120,583,339,702,77,6%
2010-06,חיפה,534,עספיא,326,140,186,9,317,204,324,17,7%
2010-06,חיפה,637,ערערה,507,231,276,5,502,321,507,23,8%
2010-06,חיפה,537,פוריידיס,367,185,182,3,364,248,365,15,8%
2010-06,חיפה,7800,פרדס חנה-כרכור,938,415,523,141,797,259,928,93,6%
2010-06,חיפה,6800,קריית אתא,2176,916,1260,150,2026,1292,2168,148,8%
2010-06,חיפה,9500,קריית ביאליק,1368,549,819,175,1193,734,1359,76,7%
2010-06,חיפה,2300,קריית טבעון,240,106,134,72,168,53,240,31,3%
2010-06,חיפה,9600,קריית ים,1947,834,1113,165,1782,1249,1940,133,10%
2010-06,חיפה,8200,קריית מוצקין,1336,543,793,193,1143,670,1324,89,6%
2010-06,חיפה,922,רכסים,155,75,80,8,147,108,154,6,6%
2010-06,ירושלים,472,אבו גוש,259,119,140,10,249,176,259,18,11%
2010-06,ירושלים,2610,בית שמש,1278,592,686,114,1164,579,1264,190,5%
2010-06,ירושלים,3000,ירושלים,10500,4713,5787,1230,9270,5694,10432,860,4%
2010-06,ירושלים,1015,מבשרת ציון,408,185,223,84,324,142,407,33,3%
2010-06,ירושלים,1137,קריית יערים,31,13,18,10,21,13,30,2,3%
2010-06,תל אביב,2400,אור יהודה,947,435,512,43,904,332,927,83,5%
2010-06,תל אביב,565,אזור,212,97,115,26,186,44,211,18,4%
2010-06,תל אביב,6100,בני ברק,2221,1046,1175,109,2112,1315,2207,118,5%
2010-06,תל אביב,6200,בת ים,4186,1941,2245,540,3646,1631,4115,341,6%
2010-06,תל אביב,6300,גבעתיים,845,365,480,304,541,128,834,71,3%
2010-06,תל אביב,6400,הרצלייה,1503,704,799,323,1180,177,1478,434,3%
2010-06,תל אביב,6600,חולון,3993,1876,2117,522,3471,1112,3946,431,4%
2010-06,תל אביב,2620,קריית אונו,533,248,285,150,383,52,530,65,3%
2010-06,תל אביב,8600,רמת גן,2579,1195,1384,663,1916,557,2562,196,4%
2010-06,תל אביב,2650,רמת השרון,597,292,305,169,428,44,592,193,3%
2010-06,תל אביב,5000,תל אביב -יפו,8720,4280,4440,2300,6420,3038,8644,626,4%
2010-07,אזור יהודה והשומרון,3760,אורנית,129,59,70,39,90,5,129,9,3%
2010-07,אזור יהודה והשומרון,3750,אלפי מנשה,104,44,60,23,81,2,103,4,3%
2010-07,אזור יהודה והשומרון,3560,אלקנה,46,21,25,21,25,3,46,2,3%
2010-07,אזור יהודה והשומרון,3650,אפרתה,88,44,44,20,68,3,88,3,2%
2010-07,אזור יהודה והשומרון,3570,אריאל,451,208,243,98,353,129,451,36,5%
2010-07,אזור יהודה והשומרון,3574,בית אל,59,27,32,22,37,18,58,9,3%
2010-07,אזור יהודה והשומרון,3652,בית אריה,88,39,49,9,79,3,88,7,4%
2010-07,אזור יהודה והשומרון,3780,ביתר עילית,517,198,319,14,503,206,511,16,6%
2010-07,אזור יהודה והשומרון,3730,גבעת זאב,223,96,127,26,197,41,223,14,4%
2010-07,אזור יהודה והשומרון,3769,הר אדר,43,20,23,14,29,4,43,1,2%
2010-07,אזור יהודה והשומרון,3797,מודיעין עילית,514,124,390,20,494,87,508,15,5%
2010-07,אזור יהודה והשומרון,3616,מעלה אדומים,734,293,441,108,626,236,727,76,4%
2010-07,אזור יהודה והשומרון,3660,עמנואל,92,48,44,2,90,60,92,2,10%
2010-07,אזור יהודה והשומרון,3557,קדומים,29,15,14,12,17,6,29,3,2%
2010-07,אזור יהודה והשומרון,3611,קריית ארבע,164,83,81,22,142,70,164,11,6%
2010-07,אזור יהודה והשומרון,3640,קרני שומרון,92,54,38,22,70,20,92,6,3%
2010-07,הדרום,31,אופקים,1552,642,910,94,1458,1020,1537,75,13%
2010-07,הדרום,2600,אילת,1578,694,884,93,1485,685,1563,121,5%
2010-07,הדרום,70,אשדוד,8144,3140,5004,896,7248,4486,8071,464,8%
2010-07,הדרום,7100,אשקלון,5015,1879,3136,744,4271,2845,4912,518,8%
2010-07,הדרום,9000,באר שבע,8486,3761,4725,1081,7405,5360,8435,948,9%
2010-07,הדרום,2200,דימונה,2286,975,1311,126,2160,1544,2250,145,13%
2010-07,הדרום,1303,חורה,723,313,410,0,723,656,723,8,24%
2010-07,הדרום,831,ירוחם,558,279,279,22,536,292,551,101,13%
2010-07,הדרום,1059,כסיפה,995,443,552,1,994,900,993,24,27%
2010-07,הדרום,1271,להבים,59,31,28,24,35,3,59,23,2%
2010-07,הדרום,1060,לקיה,927,433,494,4,923,839,925,20,29%
2010-07,הדרום,1268,מיתר,86,34,52,21,65,6,85,30,2%
2010-07,הדרום,99,מצפה רמון,278,113,165,23,255,136,258,52,11%
2010-07,הדרום,246,נתיבות,1181,481,700,58,1123,572,1174,140,10%
2010-07,הדרום,666,עומר,72,37,35,24,48,8,72,22,2%
2010-07,הדרום,2560,ערד,1043,441,602,168,875,618,1012,174,8%
2010-07,הדרום,1192,ערערה-בנגב,956,382,574,1,955,876,955,7,30%
2010-07,הדרום,2630,קריית גת,2635,1037,1598,218,2417,1656,2629,188,10%
2010-07,הדרום,1034,קריית מלאכי,1442,646,796,43,1399,886,1414,148,13%
2010-07,הדרום,1161,רהט,3140,1270,1870,6,3134,2642,3137,94,22%
2010-07,הדרום,1286,שגב-שלום,570,241,329,2,568,510,569,11,27%
2010-07,הדרום,1031,שדרות,1248,521,727,67,1181,639,1242,57,11%
2010-07,הדרום,1054,תל שבע,1221,611,610,5,1216,1098,1219,17,31%
2010-07,המרכז,182,אבן יהודה,183,79,104,53,130,23,183,10,3%
2010-07,המרכז,41,אליכין,67,31,36,12,55,15,66,5,4%
2010-07,המרכז,1309,אלעד,469,196,273,25,444,119,467,15,4%
2010-07,המרכז,2530,באר יעקב,293,131,162,45,248,90,284,24,4%
2010-07,המרכז,466,בית דגן,131,71,60,20,111,34,130,7,4%
2010-07,המרכז,1066,"בני עי""ש",202,89,113,33,169,85,200,7,5%
2010-07,המרכז,681,גבעת שמואל,304,145,159,103,201,52,303,8,3%
2010-07,המרכז,2550,גדרה,410,157,253,77,333,114,405,22,4%
2010-07,המרכז,627,ג'לג'וליה,65,32,33,4,61,28,65,0,2%
2010-07,המרכז,166,גן יבנה,475,175,300,59,416,111,474,22,5%
2010-07,המרכז,229,גני תקווה,213,99,114,45,168,31,210,14,3%
2010-07,המרכז,9700,הוד השרון,756,348,408,187,569,73,751,43,3%
2010-07,המרכז,1290,זמר,179,58,121,3,176,138,179,4,7%
2010-07,המרכז,2730,טייבה,2097,883,1214,6,2091,1762,2086,35,14%
2010-07,המרכז,2720,טירה,336,169,167,15,321,198,335,19,4%
2010-07,המרכז,2660,יבנה,1120,507,613,77,1043,460,1118,68,6%
2010-07,המרכז,9400,יהוד,629,295,334,90,539,85,603,74,4%
2010-07,המרכז,1224,כוכב יאיר,264,133,131,46,218,5,264,3,5%
2010-07,המרכז,633,כפר ברא,23,9,14,0,23,9,23,0,2%
2010-07,המרכז,168,כפר יונה,390,135,255,65,325,104,387,42,4%
2010-07,המרכז,6900,כפר סבא,1440,658,782,350,1090,225,1430,91,3%
2010-07,המרכז,634,כפר קאסם,273,121,152,8,265,116,273,7,4%
2010-07,המרכז,7000,לוד,2477,1030,1447,198,2279,1342,2458,186,7%
2010-07,המרכז,1200,מודיעין-מכבים-רעות*,1105,456,649,345,760,73,1096,93,3%
2010-07,המרכז,28,מזכרת בתיה,183,61,122,32,151,39,178,13,3%
2010-07,המרכז,7200,נס ציונה,761,337,424,153,608,206,752,38,4%
2010-07,המרכז,7400,נתניה,5426,2405,3021,740,4686,2132,5373,517,6%
2010-07,המרכז,587,סביון*,24,13,11,7,17,1,24,0,1%
2010-07,המרכז,171,פרדסייה,86,39,47,19,67,11,85,7,3%
2010-07,המרכז,7900,פתח תקווה,4761,2117,2644,795,3966,1292,4727,361,4%
2010-07,המרכז,195,קדימה-צורן,304,145,159,84,220,47,301,19,3%
2010-07,המרכז,638,קלנסווה,922,342,580,1,921,751,916,16,13%
2010-07,המרכז,469,קריית עקרון,309,136,173,7,302,129,306,13,6%
2010-07,המרכז,2640,ראש העין,960,490,470,100,860,185,939,86,5%
2010-07,המרכז,8300,ראשון לציון,5307,2320,2987,920,4387,1815,5285,490,4%
2010-07,המרכז,8400,רחובות,2954,1233,1721,547,2407,1057,2920,135,5%
2010-07,המרכז,8500,רמלה,2050,940,1110,113,1937,888,2013,185,6%
2010-07,המרכז,8700,רעננה,1054,509,545,252,802,88,1047,51,3%
2010-07,המרכז,1304,שוהם,244,108,136,92,152,6,243,17,3%
2010-07,המרכז,154,תל מונד,178,72,106,47,131,20,177,13,3%
2010-07,הצפון,473,אבו סנאן,767,307,460,7,760,598,762,24,16%
2010-07,הצפון,478,אכסאל,621,252,369,19,602,515,620,15,13%
2010-07,הצפון,529,אעבלין,681,285,396,15,666,553,681,16,14%
2010-07,הצפון,482,בועיינה-נוג'ידאת,526,236,290,8,518,422,521,9,16%
2010-07,הצפון,4001,בוקעאתא,392,173,219,3,389,319,382,7,16%
2010-07,הצפון,998,ביר אל-מכסור,444,181,263,2,442,338,444,1,15%
2010-07,הצפון,480,בית ג'ן,336,108,228,3,333,247,330,7,8%
2010-07,הצפון,9200,בית שאן,914,393,521,19,895,468,911,94,10%
2010-07,הצפון,944,בסמת טבעון,313,127,186,3,310,238,313,12,12%
2010-07,הצפון,483,בענה,473,183,290,2,471,404,473,9,17%
2010-07,הצפון,1292,ג'דיידה-מכר,1506,618,888,7,1499,1270,1506,43,20%
2010-07,הצפון,485,ג'ולס,248,67,181,2,246,134,248,22,10%
2010-07,הצפון,487,ג'ש (גוש חלב),82,32,50,10,72,36,82,5,6%
2010-07,הצפון,489,דבורייה,451,209,242,31,420,329,450,5,12%
2010-07,הצפון,490,דייר אל-אסד,467,183,284,6,461,354,467,7,11%
2010-07,הצפון,492,דייר חנא,676,296,380,17,659,540,676,16,17%
2010-07,הצפון,975,זרזיר,293,128,165,1,292,193,288,12,12%
2010-07,הצפון,496,חורפיש,154,63,91,5,149,100,154,9,7%
2010-07,הצפון,2034,חצור הגלילית,325,154,171,13,312,143,319,36,7%
2010-07,הצפון,6700,טבריה,2055,848,1207,123,1932,1267,1944,119,10%
2010-07,הצפון,962,טובא-זנגרייה,391,166,225,6,385,256,388,17,15%
2010-07,הצפון,498,טורעאן,578,203,375,17,561,465,573,15,12%
2010-07,הצפון,8900,טמרה,2066,834,1232,32,2034,1774,2064,30,18%
2010-07,הצפון,1295,יאנוח-ג'ת,179,56,123,7,172,125,179,10,8%
2010-07,הצפון,46,יבנאל,133,80,53,5,128,104,127,4,10%
2010-07,הצפון,499,יפיע,651,282,369,10,641,490,647,18,10%
2010-07,הצפון,240,יקנעם עילית,571,230,341,97,474,228,569,50,6%
2010-07,הצפון,502,ירכא,513,191,322,4,509,384,512,11,11%
2010-07,הצפון,504,כאבול,761,310,451,18,743,639,759,8,18%
2010-07,הצפון,505,כאוכב אבו אל-היג'א,237,92,145,1,236,178,237,26,17%
2010-07,הצפון,1296,כסרא-סמיע,238,88,150,2,236,183,237,21,9%
2010-07,הצפון,978,כעביה-טבאש-חג'אג'רה,211,92,119,2,209,148,209,3,11%
2010-07,הצפון,1263,כפר ורדים,102,41,61,24,78,12,102,40,3%
2010-07,הצפון,507,כפר יאסיף,508,226,282,7,501,384,505,26,12%
2010-07,הצפון,508,כפר כמא,76,37,39,3,73,40,75,2,6%
2010-07,הצפון,509,כפר כנא,1221,477,744,25,1196,1012,1208,34,17%
2010-07,הצפון,510,כפר מנדא,863,361,502,10,853,685,855,18,15%
2010-07,הצפון,47,כפר תבור,58,22,36,16,42,7,58,1,3%
2010-07,הצפון,1139,כרמיאל,1881,746,1135,339,1542,973,1826,108,7%
2010-07,הצפון,481,מגאר,1491,587,904,43,1448,1258,1488,52,20%
2010-07,הצפון,516,מג'ד אל-כרום,689,274,415,7,682,536,688,16,13%
2010-07,הצפון,874,מגדל העמק,1170,507,663,107,1063,516,1132,137,9%
2010-07,הצפון,4201,מג'דל שמס,479,177,302,23,456,399,473,24,12%
2010-07,הצפון,517,מזרעה,177,69,108,5,172,138,175,7,11%
2010-07,הצפון,4203,מסעדה,209,79,130,7,202,176,208,3,14%
2010-07,הצפון,518,מעיליא,78,43,35,7,71,31,78,12,6%
2010-07,הצפון,1063,מעלות-תרשיחא,1154,495,659,132,1022,660,1152,132,10%
2010-07,הצפון,520,משהד,334,125,209,5,329,268,333,9,13%
2010-07,הצפון,9100,נהרייה,2303,1039,1264,259,2044,1360,2287,132,8%
2010-07,הצפון,522,נחף,469,189,280,12,457,383,468,9,12%
2010-07,הצפון,7300,נצרת,2876,1284,1592,87,2789,2082,2862,109,10%
2010-07,הצפון,1061,נצרת עילית,2021,892,1129,250,1771,1118,1939,201,9%
2010-07,הצפון,525,סאג'ור,115,44,71,1,114,80,113,1,8%
2010-07,הצפון,7500,סח'נין,2005,890,1115,45,1960,1731,2005,51,18%
2010-07,הצפון,4501,ע'ג'ר,112,44,68,1,111,86,111,10,13%
2010-07,הצפון,530,עיילבון,205,88,117,15,190,156,204,7,10%
2010-07,הצפון,511,עילוט,337,142,195,5,332,244,336,11,14%
2010-07,הצפון,532,עין מאהל,596,278,318,7,589,521,590,19,14%
2010-07,הצפון,7600,עכו,3505,1565,1940,149,3356,2637,3485,136,14%
2010-07,הצפון,7700,עפולה,2195,923,1272,212,1983,1064,2118,184,10%
2010-07,הצפון,531,עראבה,1391,562,829,45,1346,1160,1390,33,17%
2010-07,הצפון,535,פסוטה,147,62,85,9,138,98,147,11,10%
2010-07,הצפון,536,פקיעין (בוקייעה),149,79,70,10,139,113,147,7,6%
2010-07,הצפון,8000,צפת,1188,558,630,82,1106,722,1184,145,10%
2010-07,הצפון,4100,קצרין,234,111,123,37,197,103,232,10,6%
2010-07,הצפון,2800,קריית שמונה,874,427,447,58,816,341,863,115,7%
2010-07,הצפון,543,ראמה,343,147,196,9,334,259,343,7,11%
2010-07,הצפון,26,ראש פינה,55,25,30,7,48,17,55,8,4%
2010-07,הצפון,542,ריינה,649,267,382,14,635,500,645,20,12%
2010-07,הצפון,122,רמת ישי,133,52,81,33,100,8,133,13,4%
2010-07,הצפון,913,שבלי - אום אל-גנם,238,109,129,7,231,187,237,1,11%
2010-07,הצפון,812,שלומי,306,128,178,14,292,159,305,44,9%
2010-07,הצפון,538,שעב,473,201,272,3,470,409,472,18,19%
2010-07,הצפון,8800,שפרעם,2185,879,1306,33,2152,1757,2177,48,15%
2010-07,חיפה,2710,אום אל-פחם,3522,1494,2028,10,3512,2982,3519,58,21%
2010-07,חיפה,1020,אור עקיבא,678,308,370,47,631,232,666,61,7%
2010-07,חיפה,6000,באקה אל-גרביה,587,308,279,10,577,361,586,44,NULL
2010-07,חיפה,9800,בנימינה-גבעת עדה*,205,100,105,58,147,47,203,15,3%
2010-07,חיפה,1326,"בסמ""ה",372,184,188,4,368,274,372,7,12%
2010-07,חיפה,541,ג'סר א-זרקא,397,220,177,2,395,252,395,9,8%
2010-07,חיפה,628,ג'ת,188,87,101,5,183,121,188,8,NULL
2010-07,חיפה,494,דאלית אל-כרמל,536,214,322,12,524,292,535,35,8%
2010-07,חיפה,9300,זכרון יעקב,261,110,151,67,194,48,260,20,3%
2010-07,חיפה,6500,חדרה,2615,1038,1577,294,2321,974,2570,208,6%
2010-07,חיפה,4000,חיפה,9138,3973,5165,1647,7491,5741,9085,633,7%
2010-07,חיפה,1247,חריש-קציר,28,16,12,3,25,10,27,1,2%
2010-07,חיפה,2100,טירת כרמל,845,375,470,21,824,542,835,68,9%
2010-07,חיפה,654,כפר קרע,353,161,192,10,343,195,351,15,5%
2010-07,חיפה,1327,מעלה עירון,843,327,516,3,840,704,841,18,18%
2010-07,חיפה,2500,נשר,671,300,371,127,544,325,668,73,5%
2010-07,חיפה,534,עספיא,377,163,214,11,366,213,377,22,8%
2010-07,חיפה,637,ערערה,519,217,302,9,510,320,519,33,8%
2010-07,חיפה,537,פוריידיס,421,187,234,2,419,258,419,15,9%
2010-07,חיפה,7800,פרדס חנה-כרכור,913,380,533,148,765,268,905,85,5%
2010-07,חיפה,6800,קריית אתא,2156,856,1300,152,2004,1291,2149,101,8%
2010-07,חיפה,9500,קריית ביאליק,1333,556,777,156,1177,712,1329,78,7%
2010-07,חיפה,2300,קריית טבעון,226,99,127,70,156,54,226,28,3%
2010-07,חיפה,9600,קריית ים,1926,820,1106,164,1762,1254,1918,95,10%
2010-07,חיפה,8200,קריית מוצקין,1306,520,786,190,1116,674,1293,81,6%
2010-07,חיפה,922,רכסים,177,80,97,8,169,106,176,11,6%
2010-07,ירושלים,472,אבו גוש,257,120,137,6,251,179,257,13,11%
2010-07,ירושלים,2610,בית שמש,1560,644,916,129,1431,626,1544,183,6%
2010-07,ירושלים,3000,ירושלים,11003,4781,6222,1298,9705,5718,10935,686,4%
2010-07,ירושלים,1015,מבשרת ציון,403,202,201,81,322,142,400,32,3%
2010-07,ירושלים,1137,קריית יערים,35,10,25,6,29,12,35,1,3%
2010-07,תל אביב,2400,אור יהודה,999,444,555,51,948,330,979,105,6%
2010-07,תל אביב,565,אזור,202,90,112,32,170,43,199,18,3%
2010-07,תל אביב,6100,בני ברק,2478,1055,1423,128,2350,1319,2457,112,5%
2010-07,תל אביב,6200,בת ים,3788,1738,2050,535,3253,1621,3724,277,5%
2010-07,תל אביב,6300,גבעתיים,822,337,485,336,486,120,811,46,3%
2010-07,תל אביב,6400,הרצלייה,1382,575,807,336,1046,180,1353,303,3%
2010-07,תל אביב,6600,חולון,3503,1600,1903,535,2968,1085,3449,300,4%
2010-07,תל אביב,2620,קריית אונו,485,211,274,148,337,59,482,51,3%
2010-07,תל אביב,8600,רמת גן,2369,1085,1284,682,1687,556,2350,142,3%
2010-07,תל אביב,2650,רמת השרון,507,233,274,158,349,45,500,114,2%
2010-07,תל אביב,5000,תל אביב -יפו,8338,4015,4323,2253,6085,3024,8247,542,4%
2010-08,אזור יהודה והשומרון,3760,אורנית,110,48,62,36,74,5,110,5,3%
2010-08,אזור יהודה והשומרון,3750,אלפי מנשה,110,45,65,27,83,5,109,7,3%
2010-08,אזור יהודה והשומרון,3560,אלקנה,42,18,24,18,24,3,41,2,2%
2010-08,אזור יהודה והשומרון,3650,אפרתה,62,32,30,24,38,6,61,4,2%
2010-08,אזור יהודה והשומרון,3570,אריאל,410,186,224,89,321,129,410,37,4%
2010-08,אזור יהודה והשומרון,3574,בית אל,58,28,30,18,40,12,57,3,3%
2010-08,אזור יהודה והשומרון,3652,בית אריה,71,31,40,10,61,5,71,7,3%
2010-08,אזור יהודה והשומרון,3780,ביתר עילית,574,210,364,19,555,204,569,28,7%
2010-08,אזור יהודה והשומרון,3730,גבעת זאב,182,86,96,27,155,41,182,28,3%
2010-08,אזור יהודה והשומרון,3769,הר אדר,44,14,30,14,30,4,44,2,3%
2010-08,אזור יהודה והשומרון,3797,מודיעין עילית,626,114,512,28,598,81,623,19,6%
2010-08,אזור יהודה והשומרון,3616,מעלה אדומים,741,295,446,105,636,232,733,77,4%
2010-08,אזור יהודה והשומרון,3660,עמנואל,98,51,47,2,96,62,98,2,10%
2010-08,אזור יהודה והשומרון,3557,קדומים,31,16,15,12,19,8,30,1,2%
2010-08,אזור יהודה והשומרון,3611,קריית ארבע,137,65,72,21,116,68,137,10,5%
2010-08,אזור יהודה והשומרון,3640,קרני שומרון,91,44,47,24,67,22,90,10,3%
2010-08,הדרום,31,אופקים,1543,621,922,94,1449,1037,1530,88,13%
2010-08,הדרום,2600,אילת,1465,627,838,95,1370,667,1451,111,5%
2010-08,הדרום,70,אשדוד,7699,2819,4880,913,6786,4496,7631,428,8%
2010-08,הדרום,7100,אשקלון,4750,1758,2992,729,4021,2782,4648,315,8%
2010-08,הדרום,9000,באר שבע,8165,3536,4629,1097,7068,5351,8110,805,9%
2010-08,הדרום,2200,דימונה,2293,960,1333,144,2149,1569,2252,178,13%
2010-08,הדרום,1303,חורה,723,307,416,0,723,668,723,10,24%
2010-08,הדרום,831,ירוחם,511,234,277,22,489,289,507,85,12%
2010-08,הדרום,1059,כסיפה,999,447,552,1,998,894,996,32,27%
2010-08,הדרום,1271,להבים,37,19,18,22,15,3,37,13,1%
2010-08,הדרום,1060,לקיה,939,426,513,3,936,852,937,21,29%
2010-08,הדרום,1268,מיתר,68,20,48,23,45,6,68,26,2%
2010-08,הדרום,99,מצפה רמון,300,111,189,24,276,138,274,55,12%
2010-08,הדרום,246,נתיבות,1165,428,737,60,1105,570,1161,184,10%
2010-08,הדרום,666,עומר,64,23,41,28,36,8,64,13,2%
2010-08,הדרום,2560,ערד,1051,424,627,172,879,625,1021,176,8%
2010-08,הדרום,1192,ערערה-בנגב,963,384,579,1,962,878,962,3,30%
2010-08,הדרום,2630,קריית גת,2551,984,1567,207,2344,1639,2545,190,10%
2010-08,הדרום,1034,קריית מלאכי,1387,626,761,44,1343,874,1368,215,13%
2010-08,הדרום,1161,רהט,3088,1226,1862,6,3082,2662,3085,162,22%
2010-08,הדרום,1286,שגב-שלום,571,241,330,2,569,508,569,15,27%
2010-08,הדרום,1031,שדרות,1236,497,739,68,1168,665,1232,85,11%
2010-08,הדרום,1054,תל שבע,1210,595,615,4,1206,1106,1207,13,31%
2010-08,המרכז,182,אבן יהודה,156,66,90,59,97,21,156,12,3%
2010-08,המרכז,41,אליכין,69,33,36,14,55,16,69,6,4%
2010-08,המרכז,1309,אלעד,531,174,357,26,505,121,529,103,5%
2010-08,המרכז,2530,באר יעקב,288,127,161,44,244,93,281,22,4%
2010-08,המרכז,466,בית דגן,120,59,61,20,100,35,119,4,4%
2010-08,המרכז,1066,"בני עי""ש",198,90,108,31,167,86,196,10,5%
2010-08,המרכז,681,גבעת שמואל,278,130,148,108,170,52,278,15,3%
2010-08,המרכז,2550,גדרה,359,143,216,67,292,111,353,23,4%
2010-08,המרכז,627,ג'לג'וליה,64,32,32,4,60,28,64,3,2%
2010-08,המרכז,166,גן יבנה,405,144,261,55,350,110,403,29,4%
2010-08,המרכז,229,גני תקווה,197,79,118,45,152,28,197,7,3%
2010-08,המרכז,9700,הוד השרון,626,274,352,193,433,64,623,37,3%
2010-08,המרכז,1290,זמר,170,57,113,4,166,132,170,4,7%
2010-08,המרכז,2730,טייבה,2083,870,1213,6,2077,1768,2071,44,14%
2010-08,המרכז,2720,טירה,308,148,160,13,295,193,307,21,3%
2010-08,המרכז,2660,יבנה,1024,445,579,77,947,451,1021,94,6%
2010-08,המרכז,9400,יהוד,586,249,337,95,491,86,564,60,4%
2010-08,המרכז,1224,כוכב יאיר,216,89,127,46,170,4,215,10,4%
2010-08,המרכז,633,כפר ברא,16,4,12,0,16,9,16,1,2%
2010-08,המרכז,168,כפר יונה,373,136,237,58,315,103,368,25,4%
2010-08,המרכז,6900,כפר סבא,1279,551,728,361,918,240,1269,118,3%
2010-08,המרכז,634,כפר קאסם,263,116,147,8,255,119,263,12,4%
2010-08,המרכז,7000,לוד,2420,986,1434,203,2217,1337,2404,184,7%
2010-08,המרכז,1200,מודיעין-מכבים-רעות*,1046,388,658,360,686,82,1035,120,3%
2010-08,המרכז,28,מזכרת בתיה,177,55,122,35,142,40,174,7,3%
2010-08,המרכז,7200,נס ציונה,716,300,416,141,575,208,708,21,4%
2010-08,המרכז,7400,נתניה,5275,2240,3035,742,4533,2201,5218,541,6%
2010-08,המרכז,587,סביון*,14,6,8,7,7,1,14,0,1%
2010-08,המרכז,171,פרדסייה,76,39,37,18,58,8,75,4,2%
2010-08,המרכז,7900,פתח תקווה,4454,1886,2568,813,3641,1309,4422,317,4%
2010-08,המרכז,195,קדימה-צורן,279,126,153,87,192,44,277,21,3%
2010-08,המרכז,638,קלנסווה,922,332,590,1,921,761,916,21,13%
2010-08,המרכז,469,קריית עקרון,284,124,160,8,276,128,281,14,5%
2010-08,המרכז,2640,ראש העין,866,376,490,98,768,193,851,91,4%
2010-08,המרכז,8300,ראשון לציון,4763,2040,2723,913,3850,1795,4744,354,4%
2010-08,המרכז,8400,רחובות,2892,1154,1738,552,2340,1038,2854,110,5%
2010-08,המרכז,8500,רמלה,1935,873,1062,122,1813,893,1901,165,6%
2010-08,המרכז,8700,רעננה,751,357,394,269,482,82,746,62,2%
2010-08,המרכז,1304,שוהם,202,82,120,80,122,6,202,15,2%
2010-08,המרכז,154,תל מונד,134,55,79,44,90,21,134,6,3%
2010-08,הצפון,473,אבו סנאן,760,299,461,6,754,605,756,34,16%
2010-08,הצפון,478,אכסאל,597,234,363,15,582,511,596,4,13%
2010-08,הצפון,529,אעבלין,670,275,395,14,656,551,670,35,14%
2010-08,הצפון,482,בועיינה-נוג'ידאת,516,226,290,9,507,420,511,4,16%
2010-08,הצפון,4001,בוקעאתא,381,166,215,3,378,318,371,8,16%
2010-08,הצפון,998,ביר אל-מכסור,421,162,259,1,420,337,421,8,14%
2010-08,הצפון,480,בית ג'ן,309,97,212,2,307,239,306,7,8%
2010-08,הצפון,9200,בית שאן,938,410,528,23,915,466,937,137,10%
2010-08,הצפון,944,בסמת טבעון,303,122,181,3,300,240,303,15,11%
2010-08,הצפון,483,בענה,480,192,288,3,477,407,480,10,17%
2010-08,הצפון,1292,ג'דיידה-מכר,1487,596,891,7,1480,1276,1487,38,19%
2010-08,הצפון,485,ג'ולס,242,69,173,2,240,135,242,24,10%
2010-08,הצפון,487,ג'ש (גוש חלב),75,29,46,9,66,38,75,2,5%
2010-08,הצפון,489,דבורייה,460,219,241,30,430,324,458,5,13%
2010-08,הצפון,490,דייר אל-אסד,471,183,288,7,464,353,471,10,11%
2010-08,הצפון,492,דייר חנא,666,285,381,15,651,537,666,16,17%
2010-08,הצפון,975,זרזיר,296,135,161,2,294,191,292,9,12%
2010-08,הצפון,496,חורפיש,147,60,87,4,143,99,147,7,7%
2010-08,הצפון,2034,חצור הגלילית,313,138,175,15,298,145,304,27,7%
2010-08,הצפון,6700,טבריה,1938,743,1195,121,1817,1224,1836,124,9%
2010-08,הצפון,962,טובא-זנגרייה,380,157,223,7,373,259,376,15,14%
2010-08,הצפון,498,טורעאן,567,197,370,11,556,458,563,17,12%
2010-08,הצפון,8900,טמרה,2052,827,1225,35,2017,1788,2049,38,18%
2010-08,הצפון,1295,יאנוח-ג'ת,169,52,117,4,165,116,169,2,8%
2010-08,הצפון,46,יבנאל,143,79,64,7,136,103,137,1,10%
2010-08,הצפון,499,יפיע,636,256,380,9,627,501,633,27,10%
2010-08,הצפון,240,יקנעם עילית,532,202,330,101,431,211,529,36,5%
2010-08,הצפון,502,ירכא,509,192,317,4,505,389,508,20,11%
2010-08,הצפון,504,כאבול,757,310,447,18,739,642,753,19,18%
2010-08,הצפון,505,כאוכב אבו אל-היג'א,198,74,124,1,197,170,198,11,14%
2010-08,הצפון,1296,כסרא-סמיע,237,96,141,0,237,177,236,19,9%
2010-08,הצפון,978,כעביה-טבאש-חג'אג'רה,216,100,116,2,214,149,214,8,11%
2010-08,הצפון,1263,כפר ורדים,78,33,45,24,54,14,78,6,3%
2010-08,הצפון,507,כפר יאסיף,490,206,284,8,482,390,488,20,11%
2010-08,הצפון,508,כפר כמא,70,30,40,3,67,45,69,0,5%
2010-08,הצפון,509,כפר כנא,1205,463,742,25,1180,1012,1194,27,16%
2010-08,הצפון,510,כפר מנדא,888,383,505,11,877,722,880,30,15%
2010-08,הצפון,47,כפר תבור,51,19,32,23,28,6,51,0,3%
2010-08,הצפון,1139,כרמיאל,1829,696,1133,335,1494,995,1774,169,7%
2010-08,הצפון,481,מגאר,1459,571,888,41,1418,1259,1456,51,20%
2010-08,הצפון,516,מג'ד אל-כרום,677,272,405,7,670,529,676,17,13%
2010-08,הצפון,874,מגדל העמק,1147,478,669,99,1048,531,1104,165,9%
2010-08,הצפון,4201,מג'דל שמס,474,179,295,24,450,402,469,24,12%
2010-08,הצפון,517,מזרעה,169,64,105,4,165,138,167,2,11%
2010-08,הצפון,4203,מסעדה,208,77,131,6,202,179,207,4,14%
2010-08,הצפון,518,מעיליא,68,31,37,6,62,31,68,0,5%
2010-08,הצפון,1063,מעלות-תרשיחא,1062,443,619,138,924,646,1060,57,9%
2010-08,הצפון,520,משהד,337,126,211,3,334,269,334,10,13%
2010-08,הצפון,9100,נהרייה,2216,967,1249,271,1945,1368,2200,126,8%
2010-08,הצפון,522,נחף,469,192,277,13,456,391,468,5,12%
2010-08,הצפון,7300,נצרת,2834,1201,1633,89,2745,2126,2818,90,10%
2010-08,הצפון,1061,נצרת עילית,1934,830,1104,257,1677,1116,1850,220,8%
2010-08,הצפון,525,סאג'ור,115,42,73,1,114,85,114,4,8%
2010-08,הצפון,7500,סח'נין,2002,878,1124,51,1951,1741,2002,54,17%
2010-08,הצפון,4501,ע'ג'ר,101,42,59,1,100,79,101,7,12%
2010-08,הצפון,530,עיילבון,203,84,119,12,191,159,202,10,9%
2010-08,הצפון,511,עילוט,339,138,201,3,336,262,339,10,15%
2010-08,הצפון,532,עין מאהל,589,263,326,8,581,521,580,18,14%
2010-08,הצפון,7600,עכו,3429,1499,1930,148,3281,2620,3406,143,14%
2010-08,הצפון,7700,עפולה,2119,883,1236,223,1896,1088,2038,201,9%
2010-08,הצפון,531,עראבה,1373,551,822,42,1331,1155,1372,42,17%
2010-08,הצפון,535,פסוטה,139,61,78,9,130,92,139,2,9%
2010-08,הצפון,536,פקיעין (בוקייעה),136,67,69,7,129,108,135,12,6%
2010-08,הצפון,8000,צפת,1136,542,594,88,1048,727,1130,95,10%
2010-08,הצפון,4100,קצרין,221,95,126,38,183,111,218,17,6%
2010-08,הצפון,2800,קריית שמונה,817,393,424,67,750,331,799,117,7%
2010-08,הצפון,543,ראמה,330,138,192,11,319,253,330,10,10%
2010-08,הצפון,26,ראש פינה,48,20,28,8,40,18,47,2,3%
2010-08,הצפון,542,ריינה,629,245,384,14,615,502,624,16,11%
2010-08,הצפון,122,רמת ישי,110,45,65,27,83,9,110,7,3%
2010-08,הצפון,913,שבלי - אום אל-גנם,251,115,136,8,243,193,249,4,12%
2010-08,הצפון,812,שלומי,277,119,158,15,262,166,275,23,8%
2010-08,הצפון,538,שעב,482,202,280,3,479,417,481,9,19%
2010-08,הצפון,8800,שפרעם,2144,846,1298,36,2108,1759,2136,113,14%
2010-08,חיפה,2710,אום אל-פחם,3523,1471,2052,15,3508,2993,3519,73,21%
2010-08,חיפה,1020,אור עקיבא,678,289,389,51,627,255,659,76,7%
2010-08,חיפה,6000,באקה אל-גרביה,584,297,287,14,570,361,583,37,NULL
2010-08,חיפה,9800,בנימינה-גבעת עדה*,208,96,112,62,146,51,207,20,3%
2010-08,חיפה,1326,"בסמ""ה",369,181,188,4,365,276,369,11,12%
2010-08,חיפה,541,ג'סר א-זרקא,406,226,180,2,404,265,402,21,8%
2010-08,חיפה,628,ג'ת,167,77,90,5,162,118,167,11,NULL
2010-08,חיפה,494,דאלית אל-כרמל,535,217,318,13,522,286,533,23,8%
2010-08,חיפה,9300,זכרון יעקב,234,101,133,70,164,44,231,15,3%
2010-08,חיפה,6500,חדרה,2482,963,1519,279,2203,954,2436,210,6%
2010-08,חיפה,4000,חיפה,8855,3761,5094,1674,7181,5774,8797,602,7%
2010-08,חיפה,1247,חריש-קציר,32,14,18,7,25,13,31,3,2%
2010-08,חיפה,2100,טירת כרמל,811,352,459,26,785,544,802,58,8%
2010-08,חיפה,654,כפר קרע,354,164,190,10,344,203,352,16,5%
2010-08,חיפה,1327,מעלה עירון,832,322,510,4,828,699,830,11,18%
2010-08,חיפה,2500,נשר,617,285,332,122,495,331,613,63,5%
2010-08,חיפה,534,עספיא,366,160,206,11,355,210,366,17,8%
2010-08,חיפה,637,ערערה,525,222,303,11,514,338,525,39,8%
2010-08,חיפה,537,פוריידיס,392,177,215,2,390,265,390,39,8%
2010-08,חיפה,7800,פרדס חנה-כרכור,874,341,533,149,725,260,863,88,5%
2010-08,חיפה,6800,קריית אתא,2157,825,1332,170,1987,1321,2142,149,8%
2010-08,חיפה,9500,קריית ביאליק,1333,532,801,164,1169,735,1327,98,7%
2010-08,חיפה,2300,קריית טבעון,184,75,109,67,117,54,184,13,2%
2010-08,חיפה,9600,קריית ים,1914,813,1101,156,1758,1274,1909,119,10%
2010-08,חיפה,8200,קריית מוצקין,1252,478,774,184,1068,680,1238,66,6%
2010-08,חיפה,922,רכסים,195,77,118,9,186,110,194,10,7%
2010-08,ירושלים,472,אבו גוש,282,132,150,10,272,189,281,9,12%
2010-08,ירושלים,2610,בית שמש,1428,535,893,118,1310,626,1406,197,6%
2010-08,ירושלים,3000,ירושלים,10722,4576,6146,1294,9428,5843,10646,725,4%
2010-08,ירושלים,1015,מבשרת ציון,467,220,247,79,388,140,464,24,4%
2010-08,ירושלים,1137,קריית יערים,38,12,26,10,28,12,38,4,4%
2010-08,תל אביב,2400,אור יהודה,969,385,584,47,922,330,954,102,5%
2010-08,תל אביב,565,אזור,171,75,96,34,137,42,171,11,3%
2010-08,תל אביב,6100,בני ברק,2602,1061,1541,131,2471,1351,2584,321,6%
2010-08,תל אביב,6200,בת ים,3606,1620,1986,542,3064,1627,3545,310,5%
2010-08,תל אביב,6300,גבעתיים,788,327,461,342,446,130,778,52,3%
2010-08,תל אביב,6400,הרצלייה,1297,507,790,332,965,177,1272,230,3%
2010-08,תל אביב,6600,חולון,3286,1468,1818,558,2728,1159,3226,313,3%
2010-08,תל אביב,2620,קריית אונו,455,194,261,158,297,58,450,30,3%
2010-08,תל אביב,8600,רמת גן,2300,988,1312,675,1625,565,2284,146,3%
2010-08,תל אביב,2650,רמת השרון,432,194,238,152,280,45,426,60,2%
2010-08,תל אביב,5000,תל אביב -יפו,8090,3883,4207,2276,5814,3033,8019,539,3%
2010-09,אזור יהודה והשומרון,3760,אורנית,90,40,50,35,55,4,90,5,2%
2010-09,אזור יהודה והשומרון,3750,אלפי מנשה,85,30,55,21,64,3,84,6,2%
2010-09,אזור יהודה והשומרון,3560,אלקנה,35,17,18,17,18,3,35,4,2%
2010-09,אזור יהודה והשומרון,3650,אפרתה,45,27,18,21,24,6,45,2,1%
2010-09,אזור יהודה והשומרון,3570,אריאל,356,156,200,89,267,126,356,33,4%
2010-09,אזור יהודה והשומרון,3574,בית אל,40,17,23,14,26,13,39,10,2%
2010-09,אזור יהודה והשומרון,3652,בית אריה,65,28,37,10,55,6,65,2,3%
2010-09,אזור יהודה והשומרון,3780,ביתר עילית,408,172,236,18,390,196,403,73,5%
2010-09,אזור יהודה והשומרון,3730,גבעת זאב,149,66,83,20,129,40,149,11,2%
2010-09,אזור יהודה והשומרון,3769,הר אדר,28,13,15,17,11,3,28,0,2%
2010-09,אזור יהודה והשומרון,3797,מודיעין עילית,310,84,226,24,286,81,308,34,3%
2010-09,אזור יהודה והשומרון,3616,מעלה אדומים,615,237,378,86,529,217,610,68,3%
2010-09,אזור יהודה והשומרון,3660,עמנואל,79,39,40,2,77,60,79,12,8%
2010-09,אזור יהודה והשומרון,3557,קדומים,27,12,15,12,15,9,27,5,2%
2010-09,אזור יהודה והשומרון,3611,קריית ארבע,117,57,60,17,100,66,117,13,4%
2010-09,אזור יהודה והשומרון,3640,קרני שומרון,79,38,41,23,56,24,79,10,2%
2010-09,הדרום,31,אופקים,1391,556,835,88,1303,1000,1378,64,12%
2010-09,הדרום,2600,אילת,1298,559,739,88,1210,646,1278,69,4%
2010-09,הדרום,70,אשדוד,7031,2581,4450,845,6186,4326,6981,414,7%
2010-09,הדרום,7100,אשקלון,4217,1532,2685,667,3550,2642,4121,255,7%
2010-09,הדרום,9000,באר שבע,7378,3138,4240,1004,6374,5118,7344,406,8%
2010-09,הדרום,2200,דימונה,2026,847,1179,121,1905,1476,1986,167,11%
2010-09,הדרום,1303,חורה,708,304,404,1,707,659,708,11,23%
2010-09,הדרום,831,ירוחם,437,203,234,19,418,276,434,50,11%
2010-09,הדרום,1059,כסיפה,931,395,536,0,931,853,929,16,25%
2010-09,הדרום,1271,להבים,34,20,14,24,10,3,34,3,1%
2010-09,הדרום,1060,לקיה,888,405,483,3,885,824,886,10,28%
2010-09,הדרום,1268,מיתר,54,17,37,19,35,6,54,9,1%
2010-09,הדרום,99,מצפה רמון,246,83,163,23,223,132,225,20,10%
2010-09,הדרום,246,נתיבות,1019,389,630,63,956,561,1014,99,9%
2010-09,הדרום,666,עומר,55,18,37,25,30,8,55,5,1%
2010-09,הדרום,2560,ערד,946,376,570,176,770,587,919,94,7%
2010-09,הדרום,1192,ערערה-בנגב,957,380,577,1,956,882,956,5,30%
2010-09,הדרום,2630,קריית גת,2298,871,1427,199,2099,1560,2289,117,9%
2010-09,הדרום,1034,קריית מלאכי,1255,560,695,42,1213,834,1235,89,11%
2010-09,הדרום,1161,רהט,2885,1104,1781,6,2879,2553,2883,81,21%
2010-09,הדרום,1286,שגב-שלום,553,233,320,2,551,494,551,22,27%
2010-09,הדרום,1031,שדרות,1070,394,676,63,1007,648,1067,72,10%
2010-09,הדרום,1054,תל שבע,1175,570,605,3,1172,1077,1172,42,30%
2010-09,המרכז,182,אבן יהודה,138,54,84,57,81,18,138,11,2%
2010-09,המרכז,41,אליכין,54,26,28,13,41,16,54,4,3%
2010-09,המרכז,1309,אלעד,364,161,203,22,342,111,363,14,3%
2010-09,המרכז,2530,באר יעקב,266,110,156,40,226,88,259,18,4%
2010-09,המרכז,466,בית דגן,106,60,46,20,86,32,105,6,3%
2010-09,המרכז,1066,"בני עי""ש",170,77,93,25,145,85,169,10,4%
2010-09,המרכז,681,גבעת שמואל,242,105,137,99,143,49,242,6,2%
2010-09,המרכז,2550,גדרה,314,122,192,68,246,106,308,17,3%
2010-09,המרכז,627,ג'לג'וליה,55,28,27,2,53,25,55,2,2%
2010-09,המרכז,166,גן יבנה,338,119,219,45,293,100,337,20,4%
2010-09,המרכז,229,גני תקווה,171,74,97,42,129,27,171,15,2%
2010-09,המרכז,9700,הוד השרון,533,221,312,182,351,60,532,51,2%
2010-09,המרכז,1290,זמר,162,54,108,4,158,131,162,3,7%
2010-09,המרכז,2730,טייבה,2007,831,1176,4,2003,1751,1996,33,14%
2010-09,המרכז,2720,טירה,277,132,145,9,268,186,276,10,3%
2010-09,המרכז,2660,יבנה,866,380,486,75,791,443,865,65,5%
2010-09,המרכז,9400,יהוד,513,211,302,88,425,88,494,39,3%
2010-09,המרכז,1224,כוכב יאיר,81,34,47,43,38,4,81,16,2%
2010-09,המרכז,633,כפר ברא,21,7,14,0,21,10,21,2,2%
2010-09,המרכז,168,כפר יונה,323,114,209,51,272,100,321,39,3%
2010-09,המרכז,6900,כפר סבא,1079,450,629,334,745,205,1074,94,2%
2010-09,המרכז,634,כפר קאסם,209,107,102,2,207,114,209,35,3%
2010-09,המרכז,7000,לוד,2132,873,1259,194,1938,1261,2116,184,6%
2010-09,המרכז,1200,מודיעין-מכבים-רעות*,855,323,532,339,516,70,844,87,2%
2010-09,המרכז,28,מזכרת בתיה,148,44,104,36,112,38,146,5,3%
2010-09,המרכז,7200,נס ציונה,628,278,350,126,502,204,621,39,3%
2010-09,המרכז,7400,נתניה,4447,1875,2572,648,3799,2056,4409,593,5%
2010-09,המרכז,587,סביון*,13,8,5,6,7,1,13,1,1%
2010-09,המרכז,171,פרדסייה,65,32,33,20,45,9,64,2,2%
2010-09,המרכז,7900,פתח תקווה,3780,1541,2239,726,3054,1205,3755,273,3%
2010-09,המרכז,195,קדימה-צורן,243,108,135,75,168,39,241,21,3%
2010-09,המרכז,638,קלנסווה,864,313,551,0,864,753,859,25,12%
2010-09,המרכז,469,קריית עקרון,258,115,143,12,246,115,255,13,5%
2010-09,המרכז,2640,ראש העין,687,319,368,94,593,186,676,55,3%
2010-09,המרכז,8300,ראשון לציון,4106,1713,2393,836,3270,1674,4089,306,3%
2010-09,המרכז,8400,רחובות,2505,1010,1495,501,2004,1007,2466,123,4%
2010-09,המרכז,8500,רמלה,1629,742,887,104,1525,817,1605,154,5%
2010-09,המרכז,8700,רעננה,629,280,349,253,376,69,626,63,2%
2010-09,המרכז,1304,שוהם,185,67,118,72,113,4,185,14,2%
2010-09,המרכז,154,תל מונד,118,47,71,44,74,19,118,13,2%
2010-09,הצפון,473,אבו סנאן,717,274,443,5,712,601,713,9,15%
2010-09,הצפון,478,אכסאל,559,218,341,11,548,489,558,14,12%
2010-09,הצפון,529,אעבלין,614,244,370,10,604,524,614,9,13%
2010-09,הצפון,482,בועיינה-נוג'ידאת,493,211,282,12,481,406,489,10,16%
2010-09,הצפון,4001,בוקעאתא,368,156,212,4,364,315,358,6,16%
2010-09,הצפון,998,ביר אל-מכסור,404,149,255,1,403,332,404,1,14%
2010-09,הצפון,480,בית ג'ן,292,91,201,1,291,231,290,5,7%
2010-09,הצפון,9200,בית שאן,791,325,466,20,771,436,789,81,9%
2010-09,הצפון,944,בסמת טבעון,277,104,173,3,274,220,277,8,10%
2010-09,הצפון,483,בענה,462,186,276,2,460,404,462,17,16%
2010-09,הצפון,1292,ג'דיידה-מכר,1450,584,866,6,1444,1271,1450,13,19%
2010-09,הצפון,485,ג'ולס,212,54,158,2,210,132,212,6,9%
2010-09,הצפון,487,ג'ש (גוש חלב),67,30,37,9,58,37,67,6,5%
2010-09,הצפון,489,דבורייה,411,192,219,30,381,308,411,10,11%
2010-09,הצפון,490,דייר אל-אסד,426,174,252,10,416,343,426,30,10%
2010-09,הצפון,492,דייר חנא,644,276,368,16,628,529,644,15,17%
2010-09,הצפון,975,זרזיר,261,112,149,1,260,187,258,11,11%
2010-09,הצפון,496,חורפיש,129,50,79,3,126,90,129,4,6%
2010-09,הצפון,2034,חצור הגלילית,292,127,165,12,280,146,287,20,7%
2010-09,הצפון,6700,טבריה,1772,699,1073,115,1657,1178,1673,77,8%
2010-09,הצפון,962,טובא-זנגרייה,341,142,199,8,333,252,336,9,13%
2010-09,הצפון,498,טורעאן,524,191,333,11,513,456,521,20,11%
2010-09,הצפון,8900,טמרה,1984,794,1190,29,1955,1760,1981,40,17%
2010-09,הצפון,1295,יאנוח-ג'ת,165,51,114,3,162,112,165,14,8%
2010-09,הצפון,46,יבנאל,131,69,62,9,122,94,125,2,9%
2010-09,הצפון,499,יפיע,604,243,361,9,595,491,600,21,9%
2010-09,הצפון,240,יקנעם עילית,486,187,299,88,398,209,484,32,5%
2010-09,הצפון,502,ירכא,492,181,311,3,489,384,492,10,11%
2010-09,הצפון,504,כאבול,705,288,417,12,693,622,701,14,17%
2010-09,הצפון,505,כאוכב אבו אל-היג'א,191,72,119,2,189,168,191,1,14%
2010-09,הצפון,1296,כסרא-סמיע,209,85,124,1,208,161,209,10,8%
2010-09,הצפון,978,כעביה-טבאש-חג'אג'רה,196,85,111,2,194,143,193,2,10%
2010-09,הצפון,1263,כפר ורדים,55,18,37,27,28,11,55,4,2%
2010-09,הצפון,507,כפר יאסיף,470,197,273,4,466,392,468,2,11%
2010-09,הצפון,508,כפר כמא,69,32,37,4,65,44,68,1,5%
2010-09,הצפון,509,כפר כנא,1132,434,698,18,1114,992,1121,41,16%
2010-09,הצפון,510,כפר מנדא,861,354,507,8,853,710,854,19,15%
2010-09,הצפון,47,כפר תבור,42,13,29,20,22,5,42,3,3%
2010-09,הצפון,1139,כרמיאל,1638,598,1040,323,1315,945,1579,79,6%
2010-09,הצפון,481,מגאר,1363,523,840,29,1334,1232,1359,31,19%
2010-09,הצפון,516,מג'ד אל-כרום,645,260,385,7,638,526,644,16,12%
2010-09,הצפון,874,מגדל העמק,960,386,574,78,882,491,928,101,7%
2010-09,הצפון,4201,מג'דל שמס,443,158,285,21,422,390,437,5,11%
2010-09,הצפון,517,מזרעה,155,54,101,4,151,129,154,1,10%
2010-09,הצפון,4203,מסעדה,201,77,124,7,194,175,200,8,14%
2010-09,הצפון,518,מעיליא,67,29,38,7,60,32,67,3,5%
2010-09,הצפון,1063,מעלות-תרשיחא,945,391,554,135,810,598,939,46,8%
2010-09,הצפון,520,משהד,311,117,194,2,309,265,308,9,12%
2010-09,הצפון,9100,נהרייה,2053,875,1178,259,1794,1324,2038,76,7%
2010-09,הצפון,522,נחף,452,180,272,13,439,385,451,8,11%
2010-09,הצפון,7300,נצרת,2718,1135,1583,89,2629,2094,2706,112,9%
2010-09,הצפון,1061,נצרת עילית,1697,677,1020,229,1468,1070,1615,151,7%
2010-09,הצפון,525,סאג'ור,103,32,71,2,101,81,102,1,7%
2010-09,הצפון,7500,סח'נין,1970,867,1103,48,1922,1738,1970,44,17%
2010-09,הצפון,4501,ע'ג'ר,87,33,54,1,86,73,87,6,10%
2010-09,הצפון,530,עיילבון,192,79,113,7,185,155,191,2,9%
2010-09,הצפון,511,עילוט,322,133,189,2,320,253,322,16,14%
2010-09,הצפון,532,עין מאהל,541,240,301,9,532,486,533,7,13%
2010-09,הצפון,7600,עכו,3170,1398,1772,137,3033,2542,3151,176,13%
2010-09,הצפון,7700,עפולה,1804,713,1091,203,1601,1007,1743,149,8%
2010-09,הצפון,531,עראבה,1331,537,794,44,1287,1157,1330,47,17%
2010-09,הצפון,535,פסוטה,130,59,71,11,119,93,130,5,9%
2010-09,הצפון,536,פקיעין (בוקייעה),125,66,59,7,118,93,125,5,5%
2010-09,הצפון,8000,צפת,959,477,482,81,878,677,954,42,8%
2010-09,הצפון,4100,קצרין,180,76,104,36,144,108,177,11,5%
2010-09,הצפון,2800,קריית שמונה,703,318,385,58,645,297,692,73,6%
2010-09,הצפון,543,ראמה,297,117,180,9,288,246,297,7,9%
2010-09,הצפון,26,ראש פינה,45,20,25,7,38,18,45,2,3%
2010-09,הצפון,542,ריינה,603,229,374,13,590,500,597,12,11%
2010-09,הצפון,122,רמת ישי,105,36,69,25,80,11,103,5,3%
2010-09,הצפון,913,שבלי - אום אל-גנם,234,102,132,8,226,192,233,2,11%
2010-09,הצפון,812,שלומי,256,106,150,11,245,157,254,10,8%
2010-09,הצפון,538,שעב,475,198,277,4,471,414,474,10,19%
2010-09,הצפון,8800,שפרעם,2039,775,1264,34,2005,1713,2030,57,14%
2010-09,חיפה,2710,אום אל-פחם,3366,1376,1990,9,3357,2959,3362,46,20%
2010-09,חיפה,1020,אור עקיבא,586,241,345,42,544,229,576,62,6%
2010-09,חיפה,6000,באקה אל-גרביה,554,280,274,14,540,359,553,22,NULL
2010-09,חיפה,9800,בנימינה-גבעת עדה*,178,81,97,61,117,49,177,18,3%
2010-09,חיפה,1326,"בסמ""ה",374,180,194,4,370,285,374,10,12%
2010-09,חיפה,541,ג'סר א-זרקא,368,198,170,0,368,253,365,8,7%
2010-09,חיפה,628,ג'ת,161,74,87,7,154,112,161,3,NULL
2010-09,חיפה,494,דאלית אל-כרמל,487,200,287,13,474,292,485,33,7%
2010-09,חיפה,9300,זכרון יעקב,203,79,124,76,127,43,201,22,2%
2010-09,חיפה,6500,חדרה,2171,832,1339,267,1904,913,2138,202,5%
2010-09,חיפה,4000,חיפה,8161,3418,4743,1604,6557,5503,8112,454,6%
2010-09,חיפה,1247,חריש-קציר,27,10,17,3,24,11,27,2,2%
2010-09,חיפה,2100,טירת כרמל,750,329,421,29,721,511,742,40,8%
2010-09,חיפה,654,כפר קרע,359,163,196,11,348,201,357,8,5%
2010-09,חיפה,1327,מעלה עירון,820,306,514,4,816,701,818,3,17%
2010-09,חיפה,2500,נשר,546,233,313,105,441,308,543,38,4%
2010-09,חיפה,534,עספיא,308,133,175,7,301,203,308,17,7%
2010-09,חיפה,637,ערערה,508,207,301,13,495,331,508,46,8%
2010-09,חיפה,537,פוריידיס,358,165,193,1,357,252,356,11,8%
2010-09,חיפה,7800,פרדס חנה-כרכור,783,288,495,139,644,251,772,81,5%
2010-09,חיפה,6800,קריית אתא,1893,737,1156,161,1732,1260,1881,105,7%
2010-09,חיפה,9500,קריית ביאליק,1212,482,730,161,1051,691,1207,66,6%
2010-09,חיפה,2300,קריית טבעון,166,71,95,58,108,50,166,11,2%
2010-09,חיפה,9600,קריית ים,1728,713,1015,148,1580,1232,1724,74,9%
2010-09,חיפה,8200,קריית מוצקין,1157,414,743,171,986,644,1145,50,6%
2010-09,חיפה,922,רכסים,154,68,86,7,147,107,153,19,6%
2010-09,ירושלים,472,אבו גוש,254,115,139,10,244,185,254,12,11%
2010-09,ירושלים,2610,בית שמש,1142,433,709,112,1030,573,1125,125,5%
2010-09,ירושלים,3000,ירושלים,9023,3801,5222,1152,7871,5584,8977,526,4%
2010-09,ירושלים,1015,מבשרת ציון,312,144,168,69,243,127,309,17,3%
2010-09,ירושלים,1137,קריית יערים,32,14,18,7,25,11,32,3,3%
2010-09,תל אביב,2400,אור יהודה,797,323,474,39,758,327,785,61,5%
2010-09,תל אביב,565,אזור,156,68,88,31,125,41,156,12,3%
2010-09,תל אביב,6100,בני ברק,2068,967,1101,121,1947,1270,2062,100,4%
2010-09,תל אביב,6200,בת ים,3148,1365,1783,472,2676,1508,3099,180,4%
2010-09,תל אביב,6300,גבעתיים,682,276,406,301,381,126,673,37,2%
2010-09,תל אביב,6400,הרצלייה,1027,403,624,313,714,151,1014,174,2%
2010-09,תל אביב,6600,חולון,2772,1232,1540,475,2297,1032,2735,226,3%
2010-09,תל אביב,2620,קריית אונו,408,169,239,162,246,59,407,15,3%
2010-09,תל אביב,8600,רמת גן,1947,811,1136,591,1356,522,1931,139,3%
2010-09,תל אביב,2650,רמת השרון,384,171,213,158,226,39,381,36,2%
2010-09,תל אביב,5000,תל אביב -יפו,7221,3386,3835,2089,5132,2809,7166,370,3%
2010-10,אזור יהודה והשומרון,3760,אורנית,98,49,49,40,58,4,98,7,3%
2010-10,אזור יהודה והשומרון,3750,אלפי מנשה,98,43,55,23,75,4,97,10,2%
2010-10,אזור יהודה והשומרון,3560,אלקנה,36,14,22,18,18,3,36,1,2%
2010-10,אזור יהודה והשומרון,3650,אפרתה,50,29,21,25,25,6,49,4,1%
2010-10,אזור יהודה והשומרון,3570,אריאל,402,176,226,91,311,128,401,49,4%
2010-10,אזור יהודה והשומרון,3574,בית אל,48,18,30,16,32,13,47,3,2%
2010-10,אזור יהודה והשומרון,3652,בית אריה,75,35,40,10,65,5,74,6,3%
2010-10,אזור יהודה והשומרון,3780,ביתר עילית,433,184,249,19,414,194,430,28,5%
2010-10,אזור יהודה והשומרון,3730,גבעת זאב,187,83,104,21,166,45,187,17,3%
2010-10,אזור יהודה והשומרון,3769,הר אדר,31,16,15,17,14,2,31,2,2%
2010-10,אזור יהודה והשומרון,3797,מודיעין עילית,339,104,235,21,318,85,336,29,3%
2010-10,אזור יהודה והשומרון,3616,מעלה אדומים,708,279,429,101,607,231,701,62,4%
2010-10,אזור יהודה והשומרון,3660,עמנואל,85,44,41,2,83,60,85,1,9%
2010-10,אזור יהודה והשומרון,3557,קדומים,35,20,15,13,22,11,35,3,2%
2010-10,אזור יהודה והשומרון,3611,קריית ארבע,107,52,55,18,89,64,107,9,4%
2010-10,אזור יהודה והשומרון,3640,קרני שומרון,86,39,47,26,60,27,85,9,3%
2010-10,הדרום,31,אופקים,1451,593,858,89,1362,1024,1435,98,13%
2010-10,הדרום,2600,אילת,1453,657,796,103,1350,685,1432,101,5%
2010-10,הדרום,70,אשדוד,7428,2816,4612,873,6555,4423,7371,422,7%
2010-10,הדרום,7100,אשקלון,4690,1764,2926,721,3969,2823,4587,326,8%
2010-10,הדרום,9000,באר שבע,7773,3326,4447,1052,6721,5216,7717,673,8%
2010-10,הדרום,2200,דימונה,2215,961,1254,133,2082,1548,2171,229,12%
2010-10,הדרום,1303,חורה,729,324,405,1,728,671,729,16,24%
2010-10,הדרום,831,ירוחם,511,241,270,23,488,301,503,80,12%
2010-10,הדרום,1059,כסיפה,973,422,551,1,972,882,971,24,26%
2010-10,הדרום,1271,להבים,50,29,21,27,23,5,50,14,2%
2010-10,הדרום,1060,לקיה,916,416,500,3,913,843,914,7,29%
2010-10,הדרום,1268,מיתר,68,22,46,25,43,6,68,15,2%
2010-10,הדרום,99,מצפה רמון,279,104,175,26,253,132,249,38,11%
2010-10,הדרום,246,נתיבות,1085,408,677,65,1020,569,1078,130,9%
2010-10,הדרום,666,עומר,64,20,44,32,32,10,62,9,2%
2010-10,הדרום,2560,ערד,966,400,566,183,783,590,941,109,8%
2010-10,הדרום,1192,ערערה-בנגב,991,403,588,3,988,898,990,12,31%
2010-10,הדרום,2630,קריית גת,2543,1001,1542,218,2325,1648,2534,201,10%
2010-10,הדרום,1034,קריית מלאכי,1354,605,749,46,1308,879,1335,141,12%
2010-10,הדרום,1161,רהט,3037,1194,1843,7,3030,2674,3035,200,22%
2010-10,הדרום,1286,שגב-שלום,559,233,326,3,556,497,558,29,27%
2010-10,הדרום,1031,שדרות,1148,453,695,72,1076,654,1145,100,10%
2010-10,הדרום,1054,תל שבע,1195,581,614,4,1191,1091,1193,46,31%
2010-10,המרכז,182,אבן יהודה,158,68,90,55,103,19,158,22,3%
2010-10,המרכז,41,אליכין,62,26,36,15,47,17,62,4,4%
2010-10,המרכז,1309,אלעד,412,190,222,26,386,122,411,28,4%
2010-10,המרכז,2530,באר יעקב,271,123,148,35,236,83,266,31,4%
2010-10,המרכז,466,בית דגן,116,63,53,20,96,34,115,3,4%
2010-10,המרכז,1066,"בני עי""ש",197,95,102,29,168,85,195,7,5%
2010-10,המרכז,681,גבעת שמואל,273,118,155,112,161,51,271,13,3%
2010-10,המרכז,2550,גדרה,350,153,197,63,287,110,343,25,3%
2010-10,המרכז,627,ג'לג'וליה,66,31,35,5,61,32,66,8,2%
2010-10,המרכז,166,גן יבנה,358,129,229,43,315,102,356,41,4%
2010-10,המרכז,229,גני תקווה,192,86,106,47,145,31,192,10,3%
2010-10,המרכז,9700,הוד השרון,585,252,333,193,392,66,583,50,2%
2010-10,המרכז,1290,זמר,163,54,109,5,158,131,163,4,7%
2010-10,המרכז,2730,טייבה,2084,879,1205,3,2081,1787,2070,38,14%
2010-10,המרכז,2720,טירה,307,135,172,10,297,201,306,12,3%
2010-10,המרכז,2660,יבנה,1018,443,575,84,934,448,1017,81,6%
2010-10,המרכז,9400,יהוד,613,249,364,103,510,92,585,45,4%
2010-10,המרכז,1224,כוכב יאיר,82,33,49,43,39,5,82,10,2%
2010-10,המרכז,633,כפר ברא,24,12,12,0,24,9,24,1,2%
2010-10,המרכז,168,כפר יונה,362,137,225,52,310,102,360,51,4%
2010-10,המרכז,6900,כפר סבא,1220,509,711,358,862,226,1208,110,3%
2010-10,המרכז,634,כפר קאסם,216,111,105,1,215,125,214,19,3%
2010-10,המרכז,7000,לוד,2262,977,1285,205,2057,1299,2246,199,7%
2010-10,המרכז,1200,מודיעין-מכבים-רעות*,934,378,556,343,591,75,921,109,3%
2010-10,המרכז,28,מזכרת בתיה,163,48,115,39,124,38,162,6,3%
2010-10,המרכז,7200,נס ציונה,679,303,376,131,548,207,672,32,3%
2010-10,המרכז,7400,נתניה,4975,2172,2803,711,4264,2194,4918,624,5%
2010-10,המרכז,587,סביון*,15,6,9,9,6,1,15,0,1%
2010-10,המרכז,171,פרדסייה,78,36,42,25,53,8,77,5,2%
2010-10,המרכז,7900,פתח תקווה,4248,1808,2440,815,3433,1280,4219,342,4%
2010-10,המרכז,195,קדימה-צורן,261,102,159,73,188,42,259,32,3%
2010-10,המרכז,638,קלנסווה,898,342,556,0,898,770,894,14,13%
2010-10,המרכז,469,קריית עקרון,297,135,162,13,284,123,293,13,5%
2010-10,המרכז,2640,ראש העין,798,369,429,93,705,188,780,87,4%
2010-10,המרכז,8300,ראשון לציון,4553,1929,2624,915,3638,1771,4531,307,4%
2010-10,המרכז,8400,רחובות,2711,1112,1599,548,2163,1068,2664,157,5%
2010-10,המרכז,8500,רמלה,1843,838,1005,107,1736,870,1807,197,6%
2010-10,המרכז,8700,רעננה,696,311,385,268,428,79,693,55,2%
2010-10,המרכז,1304,שוהם,200,83,117,80,120,5,200,19,2%
2010-10,המרכז,154,תל מונד,140,58,82,50,90,19,140,9,3%
2010-10,הצפון,473,אבו סנאן,750,292,458,4,746,610,746,18,16%
2010-10,הצפון,478,אכסאל,556,215,341,12,544,495,556,11,12%
2010-10,הצפון,529,אעבלין,653,263,390,11,642,545,653,14,14%
2010-10,הצפון,482,בועיינה-נוג'ידאת,487,206,281,9,478,407,483,7,15%
2010-10,הצפון,4001,בוקעאתא,379,160,219,5,374,322,369,6,16%
2010-10,הצפון,998,ביר אל-מכסור,423,151,272,2,421,340,423,7,14%
2010-10,הצפון,480,בית ג'ן,312,98,214,2,310,236,310,10,8%
2010-10,הצפון,9200,בית שאן,870,372,498,18,852,462,869,119,9%
2010-10,הצפון,944,בסמת טבעון,293,109,184,4,289,227,293,24,11%
2010-10,הצפון,483,בענה,469,189,280,3,466,409,469,8,17%
2010-10,הצפון,1292,ג'דיידה-מכר,1474,607,867,5,1469,1281,1474,29,19%
2010-10,הצפון,485,ג'ולס,217,56,161,3,214,131,217,13,9%
2010-10,הצפון,487,ג'ש (גוש חלב),60,28,32,6,54,35,60,3,4%
2010-10,הצפון,489,דבורייה,435,206,229,31,404,325,435,3,12%
2010-10,הצפון,490,דייר אל-אסד,436,178,258,9,427,351,436,9,11%
2010-10,הצפון,492,דייר חנא,653,287,366,14,639,541,653,25,17%
2010-10,הצפון,975,זרזיר,294,126,168,3,291,218,289,10,12%
2010-10,הצפון,496,חורפיש,139,55,84,4,135,94,139,1,7%
2010-10,הצפון,2034,חצור הגלילית,323,142,181,16,307,160,317,29,7%
2010-10,הצפון,6700,טבריה,1933,792,1141,127,1806,1216,1835,136,9%
2010-10,הצפון,962,טובא-זנגרייה,339,147,192,6,333,255,334,18,13%
2010-10,הצפון,498,טורעאן,540,202,338,12,528,463,538,15,12%
2010-10,הצפון,8900,טמרה,2030,835,1195,29,2001,1812,2027,42,17%
2010-10,הצפון,1295,יאנוח-ג'ת,173,61,112,3,170,116,173,7,8%
2010-10,הצפון,46,יבנאל,139,73,66,8,131,102,132,4,10%
2010-10,הצפון,499,יפיע,620,248,372,8,612,497,618,27,10%
2010-10,הצפון,240,יקנעם עילית,556,214,342,88,468,221,552,52,5%
2010-10,הצפון,502,ירכא,491,182,309,2,489,385,491,12,11%
2010-10,הצפון,504,כאבול,727,309,418,11,716,635,725,12,18%
2010-10,הצפון,505,כאוכב אבו אל-היג'א,200,81,119,7,193,175,200,7,14%
2010-10,הצפון,1296,כסרא-סמיע,214,89,125,1,213,160,214,10,8%
2010-10,הצפון,978,כעביה-טבאש-חג'אג'רה,203,85,118,2,201,147,200,1,11%
2010-10,הצפון,1263,כפר ורדים,61,20,41,25,36,10,60,6,2%
2010-10,הצפון,507,כפר יאסיף,489,212,277,6,483,399,487,9,11%
2010-10,הצפון,508,כפר כמא,75,34,41,3,72,43,74,0,6%
2010-10,הצפון,509,כפר כנא,1160,456,704,23,1137,1012,1148,32,16%
2010-10,הצפון,510,כפר מנדא,887,365,522,7,880,721,875,33,15%
2010-10,הצפון,47,כפר תבור,46,15,31,19,27,7,46,5,3%
2010-10,הצפון,1139,כרמיאל,1810,672,1138,372,1438,979,1743,140,7%
2010-10,הצפון,481,מגאר,1355,518,837,27,1328,1209,1351,40,19%
2010-10,הצפון,516,מג'ד אל-כרום,663,277,386,8,655,537,662,24,13%
2010-10,הצפון,874,מגדל העמק,1048,443,605,82,966,522,1012,145,8%
2010-10,הצפון,4201,מג'דל שמס,471,169,302,21,450,407,466,12,12%
2010-10,הצפון,517,מזרעה,172,65,107,4,168,136,170,11,11%
2010-10,הצפון,4203,מסעדה,203,81,122,6,197,170,202,3,14%
2010-10,הצפון,518,מעיליא,71,31,40,7,64,33,71,1,5%
2010-10,הצפון,1063,מעלות-תרשיחא,978,421,557,131,847,588,971,67,9%
2010-10,הצפון,520,משהד,308,111,197,2,306,267,305,15,12%
2010-10,הצפון,9100,נהרייה,2180,948,1232,270,1910,1358,2162,149,8%
2010-10,הצפון,522,נחף,466,185,281,17,449,388,465,13,11%
2010-10,הצפון,7300,נצרת,2847,1194,1653,93,2754,2163,2835,101,10%
2010-10,הצפון,1061,נצרת עילית,1898,791,1107,243,1655,1130,1804,268,8%
2010-10,הצפון,525,סאג'ור,110,38,72,2,108,87,109,3,8%
2010-10,הצפון,7500,סח'נין,1994,879,1115,42,1952,1756,1994,58,17%
2010-10,הצפון,4501,ע'ג'ר,88,36,52,1,87,70,88,3,11%
2010-10,הצפון,530,עיילבון,198,81,117,6,192,155,197,11,9%
2010-10,הצפון,511,עילוט,332,137,195,2,330,265,332,11,14%
2010-10,הצפון,532,עין מאהל,576,255,321,7,569,507,570,17,14%
2010-10,הצפון,7600,עכו,3300,1465,1835,142,3158,2597,3280,165,14%
2010-10,הצפון,7700,עפולה,2006,814,1192,208,1798,1058,1920,196,9%
2010-10,הצפון,531,עראבה,1358,569,789,34,1324,1190,1357,47,17%
2010-10,הצפון,535,פסוטה,132,61,71,8,124,97,132,4,9%
2010-10,הצפון,536,פקיעין (בוקייעה),143,76,67,8,135,95,142,3,6%
2010-10,הצפון,8000,צפת,1029,520,509,82,947,715,1020,49,9%
2010-10,הצפון,4100,קצרין,198,86,112,38,160,108,194,14,5%
2010-10,הצפון,2800,קריית שמונה,779,361,418,59,720,326,754,113,6%
2010-10,הצפון,543,ראמה,323,137,186,11,312,260,323,3,10%
2010-10,הצפון,26,ראש פינה,45,15,30,7,38,19,45,2,3%
2010-10,הצפון,542,ריינה,636,251,385,14,622,516,630,27,11%
2010-10,הצפון,122,רמת ישי,106,39,67,28,78,12,105,8,3%
2010-10,הצפון,913,שבלי - אום אל-גנם,250,109,141,7,243,201,248,3,12%
2010-10,הצפון,812,שלומי,271,111,160,16,255,160,269,17,8%
2010-10,הצפון,538,שעב,495,212,283,3,492,421,494,12,20%
2010-10,הצפון,8800,שפרעם,2072,799,1273,30,2042,1714,2064,59,14%
2010-10,חיפה,2710,אום אל-פחם,3450,1439,2011,10,3440,2994,3446,68,20%
2010-10,חיפה,1020,אור עקיבא,632,261,371,42,590,245,616,71,7%
2010-10,חיפה,6000,באקה אל-גרביה,579,303,276,11,568,370,578,48,NULL
2010-10,חיפה,9800,בנימינה-גבעת עדה*,201,89,112,72,129,48,199,13,3%
2010-10,חיפה,1326,"בסמ""ה",380,182,198,5,375,292,380,10,12%
2010-10,חיפה,541,ג'סר א-זרקא,374,212,162,0,374,257,370,30,7%
2010-10,חיפה,628,ג'ת,174,81,93,9,165,116,174,12,NULL
2010-10,חיפה,494,דאלית אל-כרמל,489,202,287,13,476,291,488,13,7%
2010-10,חיפה,9300,זכרון יעקב,227,89,138,81,146,49,225,15,3%
2010-10,חיפה,6500,חדרה,2399,933,1466,296,2103,957,2357,268,5%
2010-10,חיפה,4000,חיפה,8708,3694,5014,1679,7029,5659,8655,563,7%
2010-10,חיפה,1247,חריש-קציר,25,8,17,1,24,10,24,5,1%
2010-10,חיפה,2100,טירת כרמל,796,346,450,33,763,525,785,54,8%
2010-10,חיפה,654,כפר קרע,369,163,206,13,356,208,367,22,5%
2010-10,חיפה,1327,מעלה עירון,840,322,518,5,835,708,838,25,18%
2010-10,חיפה,2500,נשר,596,271,325,114,482,319,592,41,5%
2010-10,חיפה,534,עספיא,319,146,173,8,311,209,319,26,7%
2010-10,חיפה,637,ערערה,509,206,303,10,499,341,509,22,8%
2010-10,חיפה,537,פוריידיס,384,183,201,1,383,258,382,24,8%
2010-10,חיפה,7800,פרדס חנה-כרכור,850,334,516,132,718,268,835,113,5%
2010-10,חיפה,6800,קריית אתא,1975,776,1199,178,1797,1275,1963,113,7%
2010-10,חיפה,9500,קריית ביאליק,1267,503,764,174,1093,697,1263,95,6%
2010-10,חיפה,2300,קריית טבעון,178,74,104,62,116,51,177,16,2%
2010-10,חיפה,9600,קריית ים,1838,773,1065,166,1672,1243,1831,131,9%
2010-10,חיפה,8200,קריית מוצקין,1240,459,781,177,1063,668,1227,91,6%
2010-10,חיפה,922,רכסים,154,68,86,7,147,106,153,11,6%
2010-10,ירושלים,472,אבו גוש,287,137,150,11,276,198,287,14,12%
2010-10,ירושלים,2610,בית שמש,1274,499,775,112,1162,610,1256,171,5%
2010-10,ירושלים,3000,ירושלים,10272,4376,5896,1308,8964,5933,10191,761,4%
2010-10,ירושלים,1015,מבשרת ציון,352,164,188,82,270,127,349,29,3%
2010-10,ירושלים,1137,קריית יערים,37,15,22,5,32,12,37,4,4%
2010-10,תל אביב,2400,אור יהודה,881,366,515,43,838,337,866,85,5%
2010-10,תל אביב,565,אזור,182,91,91,27,155,45,179,25,3%
2010-10,תל אביב,6100,בני ברק,2318,1084,1234,130,2188,1370,2305,172,5%
2010-10,תל אביב,6200,בת ים,3635,1613,2022,531,3104,1622,3569,331,5%
2010-10,תל אביב,6300,גבעתיים,735,302,433,311,424,129,728,51,3%
2010-10,תל אביב,6400,הרצלייה,1122,465,657,311,811,156,1109,177,2%
2010-10,תל אביב,6600,חולון,3219,1455,1764,519,2700,1051,3169,317,3%
2010-10,תל אביב,2620,קריית אונו,458,191,267,182,276,53,451,21,3%
2010-10,תל אביב,8600,רמת גן,2158,923,1235,643,1515,580,2139,194,3%
2010-10,תל אביב,2650,רמת השרון,434,188,246,165,269,42,431,44,2%
2010-10,תל אביב,5000,תל אביב -יפו,8111,3850,4261,2225,5886,3013,8039,601,3%
2010-11,אזור יהודה והשומרון,3760,אורנית,86,42,44,32,54,4,86,13,2%
2010-11,אזור יהודה והשומרון,3750,אלפי מנשה,91,38,53,24,67,5,90,10,2%
2010-11,אזור יהודה והשומרון,3560,אלקנה,40,19,21,21,19,3,40,2,2%
2010-11,אזור יהודה והשומרון,3650,אפרתה,56,29,27,32,24,8,55,4,2%
2010-11,אזור יהודה והשומרון,3570,אריאל,381,168,213,96,285,132,381,42,4%
2010-11,אזור יהודה והשומרון,3574,בית אל,51,23,28,16,35,14,50,5,2%
2010-11,אזור יהודה והשומרון,3652,בית אריה,63,28,35,11,52,6,63,4,3%
2010-11,אזור יהודה והשומרון,3780,ביתר עילית,437,190,247,18,419,196,432,18,5%
2010-11,אזור יהודה והשומרון,3730,גבעת זאב,187,84,103,22,165,45,187,14,3%
2010-11,אזור יהודה והשומרון,3769,הר אדר,28,17,11,13,15,3,28,3,2%
2010-11,אזור יהודה והשומרון,3797,מודיעין עילית,309,114,195,21,288,88,307,22,3%
2010-11,אזור יהודה והשומרון,3616,מעלה אדומים,674,263,411,98,576,221,666,68,4%
2010-11,אזור יהודה והשומרון,3660,עמנואל,91,49,42,4,87,59,90,6,10%
2010-11,אזור יהודה והשומרון,3557,קדומים,26,18,8,9,17,8,26,3,2%
2010-11,אזור יהודה והשומרון,3611,קריית ארבע,112,52,60,17,95,68,112,8,4%
2010-11,אזור יהודה והשומרון,3640,קרני שומרון,86,48,38,23,63,25,84,4,3%
2010-11,הדרום,31,אופקים,1429,592,837,95,1334,1018,1413,63,13%
2010-11,הדרום,2600,אילת,1429,649,780,99,1330,668,1408,115,5%
2010-11,הדרום,70,אשדוד,7282,2804,4478,817,6465,4455,7224,454,7%
2010-11,הדרום,7100,אשקלון,4488,1718,2770,673,3815,2836,4383,269,8%
2010-11,הדרום,9000,באר שבע,7621,3282,4339,1006,6615,5136,7559,604,8%
2010-11,הדרום,2200,דימונה,2141,936,1205,125,2016,1506,2097,163,12%
2010-11,הדרום,1303,חורה,725,321,404,1,724,668,725,12,24%
2010-11,הדרום,831,ירוחם,487,236,251,28,459,287,476,84,11%
2010-11,הדרום,1059,כסיפה,967,416,551,2,965,889,964,29,26%
2010-11,הדרום,1271,להבים,34,19,15,19,15,4,34,1,1%
2010-11,הדרום,1060,לקיה,914,414,500,3,911,849,912,12,28%
2010-11,הדרום,1268,מיתר,57,20,37,20,37,6,57,5,2%
2010-11,הדרום,99,מצפה רמון,288,99,189,22,266,132,257,30,11%
2010-11,הדרום,246,נתיבות,1028,399,629,64,964,562,1022,131,9%
2010-11,הדרום,666,עומר,60,21,39,31,29,10,60,5,2%
2010-11,הדרום,2560,ערד,906,368,538,176,730,582,883,113,7%
2010-11,הדרום,1192,ערערה-בנגב,968,383,585,2,966,898,968,7,30%
2010-11,הדרום,2630,קריית גת,2408,940,1468,207,2201,1595,2400,144,10%
2010-11,הדרום,1034,קריית מלאכי,1326,600,726,50,1276,872,1303,134,12%
2010-11,הדרום,1161,רהט,2850,1104,1746,5,2845,2559,2849,120,20%
2010-11,הדרום,1286,שגב-שלום,541,215,326,2,539,489,540,9,26%
2010-11,הדרום,1031,שדרות,1100,437,663,71,1029,652,1097,72,10%
2010-11,הדרום,1054,תל שבע,1171,560,611,2,1169,1081,1169,22,30%
2010-11,המרכז,182,אבן יהודה,139,64,75,49,90,16,138,14,2%
2010-11,המרכז,41,אליכין,65,27,38,13,52,19,65,4,4%
2010-11,המרכז,1309,אלעד,409,187,222,23,386,127,405,14,4%
2010-11,המרכז,2530,באר יעקב,254,105,149,36,218,83,250,25,4%
2010-11,המרכז,466,בית דגן,111,58,53,24,87,34,110,11,3%
2010-11,המרכז,1066,"בני עי""ש",190,90,100,28,162,87,188,8,5%
2010-11,המרכז,681,גבעת שמואל,277,124,153,117,160,51,273,14,3%
2010-11,המרכז,2550,גדרה,317,136,181,53,264,101,315,13,3%
2010-11,המרכז,627,ג'לג'וליה,60,31,29,3,57,28,60,4,2%
2010-11,המרכז,166,גן יבנה,326,129,197,33,293,101,325,17,3%
2010-11,המרכז,229,גני תקווה,191,91,100,47,144,32,190,5,3%
2010-11,המרכז,9700,הוד השרון,558,237,321,179,379,66,553,44,2%
2010-11,המרכז,1290,זמר,164,57,107,5,159,133,164,8,7%
2010-11,המרכז,2730,טייבה,2052,860,1192,2,2050,1769,2043,42,14%
2010-11,המרכז,2720,טירה,319,144,175,6,313,200,315,25,4%
2010-11,המרכז,2660,יבנה,1016,434,582,83,933,441,1013,89,6%
2010-11,המרכז,9400,יהוד,591,236,355,103,488,88,562,42,4%
2010-11,המרכז,1224,כוכב יאיר,84,32,52,47,37,5,84,6,2%
2010-11,המרכז,633,כפר ברא,20,8,12,0,20,8,20,1,2%
2010-11,המרכז,168,כפר יונה,340,134,206,55,285,95,333,26,4%
2010-11,המרכז,6900,כפר סבא,1152,473,679,346,806,211,1145,105,3%
2010-11,המרכז,634,כפר קאסם,194,96,98,2,192,120,194,17,3%
2010-11,המרכז,7000,לוד,2174,950,1224,192,1982,1296,2160,178,7%
2010-11,המרכז,1200,מודיעין-מכבים-רעות*,915,375,540,344,571,74,900,76,2%
2010-11,המרכז,28,מזכרת בתיה,152,50,102,37,115,40,151,3,3%
2010-11,המרכז,7200,נס ציונה,625,270,355,131,494,205,620,42,3%
2010-11,המרכז,7400,נתניה,4727,2115,2612,681,4046,2057,4665,500,5%
2010-11,המרכז,587,סביון*,16,8,8,9,7,1,16,0,1%
2010-11,המרכז,171,פרדסייה,82,41,41,30,52,8,82,3,2%
2010-11,המרכז,7900,פתח תקווה,4067,1722,2345,814,3253,1251,4031,312,4%
2010-11,המרכז,195,קדימה-צורן,235,100,135,64,171,37,234,25,3%
2010-11,המרכז,638,קלנסווה,890,344,546,0,890,763,886,10,13%
2010-11,המרכז,469,קריית עקרון,277,125,152,11,266,116,273,15,5%
2010-11,המרכז,2640,ראש העין,744,359,385,96,648,182,733,79,4%
2010-11,המרכז,8300,ראשון לציון,4483,1915,2568,918,3565,1759,4460,318,4%
2010-11,המרכז,8400,רחובות,2608,1075,1533,539,2069,1039,2575,134,5%
2010-11,המרכז,8500,רמלה,1727,785,942,85,1642,843,1701,163,5%
2010-11,המרכז,8700,רעננה,663,299,364,280,383,75,662,30,2%
2010-11,המרכז,1304,שוהם,186,77,109,76,110,4,186,24,2%
2010-11,המרכז,154,תל מונד,130,59,71,47,83,23,130,5,2%
2010-11,הצפון,473,אבו סנאן,721,274,447,4,717,603,717,13,15%
2010-11,הצפון,478,אכסאל,539,208,331,6,533,491,539,10,12%
2010-11,הצפון,529,אעבלין,638,247,391,9,629,547,638,9,14%
2010-11,הצפון,482,בועיינה-נוג'ידאת,480,202,278,7,473,413,476,5,15%
2010-11,הצפון,4001,בוקעאתא,377,154,223,5,372,325,367,13,16%
2010-11,הצפון,998,ביר אל-מכסור,430,156,274,2,428,349,430,3,14%
2010-11,הצפון,480,בית ג'ן,316,90,226,1,315,242,313,5,8%
2010-11,הצפון,9200,בית שאן,827,361,466,20,807,454,827,102,9%
2010-11,הצפון,944,בסמת טבעון,265,101,164,2,263,208,265,6,10%
2010-11,הצפון,483,בענה,472,187,285,4,468,410,472,11,17%
2010-11,הצפון,1292,ג'דיידה-מכר,1453,594,859,6,1447,1271,1453,25,19%
2010-11,הצפון,485,ג'ולס,239,60,179,3,236,138,239,8,10%
2010-11,הצפון,487,ג'ש (גוש חלב),55,23,32,4,51,33,55,2,4%
2010-11,הצפון,489,דבורייה,415,195,220,27,388,314,414,5,12%
2010-11,הצפון,490,דייר אל-אסד,432,174,258,8,424,354,432,12,10%
2010-11,הצפון,492,דייר חנא,639,275,364,13,626,531,639,15,16%
2010-11,הצפון,975,זרזיר,297,120,177,2,295,223,292,15,12%
2010-11,הצפון,496,חורפיש,149,59,90,4,145,103,149,8,7%
2010-11,הצפון,2034,חצור הגלילית,316,131,185,16,300,149,308,36,7%
2010-11,הצפון,6700,טבריה,1925,810,1115,122,1803,1209,1825,152,9%
2010-11,הצפון,962,טובא-זנגרייה,344,151,193,6,338,255,341,10,13%
2010-11,הצפון,498,טורעאן,529,198,331,10,519,461,527,14,12%
2010-11,הצפון,8900,טמרה,2007,812,1195,24,1983,1797,2005,26,17%
2010-11,הצפון,1295,יאנוח-ג'ת,165,54,111,3,162,115,165,4,8%
2010-11,הצפון,46,יבנאל,122,66,56,7,115,92,115,4,9%
2010-11,הצפון,499,יפיע,609,259,350,7,602,491,607,26,9%
2010-11,הצפון,240,יקנעם עילית,511,195,316,84,427,208,508,62,5%
2010-11,הצפון,502,ירכא,491,190,301,1,490,385,491,13,11%
2010-11,הצפון,504,כאבול,725,309,416,11,714,632,723,15,18%
2010-11,הצפון,505,כאוכב אבו אל-היג'א,201,80,121,8,193,176,201,4,14%
2010-11,הצפון,1296,כסרא-סמיע,202,79,123,1,201,157,202,5,8%
2010-11,הצפון,978,כעביה-טבאש-חג'אג'רה,194,80,114,3,191,147,192,1,10%
2010-11,הצפון,1263,כפר ורדים,72,25,47,27,45,10,72,7,2%
2010-11,הצפון,507,כפר יאסיף,492,211,281,6,486,392,491,19,12%
2010-11,הצפון,508,כפר כמא,73,33,40,3,70,41,72,2,5%
2010-11,הצפון,509,כפר כנא,1143,446,697,24,1119,1002,1133,35,16%
2010-11,הצפון,510,כפר מנדא,874,374,500,5,869,722,865,27,15%
2010-11,הצפון,47,כפר תבור,46,16,30,17,29,6,46,2,3%
2010-11,הצפון,1139,כרמיאל,1767,650,1117,365,1402,975,1712,118,7%
2010-11,הצפון,481,מגאר,1361,510,851,28,1333,1234,1358,27,19%
2010-11,הצפון,516,מג'ד אל-כרום,645,268,377,8,637,524,644,17,12%
2010-11,הצפון,874,מגדל העמק,988,413,575,71,917,506,952,162,8%
2010-11,הצפון,4201,מג'דל שמס,475,178,297,23,452,411,470,17,12%
2010-11,הצפון,517,מזרעה,166,60,106,5,161,137,164,1,10%
2010-11,הצפון,4203,מסעדה,197,77,120,6,191,168,196,6,14%
2010-11,הצפון,518,מעיליא,65,28,37,7,58,34,65,5,5%
2010-11,הצפון,1063,מעלות-תרשיחא,931,399,532,125,806,567,928,51,8%
2010-11,הצפון,520,משהד,305,113,192,3,302,269,302,5,12%
2010-11,הצפון,9100,נהרייה,2089,906,1183,254,1835,1322,2075,138,7%
2010-11,הצפון,522,נחף,472,195,277,15,457,388,471,11,12%
2010-11,הצפון,7300,נצרת,2812,1187,1625,76,2736,2150,2796,85,10%
2010-11,הצפון,1061,נצרת עילית,1815,748,1067,229,1586,1128,1723,255,8%
2010-11,הצפון,525,סאג'ור,105,36,69,2,103,82,104,1,7%
2010-11,הצפון,7500,סח'נין,1983,877,1106,40,1943,1746,1983,38,17%
2010-11,הצפון,4501,ע'ג'ר,87,36,51,1,86,73,87,3,10%
2010-11,הצפון,530,עיילבון,196,79,117,3,193,157,195,8,9%
2010-11,הצפון,511,עילוט,322,122,200,2,320,261,322,13,14%
2010-11,הצפון,532,עין מאהל,575,247,328,8,567,515,569,16,14%
2010-11,הצפון,7600,עכו,3283,1451,1832,141,3142,2577,3264,152,14%
2010-11,הצפון,7700,עפולה,1899,771,1128,203,1696,1049,1831,190,8%
2010-11,הצפון,531,עראבה,1341,554,787,29,1312,1188,1340,27,17%
2010-11,הצפון,535,פסוטה,131,58,73,9,122,93,131,5,9%
2010-11,הצפון,536,פקיעין (בוקייעה),131,64,67,5,126,93,130,8,6%
2010-11,הצפון,8000,צפת,983,486,497,85,898,696,975,32,9%
2010-11,הצפון,4100,קצרין,192,85,107,43,149,103,189,10,5%
2010-11,הצפון,2800,קריית שמונה,758,365,393,57,701,308,739,104,6%
2010-11,הצפון,543,ראמה,304,125,179,10,294,249,302,15,9%
2010-11,הצפון,26,ראש פינה,42,13,29,8,34,19,42,4,3%
2010-11,הצפון,542,ריינה,608,241,367,8,600,508,604,25,11%
2010-11,הצפון,122,רמת ישי,96,41,55,25,71,10,95,9,3%
2010-11,הצפון,913,שבלי - אום אל-גנם,255,110,145,5,250,200,252,3,12%
2010-11,הצפון,812,שלומי,267,109,158,20,247,160,263,16,8%
2010-11,הצפון,538,שעב,489,207,282,3,486,416,488,8,19%
2010-11,הצפון,8800,שפרעם,2013,747,1266,32,1981,1697,2007,50,14%
2010-11,חיפה,2710,אום אל-פחם,3413,1398,2015,9,3404,2989,3409,72,20%
2010-11,חיפה,1020,אור עקיבא,620,259,361,44,576,249,605,85,7%
2010-11,חיפה,6000,באקה אל-גרביה,551,289,262,10,541,365,550,27,NULL
2010-11,חיפה,9800,בנימינה-גבעת עדה*,196,87,109,70,126,49,195,28,3%
2010-11,חיפה,1326,"בסמ""ה",382,175,207,4,378,301,382,10,12%
2010-11,חיפה,541,ג'סר א-זרקא,362,208,154,0,362,253,359,20,7%
2010-11,חיפה,628,ג'ת,168,73,95,7,161,116,168,4,NULL
2010-11,חיפה,494,דאלית אל-כרמל,493,200,293,12,481,297,491,22,7%
2010-11,חיפה,9300,זכרון יעקב,228,91,137,82,146,44,225,19,3%
2010-11,חיפה,6500,חדרה,2414,955,1459,287,2127,1001,2370,265,5%
2010-11,חיפה,4000,חיפה,8390,3592,4798,1598,6792,5577,8337,588,6%
2010-11,חיפה,1247,חריש-קציר,25,9,16,1,24,11,25,2,2%
2010-11,חיפה,2100,טירת כרמל,789,345,444,36,753,517,780,61,8%
2010-11,חיפה,654,כפר קרע,359,154,205,11,348,210,357,26,5%
2010-11,חיפה,1327,מעלה עירון,828,317,511,5,823,700,826,12,18%
2010-11,חיפה,2500,נשר,563,253,310,105,458,305,560,58,5%
2010-11,חיפה,534,עספיא,327,147,180,7,320,204,327,12,7%
2010-11,חיפה,637,ערערה,525,207,318,9,516,350,525,31,8%
2010-11,חיפה,537,פוריידיס,379,183,196,2,377,255,376,13,8%
2010-11,חיפה,7800,פרדס חנה-כרכור,834,339,495,131,703,276,820,99,5%
2010-11,חיפה,6800,קריית אתא,1958,765,1193,169,1789,1259,1945,119,7%
2010-11,חיפה,9500,קריית ביאליק,1247,488,759,172,1075,693,1244,83,6%
2010-11,חיפה,2300,קריית טבעון,180,69,111,61,119,48,180,14,2%
2010-11,חיפה,9600,קריית ים,1794,754,1040,167,1627,1204,1786,95,9%
2010-11,חיפה,8200,קריית מוצקין,1189,427,762,169,1020,657,1175,93,6%
2010-11,חיפה,922,רכסים,154,69,85,8,146,101,153,7,6%
2010-11,ירושלים,472,אבו גוש,266,114,152,8,258,195,266,7,11%
2010-11,ירושלים,2610,בית שמש,1184,470,714,106,1078,599,1162,109,5%
2010-11,ירושלים,3000,ירושלים,10182,4308,5874,1253,8929,5980,10104,729,4%
2010-11,ירושלים,1015,מבשרת ציון,337,156,181,71,266,132,332,19,3%
2010-11,ירושלים,1137,קריית יערים,40,16,24,8,32,15,40,3,4%
2010-11,תל אביב,2400,אור יהודה,865,367,498,40,825,317,852,78,5%
2010-11,תל אביב,565,אזור,178,82,96,24,154,44,176,23,3%
2010-11,תל אביב,6100,בני ברק,2236,1045,1191,126,2110,1353,2225,132,5%
2010-11,תל אביב,6200,בת ים,3553,1560,1993,530,3023,1609,3480,308,5%
2010-11,תל אביב,6300,גבעתיים,695,304,391,291,404,130,689,54,3%
2010-11,תל אביב,6400,הרצלייה,1100,466,634,326,774,152,1078,177,2%
2010-11,תל אביב,6600,חולון,3130,1428,1702,518,2612,1078,3062,306,3%
2010-11,תל אביב,2620,קריית אונו,448,184,264,178,270,58,442,36,3%
2010-11,תל אביב,8600,רמת גן,2123,911,1212,628,1495,572,2107,142,3%
2010-11,תל אביב,2650,רמת השרון,431,193,238,176,255,38,426,58,2%
2010-11,תל אביב,5000,תל אביב -יפו,7956,3855,4101,2212,5744,2927,7881,568,3%
2010-12,אזור יהודה והשומרון,3760,אורנית,88,34,54,35,53,3,87,9,2%
2010-12,אזור יהודה והשומרון,3750,אלפי מנשה,86,41,45,25,61,2,85,10,2%
2010-12,אזור יהודה והשומרון,3560,אלקנה,32,13,19,16,16,2,32,1,2%
2010-12,אזור יהודה והשומרון,3650,אפרתה,55,29,26,27,28,9,55,2,2%
2010-12,אזור יהודה והשומרון,3570,אריאל,365,168,197,89,276,124,364,34,4%
2010-12,אזור יהודה והשומרון,3574,בית אל,49,20,29,15,34,15,48,9,2%
2010-12,אזור יהודה והשומרון,3652,בית אריה,56,21,35,9,47,7,56,5,3%
2010-12,אזור יהודה והשומרון,3780,ביתר עילית,401,180,221,17,384,198,396,30,5%
2010-12,אזור יהודה והשומרון,3730,גבעת זאב,162,75,87,17,145,43,162,13,3%
2010-12,אזור יהודה והשומרון,3769,הר אדר,22,13,9,10,12,2,22,0,1%
2010-12,אזור יהודה והשומרון,3797,מודיעין עילית,305,115,190,18,287,85,301,18,3%
2010-12,אזור יהודה והשומרון,3616,מעלה אדומים,678,282,396,99,579,237,665,73,4%
2010-12,אזור יהודה והשומרון,3660,עמנואל,87,46,41,4,83,58,86,8,9%
2010-12,אזור יהודה והשומרון,3557,קדומים,22,16,6,7,15,7,22,0,1%
2010-12,אזור יהודה והשומרון,3611,קריית ארבע,106,50,56,18,88,64,106,12,4%
2010-12,אזור יהודה והשומרון,3640,קרני שומרון,79,42,37,23,56,28,79,8,2%
2010-12,הדרום,31,אופקים,1377,569,808,94,1283,1015,1362,56,12%
2010-12,הדרום,2600,אילת,1409,644,765,94,1315,658,1393,90,5%
2010-12,הדרום,70,אשדוד,6986,2716,4270,793,6193,4341,6922,445,7%
2010-12,הדרום,7100,אשקלון,4311,1651,2660,657,3654,2799,4208,264,7%
2010-12,הדרום,9000,באר שבע,7452,3203,4249,984,6468,5067,7394,593,8%
2010-12,הדרום,2200,דימונה,2005,886,1119,111,1894,1447,1976,119,11%
2010-12,הדרום,1303,חורה,724,319,405,1,723,669,724,17,24%
2010-12,הדרום,831,ירוחם,429,219,210,22,407,265,424,50,10%
2010-12,הדרום,1059,כסיפה,970,417,553,2,968,895,967,23,26%
2010-12,הדרום,1271,להבים,31,16,15,19,12,4,31,3,1%
2010-12,הדרום,1060,לקיה,916,416,500,3,913,857,914,17,29%
2010-12,הדרום,1268,מיתר,60,23,37,24,36,5,60,9,2%
2010-12,הדרום,99,מצפה רמון,258,95,163,21,237,136,242,32,11%
2010-12,הדרום,246,נתיבות,959,369,590,61,898,549,952,94,8%
2010-12,הדרום,666,עומר,63,23,40,33,30,9,63,6,2%
2010-12,הדרום,2560,ערד,899,375,524,168,731,567,872,87,7%
2010-12,הדרום,1192,ערערה-בנגב,978,387,591,3,975,909,978,14,30%
2010-12,הדרום,2630,קריית גת,2298,908,1390,201,2097,1565,2292,165,9%
2010-12,הדרום,1034,קריית מלאכי,1281,565,716,45,1236,859,1260,132,12%
2010-12,הדרום,1161,רהט,2891,1142,1749,4,2887,2624,2889,63,21%
2010-12,הדרום,1286,שגב-שלום,553,223,330,2,551,504,551,10,27%
2010-12,הדרום,1031,שדרות,1027,409,618,58,969,633,1024,74,9%
2010-12,הדרום,1054,תל שבע,1155,549,606,2,1153,1082,1153,18,30%
2010-12,המרכז,182,אבן יהודה,130,66,64,50,80,14,129,7,2%
2010-12,המרכז,41,אליכין,62,26,36,10,52,18,60,6,4%
2010-12,המרכז,1309,אלעד,386,182,204,24,362,117,381,15,4%
2010-12,המרכז,2530,באר יעקב,260,109,151,41,219,79,256,20,4%
2010-12,המרכז,466,בית דגן,100,46,54,19,81,33,99,10,3%
2010-12,המרכז,1066,"בני עי""ש",181,84,97,29,152,89,178,8,5%
2010-12,המרכז,681,גבעת שמואל,269,128,141,114,155,57,269,19,3%
2010-12,המרכז,2550,גדרה,317,143,174,55,262,106,316,15,3%
2010-12,המרכז,627,ג'לג'וליה,63,30,33,2,61,29,63,1,2%
2010-12,המרכז,166,גן יבנה,305,120,185,36,269,99,304,24,3%
2010-12,המרכז,229,גני תקווה,184,78,106,51,133,28,183,11,3%
2010-12,המרכז,9700,הוד השרון,544,230,314,176,368,62,542,50,2%
2010-12,המרכז,1290,זמר,163,54,109,5,158,133,163,7,7%
2010-12,המרכז,2730,טייבה,2075,871,1204,3,2072,1800,2065,46,14%
2010-12,המרכז,2720,טירה,311,143,168,6,305,197,310,17,3%
2010-12,המרכז,2660,יבנה,949,417,532,88,861,441,947,85,5%
2010-12,המרכז,9400,יהוד,535,210,325,94,441,85,512,31,4%
2010-12,המרכז,1224,כוכב יאיר,88,36,52,48,40,5,88,4,2%
2010-12,המרכז,633,כפר ברא,30,15,15,0,30,10,30,1,3%
2010-12,המרכז,168,כפר יונה,331,140,191,48,283,92,327,33,3%
2010-12,המרכז,6900,כפר סבא,1087,461,626,335,752,215,1081,87,2%
2010-12,המרכז,634,כפר קאסם,207,104,103,0,207,120,205,8,3%
2010-12,המרכז,7000,לוד,2143,945,1198,193,1950,1279,2132,160,7%
2010-12,המרכז,1200,מודיעין-מכבים-רעות*,872,364,508,336,536,73,861,90,2%
2010-12,המרכז,28,מזכרת בתיה,148,54,94,35,113,39,148,2,3%
2010-12,המרכז,7200,נס ציונה,598,257,341,123,475,193,592,18,3%
2010-12,המרכז,7400,נתניה,4500,2047,2453,636,3864,2019,4439,421,5%
2010-12,המרכז,587,סביון*,16,9,7,10,6,1,16,0,1%
2010-12,המרכז,171,פרדסייה,82,39,43,31,51,10,82,6,2%
2010-12,המרכז,7900,פתח תקווה,3850,1681,2169,784,3066,1189,3820,306,4%
2010-12,המרכז,195,קדימה-צורן,240,108,132,70,170,42,238,21,3%
2010-12,המרכז,638,קלנסווה,871,337,534,0,871,753,867,19,12%
2010-12,המרכז,469,קריית עקרון,268,134,134,11,257,119,264,9,5%
2010-12,המרכז,2640,ראש העין,731,352,379,86,645,186,719,70,4%
2010-12,המרכז,8300,ראשון לציון,4359,1854,2505,904,3455,1746,4340,346,3%
2010-12,המרכז,8400,רחובות,2490,1018,1472,528,1962,1049,2454,116,4%
2010-12,המרכז,8500,רמלה,1687,759,928,90,1597,854,1666,144,5%
2010-12,המרכז,8700,רעננה,654,302,352,277,377,80,652,43,2%
2010-12,המרכז,1304,שוהם,180,66,114,72,108,5,179,16,2%
2010-12,המרכז,154,תל מונד,140,63,77,52,88,22,140,6,3%
2010-12,הצפון,473,אבו סנאן,727,285,442,4,723,605,723,34,15%
2010-12,הצפון,478,אכסאל,556,220,336,7,549,507,556,14,12%
2010-12,הצפון,529,אעבלין,635,246,389,9,626,543,635,12,14%
2010-12,הצפון,482,בועיינה-נוג'ידאת,505,213,292,6,499,417,500,4,16%
2010-12,הצפון,4001,בוקעאתא,370,152,218,6,364,315,361,10,16%
2010-12,הצפון,998,ביר אל-מכסור,432,156,276,2,430,348,432,6,14%
2010-12,הצפון,480,בית ג'ן,308,93,215,3,305,241,305,5,7%
2010-12,הצפון,9200,בית שאן,801,355,446,18,783,464,799,98,9%
2010-12,הצפון,944,בסמת טבעון,269,111,158,4,265,213,269,11,10%
2010-12,הצפון,483,בענה,471,189,282,3,468,415,471,11,17%
2010-12,הצפון,1292,ג'דיידה-מכר,1453,602,851,7,1446,1278,1453,52,19%
2010-12,הצפון,485,ג'ולס,238,61,177,3,235,141,238,30,10%
2010-12,הצפון,487,ג'ש (גוש חלב),54,26,28,4,50,33,54,1,4%
2010-12,הצפון,489,דבורייה,426,205,221,23,403,316,426,9,12%
2010-12,הצפון,490,דייר אל-אסד,420,173,247,8,412,347,420,6,10%
2010-12,הצפון,492,דייר חנא,642,276,366,10,632,535,642,25,16%
2010-12,הצפון,975,זרזיר,291,118,173,3,288,214,288,11,12%
2010-12,הצפון,496,חורפיש,149,60,89,4,145,98,149,5,7%
2010-12,הצפון,2034,חצור הגלילית,306,135,171,15,291,146,296,29,7%
2010-12,הצפון,6700,טבריה,1859,792,1067,120,1739,1211,1762,108,9%
2010-12,הצפון,962,טובא-זנגרייה,351,166,185,5,346,257,345,16,13%
2010-12,הצפון,498,טורעאן,540,208,332,11,529,467,538,13,12%
2010-12,הצפון,8900,טמרה,2011,814,1197,23,1988,1806,2008,39,17%
2010-12,הצפון,1295,יאנוח-ג'ת,163,60,103,4,159,114,163,3,8%
2010-12,הצפון,46,יבנאל,129,71,58,7,122,96,122,6,9%
2010-12,הצפון,499,יפיע,612,263,349,10,602,488,611,28,10%
2010-12,הצפון,240,יקנעם עילית,480,177,303,81,399,218,477,66,5%
2010-12,הצפון,502,ירכא,494,191,303,1,493,385,494,31,11%
2010-12,הצפון,504,כאבול,720,305,415,14,706,629,718,16,18%
2010-12,הצפון,505,כאוכב אבו אל-היג'א,197,78,119,6,191,174,197,8,14%
2010-12,הצפון,1296,כסרא-סמיע,205,83,122,3,202,158,205,10,8%
2010-12,הצפון,978,כעביה-טבאש-חג'אג'רה,202,87,115,3,199,150,200,7,11%
2010-12,הצפון,1263,כפר ורדים,66,26,40,24,42,9,66,3,2%
2010-12,הצפון,507,כפר יאסיף,488,209,279,5,483,395,486,19,11%
2010-12,הצפון,508,כפר כמא,65,27,38,3,62,41,64,3,5%
2010-12,הצפון,509,כפר כנא,1148,457,691,20,1128,1004,1139,24,16%
2010-12,הצפון,510,כפר מנדא,919,399,520,5,914,754,913,38,15%
2010-12,הצפון,47,כפר תבור,47,18,29,16,31,6,47,6,3%
2010-12,הצפון,1139,כרמיאל,1777,667,1110,359,1418,961,1719,132,7%
2010-12,הצפון,481,מגאר,1416,550,866,26,1390,1260,1411,30,19%
2010-12,הצפון,516,מג'ד אל-כרום,647,265,382,7,640,529,647,19,12%
2010-12,הצפון,874,מגדל העמק,932,392,540,63,869,479,904,112,7%
2010-12,הצפון,4201,מג'דל שמס,467,176,291,23,444,403,463,10,12%
2010-12,הצפון,517,מזרעה,165,60,105,4,161,132,163,5,10%
2010-12,הצפון,4203,מסעדה,187,72,115,6,181,158,186,1,13%
2010-12,הצפון,518,מעיליא,61,25,36,7,54,33,61,7,4%
2010-12,הצפון,1063,מעלות-תרשיחא,902,409,493,118,784,567,898,53,8%
2010-12,הצפון,520,משהד,312,113,199,3,309,277,308,8,12%
2010-12,הצפון,9100,נהרייה,2041,891,1150,249,1792,1319,2025,130,7%
2010-12,הצפון,522,נחף,463,191,272,12,451,380,462,15,11%
2010-12,הצפון,7300,נצרת,2840,1212,1628,75,2765,2200,2822,111,10%
2010-12,הצפון,1061,נצרת עילית,1738,732,1006,221,1517,1117,1656,184,7%
2010-12,הצפון,525,סאג'ור,113,40,73,2,111,81,111,2,8%
2010-12,הצפון,7500,סח'נין,1991,876,1115,40,1951,1746,1991,44,17%
2010-12,הצפון,4501,ע'ג'ר,91,39,52,2,89,71,91,5,11%
2010-12,הצפון,530,עיילבון,186,75,111,3,183,149,186,6,9%
2010-12,הצפון,511,עילוט,325,129,196,3,322,267,325,11,14%
2010-12,הצפון,532,עין מאהל,579,243,336,10,569,525,572,10,14%
2010-12,הצפון,7600,עכו,3262,1465,1797,127,3135,2590,3246,171,13%
2010-12,הצפון,7700,עפולה,1806,714,1092,207,1599,1005,1746,159,8%
2010-12,הצפון,531,עראבה,1351,559,792,26,1325,1194,1350,32,17%
2010-12,הצפון,535,פסוטה,126,56,70,9,117,96,126,3,9%
2010-12,הצפון,536,פקיעין (בוקייעה),128,60,68,5,123,90,127,6,5%
2010-12,הצפון,8000,צפת,971,492,479,80,891,693,964,35,9%
2010-12,הצפון,4100,קצרין,202,87,115,45,157,109,198,15,5%
2010-12,הצפון,2800,קריית שמונה,734,335,399,57,677,300,718,78,6%
2010-12,הצפון,543,ראמה,305,120,185,7,298,252,303,6,9%
2010-12,הצפון,26,ראש פינה,44,14,30,8,36,19,44,1,3%
2010-12,הצפון,542,ריינה,620,247,373,9,611,513,616,25,11%
2010-12,הצפון,122,רמת ישי,90,37,53,19,71,10,89,9,2%
2010-12,הצפון,913,שבלי - אום אל-גנם,263,111,152,4,259,200,262,5,12%
2010-12,הצפון,812,שלומי,285,124,161,22,263,167,282,18,9%
2010-12,הצפון,538,שעב,496,212,284,2,494,422,495,22,20%
2010-12,הצפון,8800,שפרעם,2016,776,1240,30,1986,1700,2009,48,14%
2010-12,חיפה,2710,אום אל-פחם,3480,1437,2043,10,3470,3041,3476,52,21%
2010-12,חיפה,1020,אור עקיבא,599,260,339,39,560,253,583,74,6%
2010-12,חיפה,6000,באקה אל-גרביה,595,311,284,11,584,379,595,21,NULL
2010-12,חיפה,9800,בנימינה-גבעת עדה*,197,86,111,70,127,46,197,21,3%
2010-12,חיפה,1326,"בסמ""ה",379,173,206,4,375,302,379,17,12%
2010-12,חיפה,541,ג'סר א-זרקא,368,217,151,0,368,256,365,10,7%
2010-12,חיפה,628,ג'ת,185,88,97,8,177,120,184,7,NULL
2010-12,חיפה,494,דאלית אל-כרמל,504,210,294,10,494,306,502,17,7%
2010-12,חיפה,9300,זכרון יעקב,226,84,142,79,147,47,223,21,2%
2010-12,חיפה,6500,חדרה,2317,923,1394,279,2038,982,2274,212,5%
2010-12,חיפה,4000,חיפה,8143,3478,4665,1540,6603,5445,8091,583,6%
2010-12,חיפה,1247,חריש-קציר,33,12,21,4,29,12,33,2,2%
2010-12,חיפה,2100,טירת כרמל,756,333,423,37,719,505,748,62,8%
2010-12,חיפה,654,כפר קרע,366,162,204,12,354,221,364,21,5%
2010-12,חיפה,1327,מעלה עירון,829,314,515,5,824,712,827,14,18%
2010-12,חיפה,2500,נשר,547,240,307,106,441,306,545,45,4%
2010-12,חיפה,534,עספיא,320,141,179,4,316,197,320,14,7%
2010-12,חיפה,637,ערערה,527,209,318,5,522,360,527,31,8%
2010-12,חיפה,537,פוריידיס,391,189,202,2,389,256,390,9,8%
2010-12,חיפה,7800,פרדס חנה-כרכור,822,331,491,127,695,278,811,97,5%
2010-12,חיפה,6800,קריית אתא,1931,762,1169,170,1761,1246,1921,103,7%
2010-12,חיפה,9500,קריית ביאליק,1228,478,750,174,1054,692,1221,82,6%
2010-12,חיפה,2300,קריית טבעון,190,75,115,64,126,50,190,10,3%
2010-12,חיפה,9600,קריית ים,1724,731,993,164,1560,1191,1718,116,9%
2010-12,חיפה,8200,קריית מוצקין,1169,437,732,156,1013,641,1154,82,6%
2010-12,חיפה,922,רכסים,148,66,82,7,141,102,148,8,5%
2010-12,ירושלים,472,אבו גוש,264,123,141,7,257,188,264,9,11%
2010-12,ירושלים,2610,בית שמש,1124,464,660,91,1033,590,1108,118,5%
2010-12,ירושלים,3000,ירושלים,9941,4287,5654,1214,8727,6016,9878,722,4%
2010-12,ירושלים,1015,מבשרת ציון,333,158,175,68,265,138,329,30,3%
2010-12,ירושלים,1137,קריית יערים,34,13,21,7,27,13,34,2,3%
2010-12,תל אביב,2400,אור יהודה,843,346,497,38,805,329,829,94,5%
2010-12,תל אביב,565,אזור,165,79,86,22,143,42,164,14,3%
2010-12,תל אביב,6100,בני ברק,2203,1047,1156,112,2091,1354,2191,161,5%
2010-12,תל אביב,6200,בת ים,3419,1513,1906,514,2905,1594,3350,283,5%
2010-12,תל אביב,6300,גבעתיים,670,303,367,278,392,126,666,44,2%
2010-12,תל אביב,6400,הרצלייה,1073,461,612,312,761,143,1058,144,2%
2010-12,תל אביב,6600,חולון,2916,1305,1611,517,2399,1081,2870,342,3%
2010-12,תל אביב,2620,קריית אונו,427,181,246,166,261,57,426,28,3%
2010-12,תל אביב,8600,רמת גן,2018,892,1126,615,1403,552,1995,161,3%
2010-12,תל אביב,2650,רמת השרון,402,177,225,171,231,35,397,41,2%
2010-12,תל אביב,5000,תל אביב -יפו,7662,3729,3933,2178,5484,2859,7586,540,3%
2011-01,אזור יהודה והשומרון,3760,אורנית,85,41,44,36,49,3,84,9,2%
2011-01,אזור יהודה והשומרון,3750,אלפי מנשה,81,34,47,21,60,4,80,9,2%
2011-01,אזור יהודה והשומרון,3560,אלקנה,35,16,19,17,18,2,35,2,2%
2011-01,אזור יהודה והשומרון,3650,אפרתה,57,33,24,28,29,11,57,10,2%
2011-01,אזור יהודה והשומרון,3570,אריאל,376,176,200,86,290,120,373,44,4%
2011-01,אזור יהודה והשומרון,3574,בית אל,52,22,30,15,37,15,51,4,2%
2011-01,אזור יהודה והשומרון,3652,בית אריה,53,18,35,5,48,6,53,4,3%
2011-01,אזור יהודה והשומרון,3780,ביתר עילית,423,194,229,21,402,213,417,39,5%
2011-01,אזור יהודה והשומרון,3730,גבעת זאב,168,87,81,21,147,48,167,20,3%
2011-01,אזור יהודה והשומרון,3769,הר אדר,26,13,13,11,15,2,26,2,2%
2011-01,אזור יהודה והשומרון,3797,מודיעין עילית,301,118,183,21,280,86,299,11,3%
2011-01,אזור יהודה והשומרון,3616,מעלה אדומים,688,281,407,107,581,233,682,66,4%
2011-01,אזור יהודה והשומרון,3660,עמנואל,80,39,41,5,75,57,80,3,9%
2011-01,אזור יהודה והשומרון,3557,קדומים,24,15,9,10,14,6,24,2,2%
2011-01,אזור יהודה והשומרון,3611,קריית ארבע,102,47,55,18,84,65,102,5,4%
2011-01,אזור יהודה והשומרון,3640,קרני שומרון,75,39,36,22,53,23,74,4,2%
2011-01,הדרום,31,אופקים,1374,583,791,103,1271,997,1360,51,12%
2011-01,הדרום,2600,אילת,1551,699,852,106,1445,688,1536,114,5%
2011-01,הדרום,70,אשדוד,7004,2739,4265,809,6195,4319,6944,456,7%
2011-01,הדרום,7100,אשקלון,4284,1642,2642,649,3635,2772,4189,252,7%
2011-01,הדרום,9000,באר שבע,7460,3176,4284,983,6477,5102,7397,681,8%
2011-01,הדרום,2200,דימונה,2099,940,1159,113,1986,1476,2067,154,12%
2011-01,הדרום,1303,חורה,735,321,414,1,734,684,735,20,24%
2011-01,הדרום,831,ירוחם,424,203,221,21,403,267,418,70,10%
2011-01,הדרום,1059,כסיפה,970,406,564,2,968,894,968,24,26%
2011-01,הדרום,1271,להבים,44,23,21,21,23,4,43,2,1%
2011-01,הדרום,1060,לקיה,925,425,500,3,922,860,922,18,29%
2011-01,הדרום,1268,מיתר,62,25,37,27,35,6,62,4,2%
2011-01,הדרום,99,מצפה רמון,238,89,149,18,220,130,220,50,10%
2011-01,הדרום,246,נתיבות,909,396,513,58,851,530,901,63,8%
2011-01,הדרום,666,עומר,67,28,39,34,33,7,67,3,2%
2011-01,הדרום,2560,ערד,900,373,527,172,728,570,879,114,7%
2011-01,הדרום,1192,ערערה-בנגב,998,396,602,3,995,913,998,38,31%
2011-01,הדרום,2630,קריית גת,2298,909,1389,197,2101,1564,2287,136,9%
2011-01,הדרום,1034,קריית מלאכי,1279,564,715,37,1242,862,1252,125,12%
2011-01,הדרום,1161,רהט,2979,1193,1786,5,2974,2670,2977,144,21%
2011-01,הדרום,1286,שגב-שלום,560,225,335,1,559,508,559,14,27%
2011-01,הדרום,1031,שדרות,1038,424,614,58,980,634,1035,78,9%
2011-01,הדרום,1054,תל שבע,1162,550,612,1,1161,1084,1161,29,30%
2011-01,המרכז,182,אבן יהודה,136,70,66,44,92,15,135,15,2%
2011-01,המרכז,41,אליכין,60,26,34,9,51,22,60,2,4%
2011-01,המרכז,1309,אלעד,385,182,203,26,359,121,384,22,4%
2011-01,המרכז,2530,באר יעקב,250,110,140,46,204,74,248,22,4%
2011-01,המרכז,466,בית דגן,97,46,51,15,82,35,97,7,3%
2011-01,המרכז,1066,"בני עי""ש",181,87,94,27,154,85,178,1,5%
2011-01,המרכז,681,גבעת שמואל,266,129,137,115,151,57,266,17,3%
2011-01,המרכז,2550,גדרה,323,148,175,58,265,108,317,5,3%
2011-01,המרכז,627,ג'לג'וליה,60,28,32,3,57,29,60,4,2%
2011-01,המרכז,166,גן יבנה,302,123,179,34,268,109,300,18,3%
2011-01,המרכז,229,גני תקווה,180,73,107,50,130,27,180,9,3%
2011-01,המרכז,9700,הוד השרון,566,242,324,189,377,60,563,48,2%
2011-01,המרכז,1290,זמר,164,57,107,5,159,135,164,3,7%
2011-01,המרכז,2730,טייבה,2109,890,1219,4,2105,1807,2096,67,14%
2011-01,המרכז,2720,טירה,351,161,190,5,346,213,350,12,4%
2011-01,המרכז,2660,יבנה,928,422,506,74,854,445,925,87,5%
2011-01,המרכז,9400,יהוד,569,232,337,95,474,92,549,43,4%
2011-01,המרכז,1224,כוכב יאיר,88,42,46,48,40,4,88,7,2%
2011-01,המרכז,633,כפר ברא,22,9,13,0,22,9,22,1,2%
2011-01,המרכז,168,כפר יונה,343,146,197,53,290,87,339,35,4%
2011-01,המרכז,6900,כפר סבא,1186,526,660,340,846,223,1176,111,3%
2011-01,המרכז,634,כפר קאסם,212,107,105,1,211,121,211,13,3%
2011-01,המרכז,7000,לוד,2265,964,1301,199,2066,1368,2249,175,7%
2011-01,המרכז,1200,מודיעין-מכבים-רעות*,915,401,514,357,558,72,906,89,2%
2011-01,המרכז,28,מזכרת בתיה,156,59,97,36,120,43,156,3,3%
2011-01,המרכז,7200,נס ציונה,610,262,348,133,477,196,601,13,3%
2011-01,המרכז,7400,נתניה,4618,2061,2557,649,3969,2060,4561,490,5%
2011-01,המרכז,587,סביון*,14,8,6,9,5,0,14,1,1%
2011-01,המרכז,171,פרדסייה,79,39,40,22,57,9,79,13,2%
2011-01,המרכז,7900,פתח תקווה,3921,1727,2194,783,3138,1201,3890,332,4%
2011-01,המרכז,195,קדימה-צורן,234,108,126,61,173,34,234,27,3%
2011-01,המרכז,638,קלנסווה,887,345,542,1,886,752,883,16,12%
2011-01,המרכז,469,קריית עקרון,261,130,131,12,249,123,257,5,5%
2011-01,המרכז,2640,ראש העין,756,359,397,80,676,192,745,94,4%
2011-01,המרכז,8300,ראשון לציון,4410,1894,2516,904,3506,1733,4386,343,3%
2011-01,המרכז,8400,רחובות,2489,1028,1461,527,1962,1050,2455,65,4%
2011-01,המרכז,8500,רמלה,1815,820,995,97,1718,902,1774,197,6%
2011-01,המרכז,8700,רעננה,698,327,371,282,416,84,696,53,2%
2011-01,המרכז,1304,שוהם,166,64,102,65,101,6,165,19,2%
2011-01,המרכז,154,תל מונד,133,61,72,41,92,25,133,10,3%
2011-01,הצפון,473,אבו סנאן,740,292,448,4,736,621,736,20,15%
2011-01,הצפון,478,אכסאל,563,223,340,7,556,513,563,23,12%
2011-01,הצפון,529,אעבלין,638,254,384,10,628,540,638,28,14%
2011-01,הצפון,482,בועיינה-נוג'ידאת,492,214,278,9,483,416,487,11,15%
2011-01,הצפון,4001,בוקעאתא,375,152,223,10,365,315,367,7,16%
2011-01,הצפון,998,ביר אל-מכסור,446,170,276,2,444,355,445,9,15%
2011-01,הצפון,480,בית ג'ן,324,94,230,5,319,244,318,6,8%
2011-01,הצפון,9200,בית שאן,781,338,443,14,767,457,780,97,8%
2011-01,הצפון,944,בסמת טבעון,268,114,154,4,264,215,268,11,10%
2011-01,הצפון,483,בענה,480,192,288,3,477,421,480,10,17%
2011-01,הצפון,1292,ג'דיידה-מכר,1483,612,871,5,1478,1302,1482,25,19%
2011-01,הצפון,485,ג'ולס,234,61,173,4,230,146,234,14,10%
2011-01,הצפון,487,ג'ש (גוש חלב),60,30,30,4,56,33,60,5,4%
2011-01,הצפון,489,דבורייה,453,215,238,23,430,330,452,8,12%
2011-01,הצפון,490,דייר אל-אסד,427,177,250,8,419,351,427,11,10%
2011-01,הצפון,492,דייר חנא,648,282,366,12,636,526,648,19,17%
2011-01,הצפון,975,זרזיר,304,117,187,3,301,220,297,8,12%
2011-01,הצפון,496,חורפיש,148,59,89,6,142,98,148,5,7%
2011-01,הצפון,2034,חצור הגלילית,303,124,179,14,289,149,292,41,7%
2011-01,הצפון,6700,טבריה,1917,835,1082,114,1803,1252,1805,114,9%
2011-01,הצפון,962,טובא-זנגרייה,346,163,183,5,341,258,343,10,13%
2011-01,הצפון,498,טורעאן,545,214,331,10,535,467,543,19,12%
2011-01,הצפון,8900,טמרה,2023,820,1203,23,2000,1798,2019,54,17%
2011-01,הצפון,1295,יאנוח-ג'ת,184,61,123,3,181,130,184,8,9%
2011-01,הצפון,46,יבנאל,121,63,58,7,114,94,113,1,9%
2011-01,הצפון,499,יפיע,637,268,369,10,627,513,635,25,10%
2011-01,הצפון,240,יקנעם עילית,498,187,311,83,415,219,496,52,5%
2011-01,הצפון,502,ירכא,507,215,292,1,506,390,507,16,11%
2011-01,הצפון,504,כאבול,710,294,416,13,697,625,708,23,17%
2011-01,הצפון,505,כאוכב אבו אל-היג'א,211,86,125,6,205,181,211,7,15%
2011-01,הצפון,1296,כסרא-סמיע,245,95,150,2,243,196,244,11,9%
2011-01,הצפון,978,כעביה-טבאש-חג'אג'רה,199,81,118,4,195,147,198,3,11%
2011-01,הצפון,1263,כפר ורדים,68,29,39,26,42,11,68,4,2%
2011-01,הצפון,507,כפר יאסיף,508,213,295,5,503,403,507,16,12%
2011-01,הצפון,508,כפר כמא,73,24,49,5,68,42,71,4,5%
2011-01,הצפון,509,כפר כנא,1144,456,688,18,1126,998,1137,29,16%
2011-01,הצפון,510,כפר מנדא,932,408,524,9,923,762,923,46,16%
2011-01,הצפון,47,כפר תבור,47,17,30,16,31,5,47,4,3%
2011-01,הצפון,1139,כרמיאל,1824,703,1121,364,1460,987,1764,132,7%
2011-01,הצפון,481,מגאר,1442,562,880,24,1418,1284,1438,47,20%
2011-01,הצפון,516,מג'ד אל-כרום,661,276,385,10,651,528,660,22,13%
2011-01,הצפון,874,מגדל העמק,976,422,554,78,898,480,937,118,8%
2011-01,הצפון,4201,מג'דל שמס,477,179,298,23,454,405,472,17,12%
2011-01,הצפון,517,מזרעה,170,62,108,4,166,133,169,5,11%
2011-01,הצפון,4203,מסעדה,197,77,120,6,191,163,196,2,14%
2011-01,הצפון,518,מעיליא,58,25,33,7,51,30,58,1,4%
2011-01,הצפון,1063,מעלות-תרשיחא,1003,448,555,124,879,628,999,63,9%
2011-01,הצפון,520,משהד,316,115,201,3,313,277,311,10,12%
2011-01,הצפון,9100,נהרייה,2066,914,1152,244,1822,1322,2053,121,7%
2011-01,הצפון,522,נחף,462,191,271,12,450,386,461,15,11%
2011-01,הצפון,7300,נצרת,2945,1263,1682,76,2869,2284,2931,99,10%
2011-01,הצפון,1061,נצרת עילית,1930,816,1114,249,1681,1164,1843,201,8%
2011-01,הצפון,525,סאג'ור,118,44,74,2,116,82,115,1,8%
2011-01,הצפון,7500,סח'נין,2033,909,1124,35,1998,1766,2033,51,18%
2011-01,הצפון,4501,ע'ג'ר,98,41,57,3,95,70,97,4,11%
2011-01,הצפון,530,עיילבון,189,77,112,4,185,145,189,3,9%
2011-01,הצפון,511,עילוט,328,133,195,3,325,269,328,13,14%
2011-01,הצפון,532,עין מאהל,613,269,344,14,599,544,606,33,14%
2011-01,הצפון,7600,עכו,3328,1499,1829,147,3181,2611,3305,184,14%
2011-01,הצפון,7700,עפולה,1834,734,1100,210,1624,983,1759,168,8%
2011-01,הצפון,531,עראבה,1366,574,792,26,1340,1193,1364,30,17%
2011-01,הצפון,535,פסוטה,128,52,76,7,121,99,128,3,9%
2011-01,הצפון,536,פקיעין (בוקייעה),133,69,64,2,131,94,132,7,6%
2011-01,הצפון,8000,צפת,989,503,486,85,904,688,982,43,9%
2011-01,הצפון,4100,קצרין,207,92,115,44,163,108,204,13,6%
2011-01,הצפון,2800,קריית שמונה,798,376,422,53,745,316,770,101,6%
2011-01,הצפון,543,ראמה,312,123,189,8,304,246,310,7,10%
2011-01,הצפון,26,ראש פינה,51,16,35,8,43,22,51,4,4%
2011-01,הצפון,542,ריינה,623,246,377,9,614,508,619,26,11%
2011-01,הצפון,122,רמת ישי,90,39,51,22,68,11,89,4,2%
2011-01,הצפון,913,שבלי - אום אל-גנם,276,123,153,5,271,206,274,7,13%
2011-01,הצפון,812,שלומי,272,120,152,20,252,164,269,23,8%
2011-01,הצפון,538,שעב,491,208,283,2,489,419,490,14,19%
2011-01,הצפון,8800,שפרעם,2025,793,1232,28,1997,1693,2018,95,14%
2011-01,חיפה,2710,אום אל-פחם,3501,1440,2061,8,3493,3047,3497,73,21%
2011-01,חיפה,1020,אור עקיבא,590,243,347,37,553,239,571,63,6%
2011-01,חיפה,6000,באקה אל-גרביה,628,328,300,12,616,392,628,44,NULL
2011-01,חיפה,9800,בנימינה-גבעת עדה*,181,77,104,61,120,47,181,13,3%
2011-01,חיפה,1326,"בסמ""ה",385,174,211,3,382,308,385,14,12%
2011-01,חיפה,541,ג'סר א-זרקא,379,226,153,0,379,262,377,19,8%
2011-01,חיפה,628,ג'ת,186,91,95,5,181,121,185,11,NULL
2011-01,חיפה,494,דאלית אל-כרמל,508,213,295,10,498,307,505,19,7%
2011-01,חיפה,9300,זכרון יעקב,235,91,144,74,161,46,232,21,3%
2011-01,חיפה,6500,חדרה,2301,937,1364,269,2032,960,2271,241,5%
2011-01,חיפה,4000,חיפה,8130,3532,4598,1573,6557,5339,8072,514,6%
2011-01,חיפה,1247,חריש-קציר,30,11,19,2,28,11,29,1,2%
2011-01,חיפה,2100,טירת כרמל,750,336,414,40,710,498,741,48,8%
2011-01,חיפה,654,כפר קרע,372,156,216,11,361,225,370,24,5%
2011-01,חיפה,1327,מעלה עירון,853,339,514,5,848,719,851,14,18%
2011-01,חיפה,2500,נשר,552,247,305,106,446,307,550,33,5%
2011-01,חיפה,534,עספיא,346,156,190,6,340,206,344,19,7%
2011-01,חיפה,637,ערערה,552,216,336,5,547,373,552,47,8%
2011-01,חיפה,537,פוריידיס,388,195,193,3,385,258,387,19,8%
2011-01,חיפה,7800,פרדס חנה-כרכור,862,377,485,131,731,278,851,104,5%
2011-01,חיפה,6800,קריית אתא,2009,794,1215,175,1834,1261,1998,108,7%
2011-01,חיפה,9500,קריית ביאליק,1233,486,747,172,1061,693,1224,92,6%
2011-01,חיפה,2300,קריית טבעון,192,82,110,64,128,48,192,15,3%
2011-01,חיפה,9600,קריית ים,1787,751,1036,170,1617,1210,1781,105,9%
2011-01,חיפה,8200,קריית מוצקין,1191,452,739,166,1025,643,1180,93,6%
2011-01,חיפה,922,רכסים,149,69,80,8,141,102,148,10,5%
2011-01,ירושלים,472,אבו גוש,259,123,136,7,252,188,259,10,11%
2011-01,ירושלים,2610,בית שמש,1098,475,623,87,1011,571,1090,121,4%
2011-01,ירושלים,3000,ירושלים,10082,4424,5658,1227,8855,6048,10018,710,4%
2011-01,ירושלים,1015,מבשרת ציון,346,164,182,67,279,143,341,37,3%
2011-01,ירושלים,1137,קריית יערים,34,16,18,6,28,12,34,6,3%
2011-01,תל אביב,2400,אור יהודה,840,365,475,42,798,313,825,79,5%
2011-01,תל אביב,565,אזור,175,86,89,22,153,41,173,16,3%
2011-01,תל אביב,6100,בני ברק,2226,1071,1155,112,2114,1344,2207,108,5%
2011-01,תל אביב,6200,בת ים,3574,1555,2019,536,3038,1615,3495,309,5%
2011-01,תל אביב,6300,גבעתיים,705,321,384,289,416,124,702,73,3%
2011-01,תל אביב,6400,הרצלייה,1071,483,588,305,766,134,1051,151,2%
2011-01,תל אביב,6600,חולון,2933,1321,1612,507,2426,1036,2884,303,3%
2011-01,תל אביב,2620,קריית אונו,396,167,229,159,237,53,394,28,2%
2011-01,תל אביב,8600,רמת גן,2075,949,1126,623,1452,545,2062,198,3%
2011-01,תל אביב,2650,רמת השרון,438,190,248,180,258,37,434,38,2%
2011-01,תל אביב,5000,תל אביב -יפו,7879,3898,3981,2234,5645,2898,7813,728,3%
2011-02,אזור יהודה והשומרון,3760,אורנית,82,39,43,36,46,3,81,6,2%
2011-02,אזור יהודה והשומרון,3750,אלפי מנשה,85,35,50,22,63,6,85,6,2%
2011-02,אזור יהודה והשומרון,3560,אלקנה,34,15,19,20,14,2,33,2,2%
2011-02,אזור יהודה והשומרון,3650,אפרתה,50,26,24,22,28,13,50,7,1%
2011-02,אזור יהודה והשומרון,3570,אריאל,361,169,192,83,278,112,360,46,4%
2011-02,אזור יהודה והשומרון,3574,בית אל,48,23,25,13,35,14,48,4,2%
2011-02,אזור יהודה והשומרון,3652,בית אריה,56,18,38,7,49,6,55,2,3%
2011-02,אזור יהודה והשומרון,3780,ביתר עילית,389,196,193,19,370,208,383,31,5%
2011-02,אזור יהודה והשומרון,3730,גבעת זאב,160,84,76,18,142,47,160,16,3%
2011-02,אזור יהודה והשומרון,3769,הר אדר,30,13,17,13,17,2,30,1,2%
2011-02,אזור יהודה והשומרון,3797,מודיעין עילית,309,110,199,20,289,90,306,20,3%
2011-02,אזור יהודה והשומרון,3616,מעלה אדומים,626,255,371,107,519,226,622,62,4%
2011-02,אזור יהודה והשומרון,3660,עמנואל,76,37,39,4,72,54,76,6,8%
2011-02,אזור יהודה והשומרון,3557,קדומים,22,12,10,6,16,6,22,6,1%
2011-02,אזור יהודה והשומרון,3611,קריית ארבע,106,50,56,16,90,64,106,6,4%
2011-02,אזור יהודה והשומרון,3640,קרני שומרון,70,35,35,20,50,23,70,6,2%
2011-02,הדרום,31,אופקים,1304,557,747,101,1203,969,1292,58,12%
2011-02,הדרום,2600,אילת,1490,692,798,105,1385,662,1480,97,5%
2011-02,הדרום,70,אשדוד,6915,2736,4179,797,6118,4210,6863,393,7%
2011-02,הדרום,7100,אשקלון,4185,1620,2565,662,3523,2742,4091,250,7%
2011-02,הדרום,9000,באר שבע,7207,3084,4123,931,6276,4876,7153,562,8%
2011-02,הדרום,2200,דימונה,2050,936,1114,118,1932,1464,2025,145,12%
2011-02,הדרום,1303,חורה,724,313,411,1,723,669,724,12,24%
2011-02,הדרום,831,ירוחם,428,206,222,24,404,271,420,68,10%
2011-02,הדרום,1059,כסיפה,974,409,565,2,972,895,972,17,26%
2011-02,הדרום,1271,להבים,42,22,20,22,20,3,42,6,1%
2011-02,הדרום,1060,לקיה,917,417,500,3,914,857,916,17,29%
2011-02,הדרום,1268,מיתר,64,24,40,27,37,6,64,5,2%
2011-02,הדרום,99,מצפה רמון,238,91,147,18,220,127,221,34,10%
2011-02,הדרום,246,נתיבות,978,411,567,55,923,542,966,117,8%
2011-02,הדרום,666,עומר,70,29,41,40,30,7,70,4,2%
2011-02,הדרום,2560,ערד,881,388,493,175,706,558,859,100,7%
2011-02,הדרום,1192,ערערה-בנגב,960,394,566,2,958,873,960,13,30%
2011-02,הדרום,2630,קריית גת,2258,907,1351,194,2064,1546,2248,107,9%
2011-02,הדרום,1034,קריית מלאכי,1282,582,700,37,1245,844,1254,126,12%
2011-02,הדרום,1161,רהט,2894,1139,1755,7,2887,2614,2893,80,21%
2011-02,הדרום,1286,שגב-שלום,545,222,323,1,544,496,544,6,26%
2011-02,הדרום,1031,שדרות,1038,431,607,53,985,643,1034,63,9%
2011-02,הדרום,1054,תל שבע,1148,536,612,1,1147,1078,1147,15,30%
2011-02,המרכז,182,אבן יהודה,132,62,70,46,86,15,131,19,2%
2011-02,המרכז,41,אליכין,51,23,28,2,49,20,50,5,3%
2011-02,המרכז,1309,אלעד,353,155,198,21,332,114,351,17,3%
2011-02,המרכז,2530,באר יעקב,259,118,141,49,210,78,258,16,4%
2011-02,המרכז,466,בית דגן,99,52,47,12,87,35,99,10,3%
2011-02,המרכז,1066,"בני עי""ש",190,90,100,26,164,88,187,2,5%
2011-02,המרכז,681,גבעת שמואל,269,133,136,117,152,55,266,13,3%
2011-02,המרכז,2550,גדרה,340,156,184,54,286,112,337,2,3%
2011-02,המרכז,627,ג'לג'וליה,60,28,32,5,55,33,60,1,2%
2011-02,המרכז,166,גן יבנה,304,124,180,34,270,100,303,22,3%
2011-02,המרכז,229,גני תקווה,165,68,97,46,119,25,165,13,2%
2011-02,המרכז,9700,הוד השרון,538,244,294,175,363,58,534,36,2%
2011-02,המרכז,1290,זמר,170,59,111,10,160,134,170,12,7%
2011-02,המרכז,2730,טייבה,2065,853,1212,3,2062,1787,2052,43,14%
2011-02,המרכז,2720,טירה,325,149,176,7,318,210,323,22,4%
2011-02,המרכז,2660,יבנה,883,410,473,70,813,434,881,72,5%
2011-02,המרכז,9400,יהוד,565,234,331,109,456,82,545,31,4%
2011-02,המרכז,1224,כוכב יאיר,78,44,34,39,39,5,78,4,1%
2011-02,המרכז,633,כפר ברא,34,19,15,0,34,9,34,1,3%
2011-02,המרכז,168,כפר יונה,343,142,201,57,286,81,339,32,4%
2011-02,המרכז,6900,כפר סבא,1123,503,620,321,802,209,1114,97,2%
2011-02,המרכז,634,כפר קאסם,209,100,109,1,208,124,208,8,3%
2011-02,המרכז,7000,לוד,2134,945,1189,196,1938,1255,2119,149,6%
2011-02,המרכז,1200,מודיעין-מכבים-רעות*,912,399,513,369,543,74,897,85,2%
2011-02,המרכז,28,מזכרת בתיה,148,63,85,34,114,39,148,1,3%
2011-02,המרכז,7200,נס ציונה,616,265,351,126,490,192,609,5,3%
2011-02,המרכז,7400,נתניה,4495,2083,2412,626,3869,1950,4443,439,5%
2011-02,המרכז,587,סביון*,16,7,9,7,9,1,16,0,1%
2011-02,המרכז,171,פרדסייה,71,31,40,16,55,8,71,4,2%
2011-02,המרכז,7900,פתח תקווה,3909,1703,2206,803,3106,1209,3875,351,4%
2011-02,המרכז,195,קדימה-צורן,227,103,124,65,162,36,226,17,3%
2011-02,המרכז,638,קלנסווה,895,350,545,2,893,759,891,21,13%
2011-02,המרכז,469,קריית עקרון,271,133,138,14,257,115,268,3,5%
2011-02,המרכז,2640,ראש העין,684,330,354,68,616,187,674,80,3%
2011-02,המרכז,8300,ראשון לציון,4363,1851,2512,904,3459,1724,4338,325,3%
2011-02,המרכז,8400,רחובות,2501,1073,1428,531,1970,1046,2472,20,4%
2011-02,המרכז,8500,רמלה,1774,829,945,91,1683,863,1744,157,5%
2011-02,המרכז,8700,רעננה,713,320,393,285,428,85,711,52,2%
2011-02,המרכז,1304,שוהם,169,67,102,66,103,8,167,17,2%
2011-02,המרכז,154,תל מונד,128,58,70,43,85,22,128,8,2%
2011-02,הצפון,473,אבו סנאן,715,280,435,4,711,617,711,16,15%
2011-02,הצפון,478,אכסאל,544,217,327,8,536,491,543,14,12%
2011-02,הצפון,529,אעבלין,640,258,382,11,629,541,639,21,14%
2011-02,הצפון,482,בועיינה-נוג'ידאת,498,212,286,7,491,411,493,2,16%
2011-02,הצפון,4001,בוקעאתא,376,148,228,9,367,317,369,1,16%
2011-02,הצפון,998,ביר אל-מכסור,431,165,266,2,429,345,430,13,14%
2011-02,הצפון,480,בית ג'ן,335,99,236,3,332,254,330,3,8%
2011-02,הצפון,9200,בית שאן,777,331,446,17,760,455,777,100,8%
2011-02,הצפון,944,בסמת טבעון,262,112,150,4,258,205,262,20,10%
2011-02,הצפון,483,בענה,467,193,274,4,463,408,467,8,17%
2011-02,הצפון,1292,ג'דיידה-מכר,1468,605,863,6,1462,1283,1468,24,19%
2011-02,הצפון,485,ג'ולס,213,60,153,2,211,152,213,14,9%
2011-02,הצפון,487,ג'ש (גוש חלב),53,28,25,3,50,31,53,2,4%
2011-02,הצפון,489,דבורייה,462,215,247,22,440,338,461,7,13%
2011-02,הצפון,490,דייר אל-אסד,417,172,245,7,410,343,417,11,10%
2011-02,הצפון,492,דייר חנא,669,298,371,10,659,523,669,18,17%
2011-02,הצפון,975,זרזיר,304,126,178,3,301,218,299,8,12%
2011-02,הצפון,496,חורפיש,139,51,88,6,133,96,138,5,7%
2011-02,הצפון,2034,חצור הגלילית,275,111,164,12,263,140,266,32,6%
2011-02,הצפון,6700,טבריה,1880,833,1047,111,1769,1218,1773,140,9%
2011-02,הצפון,962,טובא-זנגרייה,350,163,187,5,345,254,346,12,13%
2011-02,הצפון,498,טורעאן,522,199,323,8,514,448,519,19,11%
2011-02,הצפון,8900,טמרה,2002,819,1183,22,1980,1796,1995,61,17%
2011-02,הצפון,1295,יאנוח-ג'ת,181,62,119,3,178,128,181,5,8%
2011-02,הצפון,46,יבנאל,116,62,54,6,110,91,108,2,8%
2011-02,הצפון,499,יפיע,612,259,353,7,605,494,609,21,10%
2011-02,הצפון,240,יקנעם עילית,478,181,297,79,399,204,476,53,5%
2011-02,הצפון,502,ירכא,507,212,295,1,506,402,507,22,11%
2011-02,הצפון,504,כאבול,705,302,403,8,697,621,702,21,17%
2011-02,הצפון,505,כאוכב אבו אל-היג'א,205,85,120,6,199,175,205,6,15%
2011-02,הצפון,1296,כסרא-סמיע,239,99,140,3,236,187,239,9,9%
2011-02,הצפון,978,כעביה-טבאש-חג'אג'רה,202,83,119,5,197,149,201,5,11%
2011-02,הצפון,1263,כפר ורדים,68,29,39,28,40,13,68,5,2%
2011-02,הצפון,507,כפר יאסיף,513,217,296,5,508,400,512,18,12%
2011-02,הצפון,508,כפר כמא,74,22,52,4,70,44,72,2,5%
2011-02,הצפון,509,כפר כנא,1119,444,675,21,1098,972,1111,26,15%
2011-02,הצפון,510,כפר מנדא,961,427,534,12,949,767,952,53,16%
2011-02,הצפון,47,כפר תבור,43,14,29,18,25,3,43,1,3%
2011-02,הצפון,1139,כרמיאל,1747,675,1072,359,1388,938,1690,124,7%
2011-02,הצפון,481,מגאר,1434,556,878,21,1413,1280,1429,40,19%
2011-02,הצפון,516,מג'ד אל-כרום,644,278,366,10,634,514,644,21,12%
2011-02,הצפון,874,מגדל העמק,936,402,534,71,865,472,898,125,7%
2011-02,הצפון,4201,מג'דל שמס,472,180,292,24,448,402,468,12,12%
2011-02,הצפון,517,מזרעה,177,69,108,5,172,142,176,8,11%
2011-02,הצפון,4203,מסעדה,195,79,116,6,189,159,194,6,13%
2011-02,הצפון,518,מעיליא,62,28,34,6,56,32,62,6,4%
2011-02,הצפון,1063,מעלות-תרשיחא,938,414,524,115,823,583,937,59,8%
2011-02,הצפון,520,משהד,323,119,204,3,320,280,320,7,12%
2011-02,הצפון,9100,נהרייה,2066,906,1160,234,1832,1331,2056,118,7%
2011-02,הצפון,522,נחף,442,186,256,10,432,364,441,11,11%
2011-02,הצפון,7300,נצרת,2935,1276,1659,67,2868,2282,2923,93,10%
2011-02,הצפון,1061,נצרת עילית,1916,854,1062,250,1666,1127,1822,172,8%
2011-02,הצפון,525,סאג'ור,130,50,80,2,128,91,128,3,9%
2011-02,הצפון,7500,סח'נין,2029,911,1118,31,1998,1736,2029,39,18%
2011-02,הצפון,4501,ע'ג'ר,106,46,60,4,102,75,105,7,12%
2011-02,הצפון,530,עיילבון,189,80,109,6,183,143,189,5,9%
2011-02,הצפון,511,עילוט,316,124,192,2,314,259,316,9,14%
2011-02,הצפון,532,עין מאהל,584,253,331,14,570,507,577,15,14%
2011-02,הצפון,7600,עכו,3249,1475,1774,138,3111,2572,3231,142,13%
2011-02,הצפון,7700,עפולה,1789,745,1044,207,1582,954,1722,170,8%
2011-02,הצפון,531,עראבה,1362,572,790,30,1332,1186,1360,31,17%
2011-02,הצפון,535,פסוטה,134,59,75,8,126,95,134,2,9%
2011-02,הצפון,536,פקיעין (בוקייעה),128,60,68,2,126,95,127,8,5%
2011-02,הצפון,8000,צפת,989,511,478,78,911,699,981,50,9%
2011-02,הצפון,4100,קצרין,208,91,117,44,164,103,205,17,6%
2011-02,הצפון,2800,קריית שמונה,801,363,438,63,738,310,777,74,6%
2011-02,הצפון,543,ראמה,312,124,188,6,306,248,311,9,10%
2011-02,הצפון,26,ראש פינה,53,17,36,7,46,22,53,3,4%
2011-02,הצפון,542,ריינה,603,237,366,10,593,502,598,23,11%
2011-02,הצפון,122,רמת ישי,92,32,60,27,65,12,91,2,3%
2011-02,הצפון,913,שבלי - אום אל-גנם,273,126,147,7,266,197,272,8,13%
2011-02,הצפון,812,שלומי,261,109,152,16,245,164,259,14,8%
2011-02,הצפון,538,שעב,486,205,281,3,483,418,485,9,19%
2011-02,הצפון,8800,שפרעם,2010,802,1208,28,1982,1689,2003,68,14%
2011-02,חיפה,2710,אום אל-פחם,3511,1442,2069,8,3503,3066,3507,58,21%
2011-02,חיפה,1020,אור עקיבא,583,238,345,41,542,234,570,83,6%
2011-02,חיפה,6000,באקה אל-גרביה,633,331,302,12,621,394,633,36,NULL
2011-02,חיפה,9800,בנימינה-גבעת עדה*,184,85,99,62,122,49,184,14,3%
2011-02,חיפה,1326,"בסמ""ה",383,167,216,2,381,311,383,12,12%
2011-02,חיפה,541,ג'סר א-זרקא,373,216,157,0,373,263,370,11,7%
2011-02,חיפה,628,ג'ת,190,90,100,8,182,126,189,9,NULL
2011-02,חיפה,494,דאלית אל-כרמל,496,201,295,9,487,305,493,28,7%
2011-02,חיפה,9300,זכרון יעקב,234,91,143,74,160,48,231,17,3%
2011-02,חיפה,6500,חדרה,2265,941,1324,261,2004,932,2227,231,5%
2011-02,חיפה,4000,חיפה,8029,3488,4541,1573,6456,5248,7973,504,6%
2011-02,חיפה,1247,חריש-קציר,24,7,17,2,22,8,24,4,1%
2011-02,חיפה,2100,טירת כרמל,747,337,410,40,707,495,736,61,8%
2011-02,חיפה,654,כפר קרע,364,161,203,10,354,220,362,21,5%
2011-02,חיפה,1327,מעלה עירון,851,345,506,3,848,716,850,20,18%
2011-02,חיפה,2500,נשר,567,260,307,104,463,305,564,36,5%
2011-02,חיפה,534,עספיא,337,156,181,6,331,203,335,13,7%
2011-02,חיפה,637,ערערה,531,205,326,7,524,364,530,22,8%
2011-02,חיפה,537,פוריידיס,398,204,194,4,394,266,396,18,8%
2011-02,חיפה,7800,פרדס חנה-כרכור,859,369,490,127,732,272,848,110,5%
2011-02,חיפה,6800,קריית אתא,1949,775,1174,167,1782,1223,1943,113,7%
2011-02,חיפה,9500,קריית ביאליק,1215,493,722,164,1051,688,1210,86,6%
2011-02,חיפה,2300,קריית טבעון,192,80,112,65,127,50,192,8,3%
2011-02,חיפה,9600,קריית ים,1779,758,1021,174,1605,1205,1773,99,9%
2011-02,חיפה,8200,קריית מוצקין,1220,473,747,170,1050,671,1211,77,6%
2011-02,חיפה,922,רכסים,138,67,71,7,131,100,138,5,5%
2011-02,ירושלים,472,אבו גוש,260,116,144,8,252,191,260,13,11%
2011-02,ירושלים,2610,בית שמש,1043,457,586,88,955,548,1033,120,4%
2011-02,ירושלים,3000,ירושלים,9877,4315,5562,1197,8680,5976,9825,694,4%
2011-02,ירושלים,1015,מבשרת ציון,351,164,187,61,290,166,350,28,3%
2011-02,ירושלים,1137,קריית יערים,30,15,15,5,25,12,29,3,3%
2011-02,תל אביב,2400,אור יהודה,817,354,463,39,778,301,809,93,5%
2011-02,תל אביב,565,אזור,168,85,83,20,148,42,167,15,3%
2011-02,תל אביב,6100,בני ברק,2190,1076,1114,113,2077,1364,2172,138,5%
2011-02,תל אביב,6200,בת ים,3494,1561,1933,490,3004,1549,3421,293,5%
2011-02,תל אביב,6300,גבעתיים,677,313,364,270,407,116,676,56,2%
2011-02,תל אביב,6400,הרצלייה,1004,457,547,293,711,126,990,148,2%
2011-02,תל אביב,6600,חולון,2931,1317,1614,519,2412,1044,2873,329,3%
2011-02,תל אביב,2620,קריית אונו,391,164,227,156,235,50,389,12,2%
2011-02,תל אביב,8600,רמת גן,2026,909,1117,617,1409,533,2012,196,3%
2011-02,תל אביב,2650,רמת השרון,406,170,236,164,242,26,405,46,2%
2011-02,תל אביב,5000,תל אביב -יפו,7575,3759,3816,2138,5437,2817,7507,699,3%
2011-03,אזור יהודה והשומרון,3760,אורנית,86,41,45,31,55,3,86,2,2%
2011-03,אזור יהודה והשומרון,3750,אלפי מנשה,98,41,57,24,74,3,98,5,2%
2011-03,אזור יהודה והשומרון,3560,אלקנה,39,18,21,22,17,2,39,1,2%
2011-03,אזור יהודה והשומרון,3650,אפרתה,42,21,21,21,21,10,42,2,1%
2011-03,אזור יהודה והשומרון,3570,אריאל,351,158,193,84,267,109,350,40,4%
2011-03,אזור יהודה והשומרון,3574,בית אל,47,22,25,11,36,15,47,5,2%
2011-03,אזור יהודה והשומרון,3652,בית אריה,52,20,32,5,47,5,52,7,2%
2011-03,אזור יהודה והשומרון,3780,ביתר עילית,380,193,187,17,363,214,375,24,4%
2011-03,אזור יהודה והשומרון,3730,גבעת זאב,168,87,81,17,151,49,168,14,3%
2011-03,אזור יהודה והשומרון,3769,הר אדר,29,14,15,13,16,1,29,2,2%
2011-03,אזור יהודה והשומרון,3797,מודיעין עילית,297,117,180,18,279,94,295,12,3%
2011-03,אזור יהודה והשומרון,3616,מעלה אדומים,595,237,358,94,501,210,594,57,3%
2011-03,אזור יהודה והשומרון,3660,עמנואל,74,38,36,4,70,52,74,0,8%
2011-03,אזור יהודה והשומרון,3557,קדומים,23,12,11,6,17,6,23,0,1%
2011-03,אזור יהודה והשומרון,3611,קריית ארבע,110,55,55,19,91,64,110,11,4%
2011-03,אזור יהודה והשומרון,3640,קרני שומרון,76,41,35,20,56,20,76,3,2%
2011-03,הדרום,31,אופקים,1316,560,756,100,1216,975,1303,70,12%
2011-03,הדרום,2600,אילת,1501,692,809,93,1408,668,1483,135,5%
2011-03,הדרום,70,אשדוד,6746,2669,4077,790,5956,4107,6680,381,7%
2011-03,הדרום,7100,אשקלון,4200,1625,2575,644,3556,2699,4113,286,7%
2011-03,הדרום,9000,באר שבע,7234,3044,4190,939,6295,4933,7180,610,8%
2011-03,הדרום,2200,דימונה,2079,958,1121,127,1952,1478,2038,146,12%
2011-03,הדרום,1303,חורה,713,306,407,1,712,665,713,9,24%
2011-03,הדרום,831,ירוחם,433,212,221,28,405,274,425,60,10%
2011-03,הדרום,1059,כסיפה,980,406,574,2,978,907,979,22,26%
2011-03,הדרום,1271,להבים,39,19,20,20,19,4,39,5,1%
2011-03,הדרום,1060,לקיה,914,409,505,3,911,856,913,17,28%
2011-03,הדרום,1268,מיתר,62,25,37,27,35,4,61,7,2%
2011-03,הדרום,99,מצפה רמון,239,88,151,18,221,128,220,38,10%
2011-03,הדרום,246,נתיבות,996,412,584,56,940,528,988,214,8%
2011-03,הדרום,666,עומר,67,29,38,36,31,9,67,5,2%
2011-03,הדרום,2560,ערד,875,402,473,174,701,552,847,92,7%
2011-03,הדרום,1192,ערערה-בנגב,989,394,595,3,986,908,987,13,31%
2011-03,הדרום,2630,קריית גת,2266,916,1350,192,2074,1529,2260,153,9%
2011-03,הדרום,1034,קריית מלאכי,1268,575,693,34,1234,836,1241,105,12%
2011-03,הדרום,1161,רהט,2909,1136,1773,8,2901,2604,2908,69,21%
2011-03,הדרום,1286,שגב-שלום,563,232,331,1,562,505,562,14,27%
2011-03,הדרום,1031,שדרות,1048,443,605,59,989,643,1045,75,9%
2011-03,הדרום,1054,תל שבע,1173,549,624,2,1171,1096,1171,26,30%
2011-03,המרכז,182,אבן יהודה,119,55,64,40,79,15,119,10,2%
2011-03,המרכז,41,אליכין,50,27,23,4,46,20,49,7,3%
2011-03,המרכז,1309,אלעד,345,155,190,19,326,114,342,14,3%
2011-03,המרכז,2530,באר יעקב,253,119,134,49,204,80,252,18,4%
2011-03,המרכז,466,בית דגן,90,42,48,14,76,32,89,5,3%
2011-03,המרכז,1066,"בני עי""ש",200,96,104,27,173,90,199,2,5%
2011-03,המרכז,681,גבעת שמואל,270,140,130,109,161,50,270,13,3%
2011-03,המרכז,2550,גדרה,351,157,194,58,293,111,345,4,3%
2011-03,המרכז,627,ג'לג'וליה,62,28,34,4,58,36,62,5,2%
2011-03,המרכז,166,גן יבנה,310,129,181,36,274,100,310,12,3%
2011-03,המרכז,229,גני תקווה,159,67,92,42,117,28,159,10,2%
2011-03,המרכז,9700,הוד השרון,577,261,316,199,378,61,571,26,2%
2011-03,המרכז,1290,זמר,169,59,110,8,161,131,169,10,7%
2011-03,המרכז,2730,טייבה,2109,860,1249,6,2103,1813,2094,48,14%
2011-03,המרכז,2720,טירה,322,148,174,7,315,198,320,15,4%
2011-03,המרכז,2660,יבנה,899,429,470,79,820,441,896,86,5%
2011-03,המרכז,9400,יהוד,558,246,312,96,462,82,541,38,4%
2011-03,המרכז,1224,כוכב יאיר,85,45,40,40,45,5,85,4,2%
2011-03,המרכז,633,כפר ברא,26,15,11,0,26,7,26,2,3%
2011-03,המרכז,168,כפר יונה,320,143,177,45,275,73,318,35,3%
2011-03,המרכז,6900,כפר סבא,1104,508,596,307,797,213,1097,77,2%
2011-03,המרכז,634,כפר קאסם,208,92,116,0,208,126,207,10,3%
2011-03,המרכז,7000,לוד,2184,974,1210,200,1984,1282,2171,179,7%
2011-03,המרכז,1200,מודיעין-מכבים-רעות*,894,381,513,365,529,71,883,91,2%
2011-03,המרכז,28,מזכרת בתיה,141,55,86,33,108,40,141,2,3%
2011-03,המרכז,7200,נס ציונה,640,266,374,128,512,206,632,4,3%
2011-03,המרכז,7400,נתניה,4463,2087,2376,608,3855,1918,4417,489,5%
2011-03,המרכז,587,סביון*,15,4,11,10,5,1,15,0,1%
2011-03,המרכז,171,פרדסייה,81,35,46,16,65,8,80,8,2%
2011-03,המרכז,7900,פתח תקווה,3913,1710,2203,813,3100,1211,3871,329,4%
2011-03,המרכז,195,קדימה-צורן,232,109,123,70,162,35,232,25,3%
2011-03,המרכז,638,קלנסווה,898,352,546,3,895,760,893,14,13%
2011-03,המרכז,469,קריית עקרון,269,133,136,14,255,116,268,2,5%
2011-03,המרכז,2640,ראש העין,637,303,334,66,571,181,631,78,3%
2011-03,המרכז,8300,ראשון לציון,4425,1905,2520,922,3503,1724,4406,331,4%
2011-03,המרכז,8400,רחובות,2523,1086,1437,551,1972,1043,2484,18,4%
2011-03,המרכז,8500,רמלה,1796,844,952,88,1708,862,1772,161,6%
2011-03,המרכז,8700,רעננה,698,319,379,276,422,92,694,42,2%
2011-03,המרכז,1304,שוהם,168,72,96,69,99,9,167,21,2%
2011-03,המרכז,154,תל מונד,124,53,71,36,88,24,124,13,2%
2011-03,הצפון,473,אבו סנאן,723,281,442,4,719,618,719,18,15%
2011-03,הצפון,478,אכסאל,551,222,329,7,544,494,551,18,12%
2011-03,הצפון,529,אעבלין,622,244,378,11,611,530,622,24,13%
2011-03,הצפון,482,בועיינה-נוג'ידאת,499,200,299,5,494,407,495,6,16%
2011-03,הצפון,4001,בוקעאתא,384,152,232,10,374,324,376,3,16%
2011-03,הצפון,998,ביר אל-מכסור,447,169,278,3,444,352,446,12,15%
2011-03,הצפון,480,בית ג'ן,349,108,241,5,344,261,345,6,8%
2011-03,הצפון,9200,בית שאן,823,357,466,14,809,461,821,96,9%
2011-03,הצפון,944,בסמת טבעון,250,110,140,3,247,195,250,11,9%
2011-03,הצפון,483,בענה,474,196,278,5,469,407,474,18,17%
2011-03,הצפון,1292,ג'דיידה-מכר,1468,613,855,6,1462,1285,1468,47,19%
2011-03,הצפון,485,ג'ולס,208,64,144,1,207,150,207,9,9%
2011-03,הצפון,487,ג'ש (גוש חלב),58,31,27,2,56,32,57,1,4%
2011-03,הצפון,489,דבורייה,452,209,243,20,432,335,451,12,12%
2011-03,הצפון,490,דייר אל-אסד,409,171,238,4,405,342,409,13,10%
2011-03,הצפון,492,דייר חנא,657,288,369,7,650,520,657,24,17%
2011-03,הצפון,975,זרזיר,321,135,186,6,315,223,314,17,13%
2011-03,הצפון,496,חורפיש,147,54,93,5,142,97,147,7,7%
2011-03,הצפון,2034,חצור הגלילית,270,114,156,10,260,142,263,27,6%
2011-03,הצפון,6700,טבריה,1853,820,1033,114,1739,1203,1749,132,9%
2011-03,הצפון,962,טובא-זנגרייה,335,153,182,6,329,250,330,14,13%
2011-03,הצפון,498,טורעאן,523,201,322,9,514,456,520,15,11%
2011-03,הצפון,8900,טמרה,2014,827,1187,20,1994,1793,2009,46,17%
2011-03,הצפון,1295,יאנוח-ג'ת,167,57,110,4,163,120,167,8,8%
2011-03,הצפון,46,יבנאל,122,64,58,6,116,93,114,3,9%
2011-03,הצפון,499,יפיע,632,262,370,7,625,510,630,30,10%
2011-03,הצפון,240,יקנעם עילית,487,192,295,73,414,200,485,49,5%
2011-03,הצפון,502,ירכא,510,207,303,1,509,408,510,23,11%
2011-03,הצפון,504,כאבול,701,293,408,8,693,622,697,20,17%
2011-03,הצפון,505,כאוכב אבו אל-היג'א,205,85,120,7,198,173,205,3,15%
2011-03,הצפון,1296,כסרא-סמיע,223,95,128,3,220,173,223,12,8%
2011-03,הצפון,978,כעביה-טבאש-חג'אג'רה,194,75,119,4,190,148,193,4,10%
2011-03,הצפון,1263,כפר ורדים,79,37,42,32,47,12,79,4,3%
2011-03,הצפון,507,כפר יאסיף,509,215,294,5,504,399,508,15,12%
2011-03,הצפון,508,כפר כמא,79,25,54,4,75,43,77,7,6%
2011-03,הצפון,509,כפר כנא,1149,465,684,20,1129,992,1140,33,16%
2011-03,הצפון,510,כפר מנדא,958,416,542,12,946,751,949,54,16%
2011-03,הצפון,47,כפר תבור,43,13,30,15,28,3,43,3,3%
2011-03,הצפון,1139,כרמיאל,1809,694,1115,372,1437,967,1751,132,7%
2011-03,הצפון,481,מגאר,1477,583,894,26,1451,1309,1473,40,20%
2011-03,הצפון,516,מג'ד אל-כרום,632,271,361,10,622,506,632,31,12%
2011-03,הצפון,874,מגדל העמק,940,414,526,71,869,473,891,109,7%
2011-03,הצפון,4201,מג'דל שמס,464,171,293,25,439,400,460,11,12%
2011-03,הצפון,517,מזרעה,174,69,105,2,172,140,173,4,11%
2011-03,הצפון,4203,מסעדה,189,72,117,3,186,160,188,0,13%
2011-03,הצפון,518,מעיליא,51,23,28,6,45,28,51,4,4%
2011-03,הצפון,1063,מעלות-תרשיחא,906,397,509,113,793,576,903,57,8%
2011-03,הצפון,520,משהד,323,117,206,2,321,280,320,11,12%
2011-03,הצפון,9100,נהרייה,2088,915,1173,242,1846,1345,2074,146,7%
2011-03,הצפון,522,נחף,443,187,256,10,433,362,442,10,11%
2011-03,הצפון,7300,נצרת,2944,1273,1671,78,2866,2282,2931,115,10%
2011-03,הצפון,1061,נצרת עילית,1920,844,1076,253,1667,1143,1822,220,8%
2011-03,הצפון,525,סאג'ור,132,51,81,1,131,91,131,6,9%
2011-03,הצפון,7500,סח'נין,2037,912,1125,31,2006,1742,2037,59,18%
2011-03,הצפון,4501,ע'ג'ר,97,41,56,2,95,71,97,3,11%
2011-03,הצפון,530,עיילבון,187,81,106,6,181,143,187,8,9%
2011-03,הצפון,511,עילוט,335,130,205,4,331,274,335,14,14%
2011-03,הצפון,532,עין מאהל,586,257,329,13,573,512,580,14,14%
2011-03,הצפון,7600,עכו,3229,1472,1757,137,3092,2558,3210,165,13%
2011-03,הצפון,7700,עפולה,1798,745,1053,199,1599,940,1735,162,8%
2011-03,הצפון,531,עראבה,1354,549,805,28,1326,1179,1352,37,17%
2011-03,הצפון,535,פסוטה,135,58,77,8,127,95,135,2,9%
2011-03,הצפון,536,פקיעין (בוקייעה),126,60,66,2,124,91,125,7,5%
2011-03,הצפון,8000,צפת,974,488,486,70,904,706,965,38,9%
2011-03,הצפון,4100,קצרין,209,94,115,43,166,99,207,19,6%
2011-03,הצפון,2800,קריית שמונה,792,361,431,62,730,318,774,104,6%
2011-03,הצפון,543,ראמה,317,131,186,7,310,250,316,7,10%
2011-03,הצפון,26,ראש פינה,53,18,35,7,46,21,53,1,4%
2011-03,הצפון,542,ריינה,596,241,355,10,586,495,591,27,11%
2011-03,הצפון,122,רמת ישי,98,35,63,28,70,12,97,9,3%
2011-03,הצפון,913,שבלי - אום אל-גנם,274,126,148,9,265,193,273,4,13%
2011-03,הצפון,812,שלומי,260,107,153,17,243,171,257,20,8%
2011-03,הצפון,538,שעב,479,197,282,5,474,411,478,13,19%
2011-03,הצפון,8800,שפרעם,2017,810,1207,30,1987,1671,2011,98,14%
2011-03,חיפה,2710,אום אל-פחם,3545,1457,2088,10,3535,3089,3541,69,21%
2011-03,חיפה,1020,אור עקיבא,574,241,333,41,533,237,563,82,6%
2011-03,חיפה,6000,באקה אל-גרביה,647,338,309,12,635,400,647,42,NULL
2011-03,חיפה,9800,בנימינה-גבעת עדה*,196,87,109,65,131,49,196,18,3%
2011-03,חיפה,1326,"בסמ""ה",383,169,214,3,380,306,383,8,12%
2011-03,חיפה,541,ג'סר א-זרקא,366,209,157,0,366,271,364,21,7%
2011-03,חיפה,628,ג'ת,199,94,105,6,193,127,198,13,NULL
2011-03,חיפה,494,דאלית אל-כרמל,490,200,290,9,481,305,488,25,7%
2011-03,חיפה,9300,זכרון יעקב,236,104,132,79,157,49,231,22,3%
2011-03,חיפה,6500,חדרה,2218,951,1267,262,1956,924,2188,241,5%
2011-03,חיפה,4000,חיפה,8004,3522,4482,1566,6438,5234,7946,481,6%
2011-03,חיפה,1247,חריש-קציר,24,8,16,2,22,7,24,2,1%
2011-03,חיפה,2100,טירת כרמל,765,347,418,39,726,506,754,85,8%
2011-03,חיפה,654,כפר קרע,372,168,204,11,361,225,370,16,5%
2011-03,חיפה,1327,מעלה עירון,871,350,521,3,868,721,871,15,18%
2011-03,חיפה,2500,נשר,558,256,302,105,453,304,555,46,5%
2011-03,חיפה,534,עספיא,343,147,196,6,337,210,339,18,7%
2011-03,חיפה,637,ערערה,553,220,333,8,545,379,553,37,8%
2011-03,חיפה,537,פוריידיס,384,193,191,4,380,265,383,19,8%
2011-03,חיפה,7800,פרדס חנה-כרכור,846,366,480,124,722,280,838,116,5%
2011-03,חיפה,6800,קריית אתא,1982,799,1183,164,1818,1232,1970,130,7%
2011-03,חיפה,9500,קריית ביאליק,1228,499,729,162,1066,702,1221,73,6%
2011-03,חיפה,2300,קריית טבעון,176,73,103,55,121,50,174,22,2%
2011-03,חיפה,9600,קריית ים,1780,774,1006,167,1613,1226,1774,122,9%
2011-03,חיפה,8200,קריית מוצקין,1210,488,722,176,1034,659,1201,95,6%
2011-03,חיפה,922,רכסים,144,68,76,6,138,101,144,8,5%
2011-03,ירושלים,472,אבו גוש,255,115,140,9,246,189,255,8,11%
2011-03,ירושלים,2610,בית שמש,1033,451,582,92,941,556,1026,114,4%
2011-03,ירושלים,3000,ירושלים,9933,4372,5561,1221,8712,6015,9883,708,4%
2011-03,ירושלים,1015,מבשרת ציון,333,158,175,55,278,159,330,37,3%
2011-03,ירושלים,1137,קריית יערים,29,12,17,5,24,11,29,3,3%
2011-03,תל אביב,2400,אור יהודה,836,371,465,38,798,297,826,95,5%
2011-03,תל אביב,565,אזור,159,86,73,19,140,38,156,21,3%
2011-03,תל אביב,6100,בני ברק,2177,1080,1097,117,2060,1371,2162,136,5%
2011-03,תל אביב,6200,בת ים,3441,1553,1888,495,2946,1532,3373,337,5%
2011-03,תל אביב,6300,גבעתיים,714,324,390,283,431,127,709,55,3%
2011-03,תל אביב,6400,הרצלייה,980,447,533,297,683,108,964,155,2%
2011-03,תל אביב,6600,חולון,2945,1340,1605,492,2453,997,2899,330,3%
2011-03,תל אביב,2620,קריית אונו,398,168,230,161,237,53,391,19,2%
2011-03,תל אביב,8600,רמת גן,2033,903,1130,634,1399,522,2014,184,3%
2011-03,תל אביב,2650,רמת השרון,371,156,215,153,218,18,368,46,2%
2011-03,תל אביב,5000,תל אביב -יפו,7670,3786,3884,2200,5470,2827,7605,611,3%
2011-04,אזור יהודה והשומרון,3760,אורנית,84,44,40,32,52,3,84,7,2%
2011-04,אזור יהודה והשומרון,3750,אלפי מנשה,84,37,47,22,62,2,84,3,2%
2011-04,אזור יהודה והשומרון,3560,אלקנה,36,19,17,20,16,2,36,1,2%
2011-04,אזור יהודה והשומרון,3650,אפרתה,47,24,23,25,22,9,47,1,1%
2011-04,אזור יהודה והשומרון,3570,אריאל,326,144,182,91,235,104,325,25,3%
2011-04,אזור יהודה והשומרון,3574,בית אל,44,20,24,12,32,17,44,2,2%
2011-04,אזור יהודה והשומרון,3652,בית אריה,55,19,36,7,48,7,55,3,3%
2011-04,אזור יהודה והשומרון,3780,ביתר עילית,334,171,163,15,319,206,330,13,4%
2011-04,אזור יהודה והשומרון,3730,גבעת זאב,147,75,72,13,134,47,147,7,2%
2011-04,אזור יהודה והשומרון,3769,הר אדר,29,13,16,14,15,1,29,1,2%
2011-04,אזור יהודה והשומרון,3797,מודיעין עילית,264,108,156,18,246,88,264,5,3%
2011-04,אזור יהודה והשומרון,3616,מעלה אדומים,558,223,335,88,470,219,556,51,3%
2011-04,אזור יהודה והשומרון,3660,עמנואל,73,38,35,5,68,52,73,4,8%
2011-04,אזור יהודה והשומרון,3557,קדומים,19,13,6,7,12,4,19,0,1%
2011-04,אזור יהודה והשומרון,3611,קריית ארבע,98,46,52,15,83,65,98,3,4%
2011-04,אזור יהודה והשומרון,3640,קרני שומרון,65,38,27,18,47,19,65,6,2%
2011-04,הדרום,31,אופקים,1249,525,724,95,1154,950,1243,23,11%
2011-04,הדרום,2600,אילת,1278,586,692,75,1203,619,1264,74,4%
2011-04,הדרום,70,אשדוד,6368,2497,3871,748,5620,4006,6315,271,6%
2011-04,הדרום,7100,אשקלון,3970,1541,2429,613,3357,2600,3885,213,7%
2011-04,הדרום,9000,באר שבע,6839,2905,3934,902,5937,4730,6788,417,7%
2011-04,הדרום,2200,דימונה,1914,854,1060,117,1797,1414,1893,93,11%
2011-04,הדרום,1303,חורה,711,307,404,0,711,662,711,5,23%
2011-04,הדרום,831,ירוחם,385,191,194,19,366,261,380,43,9%
2011-04,הדרום,1059,כסיפה,973,392,581,2,971,892,970,43,26%
2011-04,הדרום,1271,להבים,33,15,18,16,17,3,33,3,1%
2011-04,הדרום,1060,לקיה,893,396,497,4,889,836,892,14,28%
2011-04,הדרום,1268,מיתר,53,19,34,25,28,5,53,5,1%
2011-04,הדרום,99,מצפה רמון,214,86,128,16,198,124,203,20,9%
2011-04,הדרום,246,נתיבות,879,381,498,48,831,482,875,58,8%
2011-04,הדרום,666,עומר,59,22,37,34,25,7,59,4,2%
2011-04,הדרום,2560,ערד,803,363,440,164,639,539,778,62,6%
2011-04,הדרום,1192,ערערה-בנגב,963,379,584,3,960,890,962,21,30%
2011-04,הדרום,2630,קריית גת,2110,836,1274,175,1935,1470,2105,80,9%
2011-04,הדרום,1034,קריית מלאכי,1179,526,653,33,1146,820,1162,84,11%
2011-04,הדרום,1161,רהט,2873,1093,1780,9,2864,2609,2871,39,21%
2011-04,הדרום,1286,שגב-שלום,579,249,330,1,578,492,578,104,28%
2011-04,הדרום,1031,שדרות,992,401,591,47,945,619,990,36,9%
2011-04,הדרום,1054,תל שבע,1151,527,624,3,1148,1075,1149,26,30%
2011-04,המרכז,182,אבן יהודה,116,60,56,37,79,12,116,11,2%
2011-04,המרכז,41,אליכין,51,23,28,5,46,18,50,1,3%
2011-04,המרכז,1309,אלעד,328,161,167,20,308,115,328,9,3%
2011-04,המרכז,2530,באר יעקב,231,113,118,42,189,74,229,13,3%
2011-04,המרכז,466,בית דגן,82,41,41,12,70,34,82,4,3%
2011-04,המרכז,1066,"בני עי""ש",187,87,100,21,166,87,186,1,5%
2011-04,המרכז,681,גבעת שמואל,246,122,124,93,153,47,246,6,2%
2011-04,המרכז,2550,גדרה,324,143,181,62,262,105,319,2,3%
2011-04,המרכז,627,ג'לג'וליה,59,28,31,5,54,32,59,1,2%
2011-04,המרכז,166,גן יבנה,281,108,173,36,245,95,280,8,3%
2011-04,המרכז,229,גני תקווה,148,65,83,39,109,28,148,3,2%
2011-04,המרכז,9700,הוד השרון,540,251,289,198,342,55,536,27,2%
2011-04,המרכז,1290,זמר,167,57,110,9,158,130,167,6,7%
2011-04,המרכז,2730,טייבה,2068,843,1225,7,2061,1800,2052,33,14%
2011-04,המרכז,2720,טירה,296,126,170,6,290,195,295,12,3%
2011-04,המרכז,2660,יבנה,794,389,405,75,719,413,792,45,4%
2011-04,המרכז,9400,יהוד,475,194,281,86,389,76,465,22,3%
2011-04,המרכז,1224,כוכב יאיר,76,39,37,38,38,4,76,4,1%
2011-04,המרכז,633,כפר ברא,21,12,9,0,21,7,21,3,2%
2011-04,המרכז,168,כפר יונה,304,141,163,54,250,71,302,32,3%
2011-04,המרכז,6900,כפר סבא,1032,452,580,306,726,197,1025,48,2%
2011-04,המרכז,634,כפר קאסם,203,96,107,0,203,122,201,6,3%
2011-04,המרכז,7000,לוד,2004,890,1114,181,1823,1242,1999,84,6%
2011-04,המרכז,1200,מודיעין-מכבים-רעות*,832,367,465,352,480,64,823,42,2%
2011-04,המרכז,28,מזכרת בתיה,137,58,79,29,108,37,135,0,2%
2011-04,המרכז,7200,נס ציונה,638,269,369,130,508,207,631,2,3%
2011-04,המרכז,7400,נתניה,4132,1903,2229,575,3557,1837,4097,291,4%
2011-04,המרכז,587,סביון*,13,4,9,7,6,1,13,0,1%
2011-04,המרכז,171,פרדסייה,65,27,38,14,51,7,65,4,2%
2011-04,המרכז,7900,פתח תקווה,3653,1596,2057,745,2908,1140,3623,168,3%
2011-04,המרכז,195,קדימה-צורן,208,99,109,62,146,39,208,6,2%
2011-04,המרכז,638,קלנסווה,869,331,538,2,867,738,865,8,12%
2011-04,המרכז,469,קריית עקרון,249,125,124,21,228,106,248,2,5%
2011-04,המרכז,2640,ראש העין,580,266,314,63,517,168,578,32,3%
2011-04,המרכז,8300,ראשון לציון,4117,1756,2361,867,3250,1655,4104,148,3%
2011-04,המרכז,8400,רחובות,2339,1029,1310,518,1821,1010,2302,12,4%
2011-04,המרכז,8500,רמלה,1629,766,863,87,1542,828,1601,105,5%
2011-04,המרכז,8700,רעננה,683,323,360,266,417,79,681,29,2%
2011-04,המרכז,1304,שוהם,148,59,89,61,87,10,148,14,2%
2011-04,המרכז,154,תל מונד,118,50,68,38,80,23,118,6,2%
2011-04,הצפון,473,אבו סנאן,711,271,440,4,707,611,707,11,15%
2011-04,הצפון,478,אכסאל,538,211,327,10,528,483,538,11,12%
2011-04,הצפון,529,אעבלין,612,238,374,9,603,521,612,18,13%
2011-04,הצפון,482,בועיינה-נוג'ידאת,478,196,282,5,473,397,475,6,15%
2011-04,הצפון,4001,בוקעאתא,368,142,226,7,361,321,360,4,16%
2011-04,הצפון,998,ביר אל-מכסור,424,156,268,3,421,338,423,12,14%
2011-04,הצפון,480,בית ג'ן,327,97,230,3,324,240,323,5,8%
2011-04,הצפון,9200,בית שאן,746,311,435,17,729,446,744,61,8%
2011-04,הצפון,944,בסמת טבעון,231,97,134,5,226,190,231,13,9%
2011-04,הצפון,483,בענה,451,180,271,4,447,398,451,9,16%
2011-04,הצפון,1292,ג'דיידה-מכר,1440,596,844,4,1436,1270,1440,23,19%
2011-04,הצפון,485,ג'ולס,191,57,134,1,190,145,190,6,8%
2011-04,הצפון,487,ג'ש (גוש חלב),56,31,25,3,53,32,55,2,4%
2011-04,הצפון,489,דבורייה,429,195,234,16,413,326,428,5,12%
2011-04,הצפון,490,דייר אל-אסד,397,161,236,3,394,330,397,13,10%
2011-04,הצפון,492,דייר חנא,637,269,368,6,631,512,637,11,16%
2011-04,הצפון,975,זרזיר,288,111,177,3,285,216,286,5,12%
2011-04,הצפון,496,חורפיש,136,49,87,3,133,93,136,5,7%
2011-04,הצפון,2034,חצור הגלילית,229,94,135,7,222,130,223,17,5%
2011-04,הצפון,6700,טבריה,1737,767,970,116,1621,1186,1628,76,8%
2011-04,הצפון,962,טובא-זנגרייה,327,143,184,5,322,249,324,8,12%
2011-04,הצפון,498,טורעאן,507,191,316,6,501,450,504,13,11%
2011-04,הצפון,8900,טמרה,1971,814,1157,18,1953,1764,1965,54,17%
2011-04,הצפון,1295,יאנוח-ג'ת,163,49,114,3,160,117,163,5,8%
2011-04,הצפון,46,יבנאל,117,64,53,6,111,90,108,1,8%
2011-04,הצפון,499,יפיע,605,250,355,9,596,493,603,25,9%
2011-04,הצפון,240,יקנעם עילית,450,186,264,70,380,194,450,41,4%
2011-04,הצפון,502,ירכא,477,189,288,1,476,396,477,10,11%
2011-04,הצפון,504,כאבול,676,280,396,6,670,603,675,14,17%
2011-04,הצפון,505,כאוכב אבו אל-היג'א,202,81,121,6,196,171,202,3,14%
2011-04,הצפון,1296,כסרא-סמיע,192,74,118,4,188,156,192,8,7%
2011-04,הצפון,978,כעביה-טבאש-חג'אג'רה,182,75,107,3,179,140,180,4,10%
2011-04,הצפון,1263,כפר ורדים,73,35,38,27,46,12,73,3,3%
2011-04,הצפון,507,כפר יאסיף,496,205,291,5,491,387,495,18,12%
2011-04,הצפון,508,כפר כמא,68,20,48,3,65,41,66,4,5%
2011-04,הצפון,509,כפר כנא,1125,449,676,21,1104,985,1117,37,16%
2011-04,הצפון,510,כפר מנדא,959,430,529,12,947,742,952,28,16%
2011-04,הצפון,47,כפר תבור,43,17,26,13,30,2,41,2,2%
2011-04,הצפון,1139,כרמיאל,1608,612,996,323,1285,905,1573,74,6%
2011-04,הצפון,481,מגאר,1450,538,912,23,1427,1290,1446,11,20%
2011-04,הצפון,516,מג'ד אל-כרום,610,256,354,9,601,499,610,16,12%
2011-04,הצפון,874,מגדל העמק,819,354,465,68,751,428,784,72,6%
2011-04,הצפון,4201,מג'דל שמס,454,164,290,17,437,397,450,7,12%
2011-04,הצפון,517,מזרעה,169,65,104,2,167,141,168,5,11%
2011-04,הצפון,4203,מסעדה,191,72,119,3,188,162,190,2,13%
2011-04,הצפון,518,מעיליא,45,20,25,6,39,24,45,1,3%
2011-04,הצפון,1063,מעלות-תרשיחא,837,379,458,109,728,551,834,47,7%
2011-04,הצפון,520,משהד,312,109,203,2,310,271,309,7,12%
2011-04,הצפון,9100,נהרייה,1939,843,1096,220,1719,1295,1929,86,7%
2011-04,הצפון,522,נחף,429,180,249,9,420,354,428,14,11%
2011-04,הצפון,7300,נצרת,2893,1251,1642,68,2825,2247,2884,97,10%
2011-04,הצפון,1061,נצרת עילית,1848,757,1091,260,1588,1153,1755,144,8%
2011-04,הצפון,525,סאג'ור,126,50,76,2,124,86,124,6,9%
2011-04,הצפון,7500,סח'נין,1992,877,1115,32,1960,1725,1992,35,17%
2011-04,הצפון,4501,ע'ג'ר,99,41,58,2,97,71,99,7,12%
2011-04,הצפון,530,עיילבון,179,73,106,5,174,138,179,5,8%
2011-04,הצפון,511,עילוט,329,130,199,6,323,270,329,8,14%
2011-04,הצפון,532,עין מאהל,582,253,329,12,570,510,576,15,14%
2011-04,הצפון,7600,עכו,3093,1412,1681,130,2963,2489,3074,95,13%
2011-04,הצפון,7700,עפולה,1604,661,943,182,1422,872,1551,108,7%
2011-04,הצפון,531,עראבה,1325,540,785,24,1301,1169,1323,32,16%
2011-04,הצפון,535,פסוטה,129,54,75,6,123,91,129,4,9%
2011-04,הצפון,536,פקיעין (בוקייעה),135,69,66,1,134,97,134,5,6%
2011-04,הצפון,8000,צפת,889,444,445,73,816,669,882,19,8%
2011-04,הצפון,4100,קצרין,202,85,117,42,160,97,200,6,5%
2011-04,הצפון,2800,קריית שמונה,688,313,375,51,637,293,669,63,6%
2011-04,הצפון,543,ראמה,296,122,174,8,288,238,295,2,9%
2011-04,הצפון,26,ראש פינה,50,19,31,6,44,20,50,3,4%
2011-04,הצפון,542,ריינה,575,228,347,9,566,483,570,16,10%
2011-04,הצפון,122,רמת ישי,85,27,58,23,62,8,84,3,2%
2011-04,הצפון,913,שבלי - אום אל-גנם,244,107,137,4,240,187,243,11,11%
2011-04,הצפון,812,שלומי,241,97,144,14,227,166,238,14,7%
2011-04,הצפון,538,שעב,478,205,273,4,474,405,477,9,19%
2011-04,הצפון,8800,שפרעם,1913,740,1173,29,1884,1617,1909,63,13%
2011-04,חיפה,2710,אום אל-פחם,3518,1424,2094,11,3507,3074,3514,44,21%
2011-04,חיפה,1020,אור עקיבא,519,224,295,39,480,228,507,61,6%
2011-04,חיפה,6000,באקה אל-גרביה,650,325,325,10,640,412,650,40,NULL
2011-04,חיפה,9800,בנימינה-גבעת עדה*,179,77,102,62,117,46,179,11,3%
2011-04,חיפה,1326,"בסמ""ה",383,167,216,3,380,309,383,7,12%
2011-04,חיפה,541,ג'סר א-זרקא,363,205,158,0,363,273,361,7,7%
2011-04,חיפה,628,ג'ת,203,98,105,8,195,123,202,17,NULL
2011-04,חיפה,494,דאלית אל-כרמל,443,180,263,10,433,289,440,8,7%
2011-04,חיפה,9300,זכרון יעקב,223,107,116,68,155,49,221,13,2%
2011-04,חיפה,6500,חדרה,2085,856,1229,260,1825,880,2057,155,5%
2011-04,חיפה,4000,חיפה,7424,3246,4178,1458,5966,5003,7380,349,6%
2011-04,חיפה,1247,חריש-קציר,28,8,20,2,26,9,27,1,2%
2011-04,חיפה,2100,טירת כרמל,740,336,404,37,703,489,732,54,8%
2011-04,חיפה,654,כפר קרע,347,152,195,8,339,224,345,20,5%
2011-04,חיפה,1327,מעלה עירון,880,359,521,2,878,715,880,15,18%
2011-04,חיפה,2500,נשר,513,236,277,98,415,285,510,31,4%
2011-04,חיפה,534,עספיא,310,133,177,5,305,206,310,13,7%
2011-04,חיפה,637,ערערה,530,195,335,7,523,372,530,19,8%
2011-04,חיפה,537,פוריידיס,379,191,188,3,376,262,378,18,8%
2011-04,חיפה,7800,פרדס חנה-כרכור,756,318,438,110,646,276,753,54,5%
2011-04,חיפה,6800,קריית אתא,1841,752,1089,147,1694,1197,1834,84,7%
2011-04,חיפה,9500,קריית ביאליק,1163,471,692,147,1016,678,1158,61,6%
2011-04,חיפה,2300,קריית טבעון,173,78,95,50,123,50,172,7,2%
2011-04,חיפה,9600,קריית ים,1664,731,933,162,1502,1169,1658,65,8%
2011-04,חיפה,8200,קריית מוצקין,1107,438,669,161,946,627,1101,55,5%
2011-04,חיפה,922,רכסים,137,64,73,5,132,97,137,3,5%
2011-04,ירושלים,472,אבו גוש,232,105,127,5,227,183,232,2,10%
2011-04,ירושלים,2610,בית שמש,945,413,532,88,857,517,936,32,4%
2011-04,ירושלים,3000,ירושלים,9123,3956,5167,1060,8063,5819,9089,347,4%
2011-04,ירושלים,1015,מבשרת ציון,318,144,174,62,256,156,318,21,3%
2011-04,ירושלים,1137,קריית יערים,26,11,15,5,21,12,26,3,3%
2011-04,תל אביב,2400,אור יהודה,732,322,410,35,697,290,725,46,4%
2011-04,תל אביב,565,אזור,151,82,69,18,133,38,150,11,3%
2011-04,תל אביב,6100,בני ברק,2062,1022,1040,119,1943,1321,2044,97,4%
2011-04,תל אביב,6200,בת ים,3161,1420,1741,447,2714,1488,3113,231,4%
2011-04,תל אביב,6300,גבעתיים,666,301,365,278,388,111,665,31,2%
2011-04,תל אביב,6400,הרצלייה,889,406,483,260,629,96,878,90,2%
2011-04,תל אביב,6600,חולון,2663,1210,1453,466,2197,958,2630,193,3%
2011-04,תל אביב,2620,קריית אונו,357,152,205,145,212,45,354,14,2%
2011-04,תל אביב,8600,רמת גן,1857,840,1017,572,1285,496,1843,102,3%
2011-04,תל אביב,2650,רמת השרון,331,138,193,135,196,22,329,32,2%
2011-04,תל אביב,5000,תל אביב -יפו,7085,3522,3563,2087,4998,2717,7033,380,3%
2011-05,אזור יהודה והשומרון,3760,אורנית,88,46,42,35,53,3,88,5,2%
2011-05,אזור יהודה והשומרון,3750,אלפי מנשה,103,46,57,31,72,3,102,10,3%
2011-05,אזור יהודה והשומרון,3560,אלקנה,38,20,18,22,16,2,38,4,2%
2011-05,אזור יהודה והשומרון,3650,אפרתה,44,24,20,27,17,6,44,1,1%
2011-05,אזור יהודה והשומרון,3570,אריאל,377,162,215,98,279,109,376,44,4%
2011-05,אזור יהודה והשומרון,3574,בית אל,53,25,28,14,39,16,53,6,2%
2011-05,אזור יהודה והשומרון,3652,בית אריה,61,21,40,9,52,5,61,1,3%
2011-05,אזור יהודה והשומרון,3780,ביתר עילית,387,188,199,14,373,216,383,30,5%
2011-05,אזור יהודה והשומרון,3730,גבעת זאב,189,92,97,30,159,50,188,15,3%
2011-05,אזור יהודה והשומרון,3769,הר אדר,26,12,14,13,13,1,26,1,2%
2011-05,אזור יהודה והשומרון,3797,מודיעין עילית,287,104,183,19,268,95,285,11,3%
2011-05,אזור יהודה והשומרון,3616,מעלה אדומים,744,306,438,110,634,230,739,63,4%
2011-05,אזור יהודה והשומרון,3660,עמנואל,78,36,42,5,73,51,77,2,8%
2011-05,אזור יהודה והשומרון,3557,קדומים,24,11,13,5,19,6,24,1,2%
2011-05,אזור יהודה והשומרון,3611,קריית ארבע,113,54,59,16,97,70,113,10,4%
2011-05,אזור יהודה והשומרון,3640,קרני שומרון,74,43,31,21,53,20,73,5,2%
2011-05,הדרום,31,אופקים,1363,584,779,98,1265,981,1351,56,12%
2011-05,הדרום,2600,אילת,1351,628,723,80,1271,646,1339,115,4%
2011-05,הדרום,70,אשדוד,6819,2640,4179,799,6020,4102,6760,523,7%
2011-05,הדרום,7100,אשקלון,4294,1658,2636,675,3619,2689,4203,240,7%
2011-05,הדרום,9000,באר שבע,7198,3036,4162,944,6254,4838,7140,574,8%
2011-05,הדרום,2200,דימונה,2052,910,1142,116,1936,1452,2026,144,12%
2011-05,הדרום,1303,חורה,711,303,408,0,711,668,710,4,23%
2011-05,הדרום,831,ירוחם,433,208,225,20,413,267,429,71,10%
2011-05,הדרום,1059,כסיפה,967,400,567,2,965,894,966,28,26%
2011-05,הדרום,1271,להבים,41,17,24,22,19,4,41,5,1%
2011-05,הדרום,1060,לקיה,898,399,499,6,892,838,897,12,28%
2011-05,הדרום,1268,מיתר,57,21,36,22,35,5,57,5,2%
2011-05,הדרום,99,מצפה רמון,229,95,134,14,215,127,218,40,10%
2011-05,הדרום,246,נתיבות,986,407,579,49,937,523,981,127,8%
2011-05,הדרום,666,עומר,57,19,38,32,25,7,57,5,2%
2011-05,הדרום,2560,ערד,879,398,481,172,707,538,841,127,7%
2011-05,הדרום,1192,ערערה-בנגב,972,391,581,3,969,895,971,18,30%
2011-05,הדרום,2630,קריית גת,2254,902,1352,176,2078,1517,2246,144,9%
2011-05,הדרום,1034,קריית מלאכי,1292,577,715,31,1261,843,1268,131,12%
2011-05,הדרום,1161,רהט,2948,1150,1798,8,2940,2635,2947,87,21%
2011-05,הדרום,1286,שגב-שלום,604,259,345,0,604,462,602,118,28%
2011-05,הדרום,1031,שדרות,1084,451,633,51,1033,650,1081,95,10%
2011-05,הדרום,1054,תל שבע,1166,549,617,3,1163,1080,1164,36,30%
2011-05,המרכז,182,אבן יהודה,128,63,65,45,83,15,128,14,2%
2011-05,המרכז,41,אליכין,54,26,28,6,48,18,53,2,3%
2011-05,המרכז,1309,אלעד,362,180,182,19,343,124,361,22,3%
2011-05,המרכז,2530,באר יעקב,233,109,124,48,185,74,230,28,3%
2011-05,המרכז,466,בית דגן,88,46,42,13,75,34,87,6,3%
2011-05,המרכז,1066,"בני עי""ש",200,93,107,22,178,86,196,1,5%
2011-05,המרכז,681,גבעת שמואל,276,143,133,109,167,57,276,14,3%
2011-05,המרכז,2550,גדרה,346,159,187,61,285,106,340,4,3%
2011-05,המרכז,627,ג'לג'וליה,66,31,35,4,62,36,66,2,2%
2011-05,המרכז,166,גן יבנה,318,115,203,42,276,102,317,33,3%
2011-05,המרכז,229,גני תקווה,175,74,101,50,125,25,174,7,3%
2011-05,המרכז,9700,הוד השרון,588,285,303,204,384,64,584,41,2%
2011-05,המרכז,1290,זמר,168,57,111,9,159,125,168,11,7%
2011-05,המרכז,2730,טייבה,2087,864,1223,6,2081,1807,2076,44,14%
2011-05,המרכז,2720,טירה,323,150,173,8,315,202,321,18,4%
2011-05,המרכז,2660,יבנה,872,427,445,78,794,430,871,83,5%
2011-05,המרכז,9400,יהוד,587,250,337,101,486,79,566,45,4%
2011-05,המרכז,1224,כוכב יאיר,84,39,45,42,42,6,84,4,2%
2011-05,המרכז,633,כפר ברא,26,14,12,0,26,8,26,2,3%
2011-05,המרכז,168,כפר יונה,315,147,168,55,260,78,312,30,3%
2011-05,המרכז,6900,כפר סבא,1152,506,646,340,812,207,1143,81,3%
2011-05,המרכז,634,כפר קאסם,222,117,105,2,220,122,221,9,3%
2011-05,המרכז,7000,לוד,2182,988,1194,194,1988,1255,2175,145,7%
2011-05,המרכז,1200,מודיעין-מכבים-רעות*,934,415,519,389,545,68,924,88,3%
2011-05,המרכז,28,מזכרת בתיה,143,62,81,32,111,40,141,1,3%
2011-05,המרכז,7200,נס ציונה,653,271,382,139,514,209,641,3,3%
2011-05,המרכז,7400,נתניה,4592,2135,2457,653,3939,1920,4537,486,5%
2011-05,המרכז,587,סביון*,19,6,13,7,12,1,19,0,1%
2011-05,המרכז,171,פרדסייה,78,35,43,17,61,7,78,10,2%
2011-05,המרכז,7900,פתח תקווה,4149,1777,2372,849,3300,1191,4111,337,4%
2011-05,המרכז,195,קדימה-צורן,236,115,121,73,163,43,236,19,3%
2011-05,המרכז,638,קלנסווה,892,351,541,1,891,753,888,19,13%
2011-05,המרכז,469,קריית עקרון,278,138,140,25,253,114,276,7,5%
2011-05,המרכז,2640,ראש העין,749,353,396,85,664,181,736,62,4%
2011-05,המרכז,8300,ראשון לציון,4553,1938,2615,898,3655,1728,4529,439,4%
2011-05,המרכז,8400,רחובות,2541,1096,1445,560,1981,1058,2493,12,4%
2011-05,המרכז,8500,רמלה,1821,852,969,103,1718,872,1781,180,6%
2011-05,המרכז,8700,רעננה,748,360,388,274,474,87,747,50,2%
2011-05,המרכז,1304,שוהם,162,69,93,73,89,8,162,20,2%
2011-05,המרכז,154,תל מונד,125,56,69,39,86,23,125,7,2%
2011-05,הצפון,473,אבו סנאן,714,269,445,4,710,613,710,25,15%
2011-05,הצפון,478,אכסאל,536,210,326,9,527,482,536,10,12%
2011-05,הצפון,529,אעבלין,614,244,370,10,604,521,614,30,13%
2011-05,הצפון,482,בועיינה-נוג'ידאת,485,197,288,4,481,396,481,20,15%
2011-05,הצפון,4001,בוקעאתא,380,151,229,8,372,324,371,10,16%
2011-05,הצפון,998,ביר אל-מכסור,429,162,267,3,426,332,428,10,14%
2011-05,הצפון,480,בית ג'ן,352,92,260,1,351,258,348,20,8%
2011-05,הצפון,9200,בית שאן,804,329,475,21,783,457,802,77,9%
2011-05,הצפון,944,בסמת טבעון,233,98,135,4,229,191,232,7,9%
2011-05,הצפון,483,בענה,456,179,277,3,453,395,456,16,16%
2011-05,הצפון,1292,ג'דיידה-מכר,1464,609,855,6,1458,1292,1463,30,19%
2011-05,הצפון,485,ג'ולס,190,56,134,1,189,144,189,8,8%
2011-05,הצפון,487,ג'ש (גוש חלב),55,28,27,3,52,33,54,5,4%
2011-05,הצפון,489,דבורייה,434,193,241,15,419,332,433,13,12%
2011-05,הצפון,490,דייר אל-אסד,409,171,238,5,404,340,409,7,10%
2011-05,הצפון,492,דייר חנא,632,270,362,5,627,510,632,20,16%
2011-05,הצפון,975,זרזיר,296,118,178,3,293,213,291,9,12%
2011-05,הצפון,496,חורפיש,163,55,108,5,158,96,163,13,8%
2011-05,הצפון,2034,חצור הגלילית,273,110,163,7,266,130,264,46,6%
2011-05,הצפון,6700,טבריה,1850,817,1033,120,1730,1237,1738,130,9%
2011-05,הצפון,962,טובא-זנגרייה,371,150,221,4,367,251,366,14,14%
2011-05,הצפון,498,טורעאן,503,187,316,5,498,453,500,14,11%
2011-05,הצפון,8900,טמרה,1968,835,1133,21,1947,1734,1963,64,17%
2011-05,הצפון,1295,יאנוח-ג'ת,167,53,114,3,164,121,167,6,8%
2011-05,הצפון,46,יבנאל,127,74,53,6,121,99,119,3,9%
2011-05,הצפון,499,יפיע,614,251,363,7,607,500,611,22,10%
2011-05,הצפון,240,יקנעם עילית,505,211,294,73,432,208,504,51,5%
2011-05,הצפון,502,ירכא,488,197,291,1,487,408,488,15,11%
2011-05,הצפון,504,כאבול,674,276,398,7,667,596,673,16,17%
2011-05,הצפון,505,כאוכב אבו אל-היג'א,197,78,119,5,192,170,197,6,14%
2011-05,הצפון,1296,כסרא-סמיע,218,80,138,3,215,164,218,13,8%
2011-05,הצפון,978,כעביה-טבאש-חג'אג'רה,191,81,110,2,189,143,189,9,10%
2011-05,הצפון,1263,כפר ורדים,77,37,40,33,44,9,77,1,3%
2011-05,הצפון,507,כפר יאסיף,490,203,287,5,485,389,489,19,12%
2011-05,הצפון,508,כפר כמא,66,23,43,4,62,43,64,2,5%
2011-05,הצפון,509,כפר כנא,1122,439,683,20,1102,984,1114,36,16%
2011-05,הצפון,510,כפר מנדא,1002,453,549,12,990,758,993,40,17%
2011-05,הצפון,47,כפר תבור,44,17,27,15,29,2,42,1,3%
2011-05,הצפון,1139,כרמיאל,1758,664,1094,350,1408,952,1700,116,7%
2011-05,הצפון,481,מגאר,1489,578,911,24,1465,1314,1485,72,20%
2011-05,הצפון,516,מג'ד אל-כרום,623,259,364,11,612,505,623,20,12%
2011-05,הצפון,874,מגדל העמק,967,412,555,83,884,462,918,125,7%
2011-05,הצפון,4201,מג'דל שמס,472,176,296,22,450,404,467,7,12%
2011-05,הצפון,517,מזרעה,172,64,108,2,170,145,171,4,11%
2011-05,הצפון,4203,מסעדה,201,73,128,4,197,172,200,3,14%
2011-05,הצפון,518,מעיליא,43,20,23,4,39,25,43,2,3%
2011-05,הצפון,1063,מעלות-תרשיחא,893,399,494,112,781,579,891,52,8%
2011-05,הצפון,520,משהד,317,109,208,1,316,273,314,9,12%
2011-05,הצפון,9100,נהרייה,2071,893,1178,238,1833,1323,2059,125,7%
2011-05,הצפון,522,נחף,436,191,245,10,426,357,435,13,11%
2011-05,הצפון,7300,נצרת,2883,1233,1650,61,2822,2237,2871,99,10%
2011-05,הצפון,1061,נצרת עילית,2007,840,1167,261,1746,1160,1912,254,8%
2011-05,הצפון,525,סאג'ור,131,47,84,2,129,92,130,2,9%
2011-05,הצפון,7500,סח'נין,1992,885,1107,33,1959,1708,1992,52,17%
2011-05,הצפון,4501,ע'ג'ר,94,33,61,2,92,67,94,6,11%
2011-05,הצפון,530,עיילבון,178,71,107,7,171,144,178,11,8%
2011-05,הצפון,511,עילוט,327,121,206,7,320,276,327,16,14%
2011-05,הצפון,532,עין מאהל,581,256,325,11,570,511,572,25,14%
2011-05,הצפון,7600,עכו,3213,1454,1759,136,3077,2549,3195,142,13%
2011-05,הצפון,7700,עפולה,1803,738,1065,192,1611,909,1738,166,8%
2011-05,הצפון,531,עראבה,1334,540,794,26,1308,1162,1332,38,17%
2011-05,הצפון,535,פסוטה,134,53,81,6,128,96,134,6,9%
2011-05,הצפון,536,פקיעין (בוקייעה),132,66,66,3,129,94,131,3,6%
2011-05,הצפון,8000,צפת,969,484,485,73,896,709,958,30,8%
2011-05,הצפון,4100,קצרין,205,88,117,47,158,96,203,13,5%
2011-05,הצפון,2800,קריית שמונה,765,354,411,51,714,305,742,100,6%
2011-05,הצפון,543,ראמה,310,135,175,8,302,240,308,5,10%
2011-05,הצפון,26,ראש פינה,48,17,31,5,43,20,48,6,4%
2011-05,הצפון,542,ריינה,593,238,355,9,584,489,588,32,11%
2011-05,הצפון,122,רמת ישי,87,27,60,25,62,11,86,12,2%
2011-05,הצפון,913,שבלי - אום אל-גנם,239,107,132,6,233,184,238,9,11%
2011-05,הצפון,812,שלומי,260,108,152,15,245,172,256,18,8%
2011-05,הצפון,538,שעב,482,207,275,2,480,409,481,9,19%
2011-05,הצפון,8800,שפרעם,1930,760,1170,26,1904,1613,1922,90,13%
2011-05,חיפה,2710,אום אל-פחם,3566,1434,2132,10,3556,3107,3562,47,21%
2011-05,חיפה,1020,אור עקיבא,598,244,354,46,552,244,579,91,6%
2011-05,חיפה,6000,באקה אל-גרביה,680,337,343,11,669,417,680,51,NULL
2011-05,חיפה,9800,בנימינה-גבעת עדה*,194,83,111,61,133,51,194,19,3%
2011-05,חיפה,1326,"בסמ""ה",380,159,221,3,377,313,380,13,12%
2011-05,חיפה,541,ג'סר א-זרקא,428,244,184,0,428,287,426,15,8%
2011-05,חיפה,628,ג'ת,208,98,110,5,203,129,207,11,NULL
2011-05,חיפה,494,דאלית אל-כרמל,457,183,274,10,447,293,454,22,7%
2011-05,חיפה,9300,זכרון יעקב,226,106,120,73,153,47,224,19,2%
2011-05,חיפה,6500,חדרה,2404,972,1432,281,2123,945,2362,240,5%
2011-05,חיפה,4000,חיפה,7746,3380,4366,1501,6245,5053,7699,563,6%
2011-05,חיפה,1247,חריש-קציר,26,9,17,2,24,8,26,1,2%
2011-05,חיפה,2100,טירת כרמל,801,361,440,37,764,508,797,78,8%
2011-05,חיפה,654,כפר קרע,356,157,199,5,351,231,354,22,5%
2011-05,חיפה,1327,מעלה עירון,881,355,526,3,878,727,881,16,19%
2011-05,חיפה,2500,נשר,559,266,293,104,455,284,554,57,5%
2011-05,חיפה,534,עספיא,326,137,189,8,318,204,326,19,7%
2011-05,חיפה,637,ערערה,540,200,340,8,532,376,539,26,8%
2011-05,חיפה,537,פוריידיס,373,187,186,5,368,260,371,19,8%
2011-05,חיפה,7800,פרדס חנה-כרכור,856,377,479,128,728,296,849,105,5%
2011-05,חיפה,6800,קריית אתא,1939,812,1127,158,1781,1195,1929,146,7%
2011-05,חיפה,9500,קריית ביאליק,1266,494,772,157,1109,699,1262,90,6%
2011-05,חיפה,2300,קריית טבעון,183,82,101,62,121,48,182,13,2%
2011-05,חיפה,9600,קריית ים,1749,774,975,165,1584,1176,1740,112,9%
2011-05,חיפה,8200,קריית מוצקין,1212,498,714,171,1041,643,1205,93,6%
2011-05,חיפה,922,רכסים,150,67,83,5,145,103,149,14,6%
2011-05,ירושלים,472,אבו גוש,237,110,127,4,233,185,237,11,10%
2011-05,ירושלים,2610,בית שמש,1149,506,643,92,1057,567,1141,117,5%
2011-05,ירושלים,3000,ירושלים,9904,4299,5605,1195,8709,6061,9837,704,4%
2011-05,ירושלים,1015,מבשרת ציון,379,171,208,68,311,182,378,22,3%
2011-05,ירושלים,1137,קריית יערים,27,9,18,3,24,10,27,3,3%
2011-05,תל אביב,2400,אור יהודה,1024,479,545,45,979,301,1014,78,6%
2011-05,תל אביב,565,אזור,175,86,89,20,155,37,171,21,3%
2011-05,תל אביב,6100,בני ברק,2180,1082,1098,137,2043,1380,2167,153,5%
2011-05,תל אביב,6200,בת ים,3385,1516,1869,462,2923,1502,3326,326,5%
2011-05,תל אביב,6300,גבעתיים,744,329,415,313,431,121,742,75,3%
2011-05,תל אביב,6400,הרצלייה,968,447,521,279,689,94,954,119,2%
2011-05,תל אביב,6600,חולון,3041,1393,1648,492,2549,998,3007,308,3%
2011-05,תל אביב,2620,קריית אונו,422,183,239,152,270,47,420,29,3%
2011-05,תל אביב,8600,רמת גן,2196,1014,1182,636,1560,508,2182,183,3%
2011-05,תל אביב,2650,רמת השרון,383,169,214,150,233,20,382,42,2%
2011-05,תל אביב,5000,תל אביב -יפו,7812,3869,3943,2290,5522,2839,7739,686,3%
2011-06,אזור יהודה והשומרון,3760,אורנית,238,124,114,34,204,4,238,5,6%
2011-06,אזור יהודה והשומרון,3750,אלפי מנשה,104,43,61,29,75,4,103,6,3%
2011-06,אזור יהודה והשומרון,3560,אלקנה,39,18,21,23,16,2,39,6,2%
2011-06,אזור יהודה והשומרון,3650,אפרתה,61,33,28,26,35,9,61,1,2%
2011-06,אזור יהודה והשומרון,3570,אריאל,457,206,251,97,360,105,456,44,5%
2011-06,אזור יהודה והשומרון,3574,בית אל,57,28,29,14,43,15,56,5,3%
2011-06,אזור יהודה והשומרון,3652,בית אריה,76,30,46,11,65,5,76,6,4%
2011-06,אזור יהודה והשומרון,3780,ביתר עילית,424,199,225,17,407,226,420,18,5%
2011-06,אזור יהודה והשומרון,3730,גבעת זאב,218,111,107,31,187,47,217,14,4%
2011-06,אזור יהודה והשומרון,3769,הר אדר,43,24,19,15,28,1,43,0,2%
2011-06,אזור יהודה והשומרון,3797,מודיעין עילית,369,123,246,18,351,97,365,9,4%
2011-06,אזור יהודה והשומרון,3616,מעלה אדומים,656,280,376,92,564,224,646,56,4%
2011-06,אזור יהודה והשומרון,3660,עמנואל,90,43,47,5,85,55,90,2,10%
2011-06,אזור יהודה והשומרון,3557,קדומים,35,19,16,6,29,6,35,1,2%
2011-06,אזור יהודה והשומרון,3611,קריית ארבע,118,60,58,21,97,63,118,4,4%
2011-06,אזור יהודה והשומרון,3640,קרני שומרון,97,56,41,22,75,19,95,6,3%
2011-06,הדרום,31,אופקים,1450,637,813,99,1351,974,1438,49,13%
2011-06,הדרום,2600,אילת,1621,756,865,83,1538,646,1608,145,5%
2011-06,הדרום,70,אשדוד,7428,2988,4440,788,6640,4072,7377,541,7%
2011-06,הדרום,7100,אשקלון,4689,1860,2829,662,4027,2662,4596,405,8%
2011-06,הדרום,9000,באר שבע,8002,3513,4489,956,7046,4784,7939,1003,8%
2011-06,הדרום,2200,דימונה,2214,1004,1210,128,2086,1450,2192,211,12%
2011-06,הדרום,1303,חורה,715,308,407,0,715,664,714,15,24%
2011-06,הדרום,831,ירוחם,498,248,250,19,479,267,489,101,12%
2011-06,הדרום,1059,כסיפה,975,410,565,2,973,904,973,38,26%
2011-06,הדרום,1271,להבים,77,39,38,19,58,3,77,30,2%
2011-06,הדרום,1060,לקיה,887,391,496,5,882,832,886,10,28%
2011-06,הדרום,1268,מיתר,109,54,55,23,86,4,109,30,3%
2011-06,הדרום,99,מצפה רמון,279,116,163,16,263,124,268,64,12%
2011-06,הדרום,246,נתיבות,1214,511,703,52,1162,534,1208,163,10%
2011-06,הדרום,666,עומר,83,40,43,36,47,5,83,25,2%
2011-06,הדרום,2560,ערד,898,406,492,159,739,523,878,190,7%
2011-06,הדרום,1192,ערערה-בנגב,979,393,586,3,976,901,979,4,31%
2011-06,הדרום,2630,קריית גת,2348,962,1386,172,2176,1505,2342,124,9%
2011-06,הדרום,1034,קריית מלאכי,1374,633,741,26,1348,831,1349,219,12%
2011-06,הדרום,1161,רהט,2969,1188,1781,8,2961,2597,2967,90,21%
2011-06,הדרום,1286,שגב-שלום,467,189,278,0,467,417,467,148,24%
2011-06,הדרום,1031,שדרות,1234,514,720,51,1183,648,1232,150,11%
2011-06,הדרום,1054,תל שבע,1171,547,624,3,1168,1084,1171,41,30%
2011-06,המרכז,182,אבן יהודה,165,81,84,44,121,19,165,15,3%
2011-06,המרכז,41,אליכין,72,34,38,5,67,15,71,5,4%
2011-06,המרכז,1309,אלעד,349,173,176,19,330,118,348,20,3%
2011-06,המרכז,2530,באר יעקב,270,124,146,40,230,73,266,13,4%
2011-06,המרכז,466,בית דגן,174,80,94,18,156,35,174,11,5%
2011-06,המרכז,1066,"בני עי""ש",190,85,105,23,167,85,190,2,5%
2011-06,המרכז,681,גבעת שמואל,422,219,203,108,314,55,421,19,4%
2011-06,המרכז,2550,גדרה,387,178,209,60,327,104,384,7,4%
2011-06,המרכז,627,ג'לג'וליה,74,38,36,4,70,35,74,4,3%
2011-06,המרכז,166,גן יבנה,377,152,225,37,340,100,376,17,4%
2011-06,המרכז,229,גני תקווה,239,106,133,47,192,26,239,8,3%
2011-06,המרכז,9700,הוד השרון,690,361,329,200,490,58,688,40,3%
2011-06,המרכז,1290,זמר,157,52,105,7,150,122,157,9,7%
2011-06,המרכז,2730,טייבה,2135,899,1236,5,2130,1812,2123,30,14%
2011-06,המרכז,2720,טירה,326,167,159,9,317,194,324,19,4%
2011-06,המרכז,2660,יבנה,973,468,505,75,898,428,969,83,5%
2011-06,המרכז,9400,יהוד,631,270,361,88,543,73,611,49,4%
2011-06,המרכז,1224,כוכב יאיר,125,54,71,32,93,4,125,4,2%
2011-06,המרכז,633,כפר ברא,24,15,9,0,24,6,24,0,2%
2011-06,המרכז,168,כפר יונה,340,159,181,56,284,74,339,26,4%
2011-06,המרכז,6900,כפר סבא,1240,567,673,339,901,195,1229,87,3%
2011-06,המרכז,634,כפר קאסם,209,101,108,3,206,119,208,11,3%
2011-06,המרכז,7000,לוד,2469,1144,1325,178,2291,1246,2461,137,7%
2011-06,המרכז,1200,מודיעין-מכבים-רעות*,1298,593,705,365,933,74,1289,103,3%
2011-06,המרכז,28,מזכרת בתיה,154,64,90,33,121,36,154,4,3%
2011-06,המרכז,7200,נס ציונה,672,289,383,145,527,204,663,7,3%
2011-06,המרכז,7400,נתניה,5124,2424,2700,673,4451,1821,5079,419,5%
2011-06,המרכז,587,סביון*,17,10,7,4,13,1,17,0,1%
2011-06,המרכז,171,פרדסייה,84,30,54,12,72,10,84,7,2%
2011-06,המרכז,7900,פתח תקווה,5087,2318,2769,825,4262,1167,5049,282,5%
2011-06,המרכז,195,קדימה-צורן,294,140,154,66,228,40,294,19,3%
2011-06,המרכז,638,קלנסווה,914,360,554,1,913,764,909,18,13%
2011-06,המרכז,469,קריית עקרון,265,127,138,25,240,110,261,3,5%
2011-06,המרכז,2640,ראש העין,1001,512,489,92,909,174,992,71,5%
2011-06,המרכז,8300,ראשון לציון,5944,2623,3321,850,5094,1702,5926,365,5%
2011-06,המרכז,8400,רחובות,2582,1143,1439,529,2053,1044,2534,23,4%
2011-06,המרכז,8500,רמלה,2002,945,1057,117,1885,857,1961,165,6%
2011-06,המרכז,8700,רעננה,856,427,429,280,576,78,854,49,2%
2011-06,המרכז,1304,שוהם,295,157,138,62,233,6,295,19,3%
2011-06,המרכז,154,תל מונד,156,71,85,43,113,22,156,5,3%
2011-06,הצפון,473,אבו סנאן,715,267,448,4,711,611,711,17,15%
2011-06,הצפון,478,אכסאל,536,214,322,9,527,478,535,17,12%
2011-06,הצפון,529,אעבלין,605,240,365,12,593,517,605,17,13%
2011-06,הצפון,482,בועיינה-נוג'ידאת,484,197,287,4,480,398,480,18,15%
2011-06,הצפון,4001,בוקעאתא,368,145,223,6,362,318,359,11,16%
2011-06,הצפון,998,ביר אל-מכסור,432,162,270,3,429,325,432,14,14%
2011-06,הצפון,480,בית ג'ן,328,90,238,1,327,244,324,10,8%
2011-06,הצפון,9200,בית שאן,912,376,536,23,889,453,909,125,10%
2011-06,הצפון,944,בסמת טבעון,246,97,149,3,243,195,245,9,9%
2011-06,הצפון,483,בענה,458,181,277,4,454,392,458,8,16%
2011-06,הצפון,1292,ג'דיידה-מכר,1490,641,849,5,1485,1274,1489,37,19%
2011-06,הצפון,485,ג'ולס,200,61,139,1,199,148,199,10,8%
2011-06,הצפון,487,ג'ש (גוש חלב),58,29,29,3,55,30,57,2,4%
2011-06,הצפון,489,דבורייה,429,191,238,16,413,318,428,4,12%
2011-06,הצפון,490,דייר אל-אסד,428,186,242,3,425,338,428,11,10%
2011-06,הצפון,492,דייר חנא,647,285,362,7,640,507,647,26,17%
2011-06,הצפון,975,זרזיר,299,122,177,6,293,208,291,17,12%
2011-06,הצפון,496,חורפיש,166,59,107,7,159,99,165,9,8%
2011-06,הצפון,2034,חצור הגלילית,313,144,169,6,307,131,308,40,7%
2011-06,הצפון,6700,טבריה,1948,847,1101,122,1826,1221,1834,140,9%
2011-06,הצפון,962,טובא-זנגרייה,369,151,218,3,366,247,366,15,14%
2011-06,הצפון,498,טורעאן,507,195,312,5,502,448,504,14,11%
2011-06,הצפון,8900,טמרה,1963,823,1140,25,1938,1715,1957,61,17%
2011-06,הצפון,1295,יאנוח-ג'ת,173,60,113,2,171,116,173,12,8%
2011-06,הצפון,46,יבנאל,129,78,51,6,123,100,120,5,9%
2011-06,הצפון,499,יפיע,622,266,356,9,613,483,620,25,10%
2011-06,הצפון,240,יקנעם עילית,562,247,315,86,476,214,562,56,6%
2011-06,הצפון,502,ירכא,487,202,285,1,486,391,487,11,11%
2011-06,הצפון,504,כאבול,690,279,411,7,683,604,689,14,17%
2011-06,הצפון,505,כאוכב אבו אל-היג'א,219,91,128,5,214,178,219,8,15%
2011-06,הצפון,1296,כסרא-סמיע,214,78,136,1,213,157,214,16,8%
2011-06,הצפון,978,כעביה-טבאש-חג'אג'רה,187,77,110,2,185,141,185,8,10%
2011-06,הצפון,1263,כפר ורדים,115,55,60,35,80,7,115,47,4%
2011-06,הצפון,507,כפר יאסיף,494,216,278,4,490,383,494,21,12%
2011-06,הצפון,508,כפר כמא,74,31,43,4,70,41,71,3,5%
2011-06,הצפון,509,כפר כנא,1139,454,685,18,1121,978,1130,41,16%
2011-06,הצפון,510,כפר מנדא,1005,458,547,12,993,742,997,41,17%
2011-06,הצפון,47,כפר תבור,57,22,35,13,44,2,56,1,3%
2011-06,הצפון,1139,כרמיאל,1936,798,1138,352,1584,922,1880,126,8%
2011-06,הצפון,481,מגאר,1479,582,897,29,1450,1282,1474,77,20%
2011-06,הצפון,516,מג'ד אל-כרום,628,264,364,10,618,503,628,26,12%
2011-06,הצפון,874,מגדל העמק,1087,482,605,77,1010,450,1037,136,8%
2011-06,הצפון,4201,מג'דל שמס,478,182,296,20,458,396,474,5,12%
2011-06,הצפון,517,מזרעה,188,73,115,2,186,146,187,15,12%
2011-06,הצפון,4203,מסעדה,210,78,132,3,207,177,209,4,14%
2011-06,הצפון,518,מעיליא,37,20,17,3,34,21,37,3,3%
2011-06,הצפון,1063,מעלות-תרשיחא,927,417,510,111,816,566,924,78,8%
2011-06,הצפון,520,משהד,318,117,201,1,317,265,314,10,12%
2011-06,הצפון,9100,נהרייה,2135,954,1181,234,1901,1272,2127,160,8%
2011-06,הצפון,522,נחף,445,199,246,9,436,363,444,12,11%
2011-06,הצפון,7300,נצרת,3017,1352,1665,75,2942,2260,3003,108,10%
2011-06,הצפון,1061,נצרת עילית,2142,954,1188,261,1881,1127,2043,206,9%
2011-06,הצפון,525,סאג'ור,133,54,79,1,132,94,131,4,9%
2011-06,הצפון,7500,סח'נין,1990,905,1085,35,1955,1704,1990,69,17%
2011-06,הצפון,4501,ע'ג'ר,86,32,54,2,84,64,86,1,10%
2011-06,הצפון,530,עיילבון,193,84,109,5,188,146,193,15,9%
2011-06,הצפון,511,עילוט,333,142,191,8,325,257,332,6,14%
2011-06,הצפון,532,עין מאהל,577,255,322,12,565,498,570,13,14%
2011-06,הצפון,7600,עכו,3308,1525,1783,137,3171,2516,3291,175,14%
2011-06,הצפון,7700,עפולה,1887,796,1091,189,1698,907,1819,168,8%
2011-06,הצפון,531,עראבה,1345,538,807,22,1323,1179,1344,34,17%
2011-06,הצפון,535,פסוטה,132,53,79,8,124,91,132,6,9%
2011-06,הצפון,536,פקיעין (בוקייעה),129,68,61,3,126,92,128,2,6%
2011-06,הצפון,8000,צפת,1070,528,542,78,992,735,1060,100,9%
2011-06,הצפון,4100,קצרין,234,107,127,39,195,95,233,68,6%
2011-06,הצפון,2800,קריית שמונה,855,400,455,54,801,302,831,93,7%
2011-06,הצפון,543,ראמה,317,133,184,8,309,240,316,3,10%
2011-06,הצפון,26,ראש פינה,70,30,40,7,63,23,70,12,5%
2011-06,הצפון,542,ריינה,597,246,351,7,590,489,592,19,11%
2011-06,הצפון,122,רמת ישי,114,44,70,26,88,8,113,12,3%
2011-06,הצפון,913,שבלי - אום אל-גנם,238,109,129,5,233,187,237,7,11%
2011-06,הצפון,812,שלומי,284,122,162,14,270,169,279,34,8%
2011-06,הצפון,538,שעב,477,203,274,1,476,412,476,13,19%
2011-06,הצפון,8800,שפרעם,1971,789,1182,28,1943,1603,1968,83,13%
2011-06,חיפה,2710,אום אל-פחם,3581,1466,2115,9,3572,3089,3578,56,21%
2011-06,חיפה,1020,אור עקיבא,626,250,376,44,582,241,611,82,7%
2011-06,חיפה,6000,באקה אל-גרביה,691,347,344,7,684,416,691,54,NULL
2011-06,חיפה,9800,בנימינה-גבעת עדה*,240,106,134,68,172,52,240,27,4%
2011-06,חיפה,1326,"בסמ""ה",392,172,220,3,389,311,392,17,12%
2011-06,חיפה,541,ג'סר א-זרקא,452,262,190,0,452,284,450,10,9%
2011-06,חיפה,628,ג'ת,218,104,114,5,213,127,217,12,NULL
2011-06,חיפה,494,דאלית אל-כרמל,453,187,266,8,445,290,448,41,7%
2011-06,חיפה,9300,זכרון יעקב,307,160,147,79,228,51,305,14,3%
2011-06,חיפה,6500,חדרה,2732,1125,1607,272,2460,953,2698,261,6%
2011-06,חיפה,4000,חיפה,8083,3561,4522,1422,6661,4929,8038,632,6%
2011-06,חיפה,1247,חריש-קציר,21,8,13,2,19,7,21,3,1%
2011-06,חיפה,2100,טירת כרמל,841,404,437,37,804,494,836,75,9%
2011-06,חיפה,654,כפר קרע,364,169,195,3,361,229,362,10,5%
2011-06,חיפה,1327,מעלה עירון,877,350,527,2,875,725,877,12,18%
2011-06,חיפה,2500,נשר,599,286,313,93,506,272,597,47,5%
2011-06,חיפה,534,עספיא,330,146,184,7,323,201,330,20,7%
2011-06,חיפה,637,ערערה,556,218,338,7,549,379,555,39,8%
2011-06,חיפה,537,פוריידיס,375,192,183,5,370,250,374,18,8%
2011-06,חיפה,7800,פרדס חנה-כרכור,911,404,507,136,775,289,904,96,5%
2011-06,חיפה,6800,קריית אתא,1987,846,1141,143,1844,1165,1978,107,7%
2011-06,חיפה,9500,קריית ביאליק,1292,530,762,155,1137,678,1286,84,6%
2011-06,חיפה,2300,קריית טבעון,254,115,139,61,193,50,253,18,3%
2011-06,חיפה,9600,קריית ים,1732,771,961,160,1572,1150,1726,104,9%
2011-06,חיפה,8200,קריית מוצקין,1238,505,733,177,1061,641,1230,99,6%
2011-06,חיפה,922,רכסים,148,70,78,5,143,95,147,7,5%
2011-06,ירושלים,472,אבו גוש,247,115,132,3,244,186,247,3,10%
2011-06,ירושלים,2610,בית שמש,1333,581,752,102,1231,544,1323,142,5%
2011-06,ירושלים,3000,ירושלים,10498,4628,5870,1153,9345,5984,10426,667,4%
2011-06,ירושלים,1015,מבשרת ציון,422,206,216,73,349,167,421,31,4%
2011-06,ירושלים,1137,קריית יערים,34,12,22,2,32,14,34,4,3%
2011-06,תל אביב,2400,אור יהודה,911,426,485,41,870,299,901,71,5%
2011-06,תל אביב,565,אזור,217,107,110,17,200,41,216,19,4%
2011-06,תל אביב,6100,בני ברק,2235,1082,1153,124,2111,1360,2222,125,5%
2011-06,תל אביב,6200,בת ים,3932,1812,2120,460,3472,1477,3885,295,6%
2011-06,תל אביב,6300,גבעתיים,797,331,466,278,519,115,790,76,3%
2011-06,תל אביב,6400,הרצלייה,1504,735,769,285,1219,100,1483,377,3%
2011-06,תל אביב,6600,חולון,3706,1734,1972,475,3231,973,3668,294,4%
2011-06,תל אביב,2620,קריית אונו,519,249,270,127,392,46,517,32,3%
2011-06,תל אביב,8600,רמת גן,2296,1028,1268,623,1673,500,2283,170,3%
2011-06,תל אביב,2650,רמת השרון,639,307,332,138,501,23,637,195,3%
2011-06,תל אביב,5000,תל אביב -יפו,8231,4102,4129,2205,6026,2797,8162,673,4%
2011-07,אזור יהודה והשומרון,3760,אורנית,98,50,48,33,65,5,98,7,3%
2011-07,אזור יהודה והשומרון,3750,אלפי מנשה,137,66,71,24,113,3,137,6,3%
2011-07,אזור יהודה והשומרון,3560,אלקנה,48,25,23,22,26,2,48,1,3%
2011-07,אזור יהודה והשומרון,3650,אפרתה,71,38,33,27,44,10,71,1,2%
2011-07,אזור יהודה והשומרון,3570,אריאל,421,201,220,101,320,103,420,34,4%
2011-07,אזור יהודה והשומרון,3574,בית אל,67,39,28,14,53,15,65,1,3%
2011-07,אזור יהודה והשומרון,3652,בית אריה,73,31,42,12,61,6,73,8,3%
2011-07,אזור יהודה והשומרון,3780,ביתר עילית,533,243,290,16,517,235,526,31,6%
2011-07,אזור יהודה והשומרון,3730,גבעת זאב,227,109,118,31,196,51,227,23,4%
2011-07,אזור יהודה והשומרון,3769,הר אדר,37,16,21,15,22,1,37,2,2%
2011-07,אזור יהודה והשומרון,3797,מודיעין עילית,581,138,443,27,554,93,578,14,5%
2011-07,אזור יהודה והשומרון,3616,מעלה אדומים,678,291,387,98,580,226,674,59,4%
2011-07,אזור יהודה והשומרון,3660,עמנואל,107,56,51,5,102,58,107,5,11%
2011-07,אזור יהודה והשומרון,3557,קדומים,107,56,51,7,100,6,106,6,6%
2011-07,אזור יהודה והשומרון,3611,קריית ארבע,137,72,65,22,115,66,137,5,5%
2011-07,אזור יהודה והשומרון,3640,קרני שומרון,89,50,39,19,70,18,88,1,3%
2011-07,הדרום,31,אופקים,1524,629,895,106,1418,986,1513,52,13%
2011-07,הדרום,2600,אילת,1451,636,815,84,1367,618,1437,92,5%
2011-07,הדרום,70,אשדוד,7704,3019,4685,839,6865,4062,7643,458,8%
2011-07,הדרום,7100,אשקלון,4713,1839,2874,679,4034,2669,4608,358,8%
2011-07,הדרום,9000,באר שבע,8098,3443,4655,991,7107,4866,8039,928,9%
2011-07,הדרום,2200,דימונה,2278,1001,1277,140,2138,1490,2254,123,13%
2011-07,הדרום,1303,חורה,747,322,425,0,747,677,746,17,24%
2011-07,הדרום,831,ירוחם,519,248,271,24,495,270,508,90,12%
2011-07,הדרום,1059,כסיפה,992,416,576,4,988,897,991,16,26%
2011-07,הדרום,1271,להבים,84,41,43,24,60,5,83,33,3%
2011-07,הדרום,1060,לקיה,916,402,514,5,911,841,915,17,29%
2011-07,הדרום,1268,מיתר,117,52,65,25,92,7,117,46,3%
2011-07,הדרום,99,מצפה רמון,252,103,149,15,237,125,241,40,11%
2011-07,הדרום,246,נתיבות,1156,466,690,67,1089,543,1147,71,10%
2011-07,הדרום,666,עומר,77,30,47,34,43,8,77,18,2%
2011-07,הדרום,2560,ערד,945,421,524,180,765,525,914,113,7%
2011-07,הדרום,1192,ערערה-בנגב,956,382,574,4,952,893,955,20,30%
2011-07,הדרום,2630,קריית גת,2463,990,1473,190,2273,1518,2458,104,10%
2011-07,הדרום,1034,קריית מלאכי,1371,641,730,29,1342,825,1346,170,12%
2011-07,הדרום,1161,רהט,3002,1128,1874,9,2993,2584,3000,117,21%
2011-07,הדרום,1286,שגב-שלום,480,180,300,0,480,433,479,114,24%
2011-07,הדרום,1031,שדרות,1159,483,676,59,1100,641,1156,72,10%
2011-07,הדרום,1054,תל שבע,1207,571,636,3,1204,1102,1207,64,31%
2011-07,המרכז,182,אבן יהודה,142,70,72,44,98,18,142,19,2%
2011-07,המרכז,41,אליכין,65,28,37,6,59,15,64,6,4%
2011-07,המרכז,1309,אלעד,402,179,223,18,384,120,400,18,4%
2011-07,המרכז,2530,באר יעקב,272,118,154,41,231,77,267,22,4%
2011-07,המרכז,466,בית דגן,140,72,68,15,125,30,140,36,4%
2011-07,המרכז,1066,"בני עי""ש",191,85,106,27,164,85,188,2,5%
2011-07,המרכז,681,גבעת שמואל,313,165,148,111,202,53,313,17,3%
2011-07,המרכז,2550,גדרה,386,178,208,75,311,106,382,6,4%
2011-07,המרכז,627,ג'לג'וליה,84,42,42,3,81,40,84,5,3%
2011-07,המרכז,166,גן יבנה,439,164,275,48,391,103,436,19,4%
2011-07,המרכז,229,גני תקווה,204,89,115,48,156,24,203,8,3%
2011-07,המרכז,9700,הוד השרון,752,388,364,217,535,57,746,27,3%
2011-07,המרכז,1290,זמר,152,45,107,7,145,120,152,6,6%
2011-07,המרכז,2730,טייבה,2157,900,1257,4,2153,1826,2145,40,15%
2011-07,המרכז,2720,טירה,343,170,173,11,332,194,343,12,4%
2011-07,המרכז,2660,יבנה,983,479,504,86,897,422,977,100,5%
2011-07,המרכז,9400,יהוד,639,280,359,90,549,76,617,41,4%
2011-07,המרכז,1224,כוכב יאיר,193,94,99,41,152,4,193,2,4%
2011-07,המרכז,633,כפר ברא,25,13,12,0,25,7,25,2,2%
2011-07,המרכז,168,כפר יונה,366,158,208,67,299,75,364,25,4%
2011-07,המרכז,6900,כפר סבא,1435,643,792,338,1097,194,1423,76,3%
2011-07,המרכז,634,כפר קאסם,250,110,140,9,241,113,250,9,4%
2011-07,המרכז,7000,לוד,2395,1024,1371,194,2201,1314,2382,114,7%
2011-07,המרכז,1200,מודיעין-מכבים-רעות*,1103,480,623,371,732,79,1090,64,3%
2011-07,המרכז,28,מזכרת בתיה,174,68,106,48,126,41,172,1,3%
2011-07,המרכז,7200,נס ציונה,693,301,392,159,534,199,687,2,3%
2011-07,המרכז,7400,נתניה,5214,2291,2923,746,4468,1907,5171,392,6%
2011-07,המרכז,587,סביון*,18,10,8,6,12,0,18,1,1%
2011-07,המרכז,171,פרדסייה,103,40,63,16,87,9,102,6,3%
2011-07,המרכז,7900,פתח תקווה,4584,2041,2543,870,3714,1160,4542,320,4%
2011-07,המרכז,195,קדימה-צורן,286,125,161,66,220,41,285,11,3%
2011-07,המרכז,638,קלנסווה,961,358,603,3,958,780,957,15,13%
2011-07,המרכז,469,קריית עקרון,281,130,151,21,260,116,279,1,5%
2011-07,המרכז,2640,ראש העין,934,444,490,93,841,171,925,77,5%
2011-07,המרכז,8300,ראשון לציון,5026,2203,2823,898,4128,1674,5000,334,4%
2011-07,המרכז,8400,רחובות,2748,1147,1601,547,2201,1050,2696,17,5%
2011-07,המרכז,8500,רמלה,1928,894,1034,121,1807,850,1884,110,6%
2011-07,המרכז,8700,רעננה,1020,500,520,300,720,87,1014,36,3%
2011-07,המרכז,1304,שוהם,196,84,112,59,137,10,196,14,2%
2011-07,המרכז,154,תל מונד,145,64,81,49,96,23,145,9,3%
2011-07,הצפון,473,אבו סנאן,734,276,458,5,729,613,730,18,15%
2011-07,הצפון,478,אכסאל,541,215,326,11,530,481,541,12,12%
2011-07,הצפון,529,אעבלין,615,241,374,12,603,511,615,18,13%
2011-07,הצפון,482,בועיינה-נוג'ידאת,494,211,283,6,488,406,490,7,16%
2011-07,הצפון,4001,בוקעאתא,356,135,221,8,348,312,347,8,15%
2011-07,הצפון,998,ביר אל-מכסור,436,161,275,8,428,335,436,6,15%
2011-07,הצפון,480,בית ג'ן,334,90,244,3,331,248,331,10,8%
2011-07,הצפון,9200,בית שאן,934,370,564,21,913,458,932,91,10%
2011-07,הצפון,944,בסמת טבעון,247,98,149,5,242,202,246,10,9%
2011-07,הצפון,483,בענה,469,175,294,4,465,390,469,17,17%
2011-07,הצפון,1292,ג'דיידה-מכר,1513,644,869,8,1505,1268,1512,35,20%
2011-07,הצפון,485,ג'ולס,222,65,157,3,219,151,221,4,9%
2011-07,הצפון,487,ג'ש (גוש חלב),63,31,32,2,61,28,62,11,4%
2011-07,הצפון,489,דבורייה,428,190,238,16,412,319,427,6,12%
2011-07,הצפון,490,דייר אל-אסד,424,172,252,6,418,332,424,21,10%
2011-07,הצפון,492,דייר חנא,637,268,369,6,631,509,636,13,16%
2011-07,הצפון,975,זרזיר,294,116,178,4,290,204,288,13,12%
2011-07,הצפון,496,חורפיש,186,76,110,7,179,93,186,29,9%
2011-07,הצפון,2034,חצור הגלילית,302,115,187,9,293,123,297,38,7%
2011-07,הצפון,6700,טבריה,1965,810,1155,119,1846,1217,1848,108,9%
2011-07,הצפון,962,טובא-זנגרייה,362,149,213,3,359,244,359,12,14%
2011-07,הצפון,498,טורעאן,534,185,349,10,524,431,532,13,12%
2011-07,הצפון,8900,טמרה,2014,826,1188,35,1979,1710,2009,50,17%
2011-07,הצפון,1295,יאנוח-ג'ת,199,70,129,5,194,125,199,17,9%
2011-07,הצפון,46,יבנאל,154,97,57,9,145,111,143,8,11%
2011-07,הצפון,499,יפיע,635,259,376,13,622,489,632,12,10%
2011-07,הצפון,240,יקנעם עילית,577,254,323,93,484,224,577,61,6%
2011-07,הצפון,502,ירכא,522,216,306,2,520,412,522,12,12%
2011-07,הצפון,504,כאבול,694,271,423,13,681,596,692,21,17%
2011-07,הצפון,505,כאוכב אבו אל-היג'א,221,89,132,7,214,180,221,10,16%
2011-07,הצפון,1296,כסרא-סמיע,259,95,164,3,256,190,258,12,10%
2011-07,הצפון,978,כעביה-טבאש-חג'אג'רה,195,81,114,2,193,145,193,5,10%
2011-07,הצפון,1263,כפר ורדים,102,41,61,37,65,7,102,22,3%
2011-07,הצפון,507,כפר יאסיף,490,203,287,3,487,388,490,15,12%
2011-07,הצפון,508,כפר כמא,71,25,46,3,68,41,69,2,5%
2011-07,הצפון,509,כפר כנא,1177,440,737,25,1152,987,1170,44,16%
2011-07,הצפון,510,כפר מנדא,1007,453,554,14,993,744,999,28,17%
2011-07,הצפון,47,כפר תבור,65,24,41,13,52,4,64,2,4%
2011-07,הצפון,1139,כרמיאל,1903,747,1156,358,1545,935,1849,116,7%
2011-07,הצפון,481,מגאר,1481,564,917,35,1446,1266,1478,73,20%
2011-07,הצפון,516,מג'ד אל-כרום,639,256,383,7,632,498,639,28,12%
2011-07,הצפון,874,מגדל העמק,1102,491,611,77,1025,468,1051,131,8%
2011-07,הצפון,4201,מג'דל שמס,454,166,288,19,435,383,452,11,12%
2011-07,הצפון,517,מזרעה,194,81,113,2,192,146,193,21,12%
2011-07,הצפון,4203,מסעדה,196,69,127,2,194,171,195,8,13%
2011-07,הצפון,518,מעיליא,37,16,21,2,35,20,37,6,3%
2011-07,הצפון,1063,מעלות-תרשיחא,1053,434,619,122,931,613,1049,98,9%
2011-07,הצפון,520,משהד,320,115,205,1,319,264,316,11,12%
2011-07,הצפון,9100,נהרייה,2140,982,1158,237,1903,1264,2127,120,8%
2011-07,הצפון,522,נחף,457,200,257,11,446,357,456,12,11%
2011-07,הצפון,7300,נצרת,3009,1305,1704,91,2918,2251,2993,97,10%
2011-07,הצפון,1061,נצרת עילית,2100,924,1176,282,1818,1150,2002,171,9%
2011-07,הצפון,525,סאג'ור,135,55,80,1,134,94,133,2,9%
2011-07,הצפון,7500,סח'נין,1999,880,1119,39,1960,1700,1999,59,17%
2011-07,הצפון,4501,ע'ג'ר,86,33,53,2,84,65,86,2,10%
2011-07,הצפון,530,עיילבון,187,80,107,4,183,141,186,12,9%
2011-07,הצפון,511,עילוט,335,130,205,7,328,257,335,5,14%
2011-07,הצפון,532,עין מאהל,578,252,326,9,569,503,569,10,14%
2011-07,הצפון,7600,עכו,3443,1545,1898,152,3291,2567,3417,163,14%
2011-07,הצפון,7700,עפולה,2030,838,1192,210,1820,948,1964,185,9%
2011-07,הצפון,531,עראבה,1378,549,829,33,1345,1174,1377,30,17%
2011-07,הצפון,535,פסוטה,149,59,90,8,141,94,149,7,10%
2011-07,הצפון,536,פקיעין (בוקייעה),138,71,67,5,133,95,137,1,6%
2011-07,הצפון,8000,צפת,1128,563,565,80,1048,719,1121,99,10%
2011-07,הצפון,4100,קצרין,229,103,126,38,191,101,228,23,6%
2011-07,הצפון,2800,קריית שמונה,868,416,452,68,800,307,854,106,7%
2011-07,הצפון,543,ראמה,334,151,183,6,328,244,332,10,10%
2011-07,הצפון,26,ראש פינה,67,27,40,9,58,23,67,5,5%
2011-07,הצפון,542,ריינה,629,255,374,15,614,496,623,18,11%
2011-07,הצפון,122,רמת ישי,110,47,63,29,81,8,110,4,3%
2011-07,הצפון,913,שבלי - אום אל-גנם,233,99,134,6,227,181,232,1,11%
2011-07,הצפון,812,שלומי,303,130,173,14,289,165,299,36,9%
2011-07,הצפון,538,שעב,460,192,268,1,459,409,459,8,18%
2011-07,הצפון,8800,שפרעם,1952,753,1199,39,1913,1592,1948,72,13%
2011-07,חיפה,2710,אום אל-פחם,3720,1550,2170,10,3710,3092,3717,65,22%
2011-07,חיפה,1020,אור עקיבא,612,254,358,47,565,227,597,76,7%
2011-07,חיפה,6000,באקה אל-גרביה,701,340,361,10,691,445,701,46,NULL
2011-07,חיפה,9800,בנימינה-גבעת עדה*,220,97,123,63,157,49,220,12,4%
2011-07,חיפה,1326,"בסמ""ה",410,179,231,3,407,325,410,10,13%
2011-07,חיפה,541,ג'סר א-זרקא,465,269,196,0,465,280,463,16,9%
2011-07,חיפה,628,ג'ת,204,90,114,5,199,126,203,17,NULL
2011-07,חיפה,494,דאלית אל-כרמל,499,191,308,10,489,295,495,43,7%
2011-07,חיפה,9300,זכרון יעקב,275,127,148,77,198,48,272,20,3%
2011-07,חיפה,6500,חדרה,2589,1041,1548,276,2313,919,2552,220,6%
2011-07,חיפה,4000,חיפה,7854,3522,4332,1434,6420,4841,7814,589,6%
2011-07,חיפה,1247,חריש-קציר,23,11,12,1,22,7,23,2,1%
2011-07,חיפה,2100,טירת כרמל,782,358,424,39,743,482,776,76,8%
2011-07,חיפה,654,כפר קרע,380,166,214,4,376,226,378,15,6%
2011-07,חיפה,1327,מעלה עירון,888,357,531,1,887,731,888,16,19%
2011-07,חיפה,2500,נשר,590,273,317,108,482,267,587,54,5%
2011-07,חיפה,534,עספיא,410,173,237,8,402,200,410,69,9%
2011-07,חיפה,637,ערערה,569,218,351,8,561,383,568,31,9%
2011-07,חיפה,537,פוריידיס,425,194,231,9,416,255,424,23,9%
2011-07,חיפה,7800,פרדס חנה-כרכור,949,418,531,138,811,285,942,101,6%
2011-07,חיפה,6800,קריית אתא,2045,835,1210,149,1896,1169,2038,134,8%
2011-07,חיפה,9500,קריית ביאליק,1300,548,752,159,1141,668,1293,75,6%
2011-07,חיפה,2300,קריית טבעון,204,99,105,67,137,46,202,11,3%
2011-07,חיפה,9600,קריית ים,1750,781,969,162,1588,1142,1743,111,9%
2011-07,חיפה,8200,קריית מוצקין,1238,503,735,177,1061,634,1232,73,6%
2011-07,חיפה,922,רכסים,184,77,107,8,176,102,183,7,7%
2011-07,ירושלים,472,אבו גוש,255,128,127,6,249,185,255,6,11%
2011-07,ירושלים,2610,בית שמש,1583,632,951,120,1463,574,1575,182,6%
2011-07,ירושלים,3000,ירושלים,11220,4857,6363,1233,9987,6117,11147,634,4%
2011-07,ירושלים,1015,מבשרת ציון,412,197,215,74,338,164,411,27,4%
2011-07,ירושלים,1137,קריית יערים,32,11,21,3,29,12,32,1,3%
2011-07,תל אביב,2400,אור יהודה,899,390,509,39,860,287,890,109,5%
2011-07,תל אביב,565,אזור,219,109,110,21,198,42,216,19,4%
2011-07,תל אביב,6100,בני ברק,2580,1097,1483,137,2443,1378,2563,88,6%
2011-07,תל אביב,6200,בת ים,3599,1640,1959,472,3127,1470,3543,260,5%
2011-07,תל אביב,6300,גבעתיים,760,317,443,285,475,112,755,56,3%
2011-07,תל אביב,6400,הרצלייה,1229,559,670,314,915,93,1206,275,3%
2011-07,תל אביב,6600,חולון,3315,1481,1834,491,2824,969,3272,264,4%
2011-07,תל אביב,2620,קריית אונו,443,188,255,138,305,48,441,22,3%
2011-07,תל אביב,8600,רמת גן,2219,1010,1209,638,1581,506,2200,140,3%
2011-07,תל אביב,2650,רמת השרון,451,196,255,137,314,25,448,109,2%
2011-07,תל אביב,5000,תל אביב -יפו,8069,3965,4104,2296,5773,2769,7999,557,3%
2011-08,אזור יהודה והשומרון,3760,אורנית,99,46,53,37,62,5,98,3,3%
2011-08,אזור יהודה והשומרון,3750,אלפי מנשה,98,47,51,26,72,0,98,5,2%
2011-08,אזור יהודה והשומרון,3560,אלקנה,37,16,21,22,15,2,36,0,2%
2011-08,אזור יהודה והשומרון,3650,אפרתה,62,32,30,29,33,11,62,2,2%
2011-08,אזור יהודה והשומרון,3570,אריאל,423,201,222,103,320,101,422,50,4%
2011-08,אזור יהודה והשומרון,3574,בית אל,58,34,24,11,47,14,57,2,3%
2011-08,אזור יהודה והשומרון,3652,בית אריה,57,21,36,9,48,5,57,3,3%
2011-08,אזור יהודה והשומרון,3780,ביתר עילית,548,213,335,14,534,220,544,16,6%
2011-08,אזור יהודה והשומרון,3730,גבעת זאב,204,98,106,26,178,50,204,12,3%
2011-08,אזור יהודה והשומרון,3769,הר אדר,39,19,20,17,22,1,38,3,2%
2011-08,אזור יהודה והשומרון,3797,מודיעין עילית,709,148,561,25,684,100,704,40,7%
2011-08,אזור יהודה והשומרון,3616,מעלה אדומים,742,298,444,94,648,223,731,73,4%
2011-08,אזור יהודה והשומרון,3660,עמנואל,92,43,49,4,88,58,92,1,10%
2011-08,אזור יהודה והשומרון,3557,קדומים,38,15,23,8,30,7,38,1,2%
2011-08,אזור יהודה והשומרון,3611,קריית ארבע,130,65,65,22,108,66,130,8,5%
2011-08,אזור יהודה והשומרון,3640,קרני שומרון,71,40,31,19,52,19,70,2,2%
2011-08,הדרום,31,אופקים,1535,627,908,108,1427,1006,1529,63,13%
2011-08,הדרום,2600,אילת,1388,592,796,85,1303,619,1372,105,4%
2011-08,הדרום,70,אשדוד,7567,2905,4662,874,6693,4095,7501,523,7%
2011-08,הדרום,7100,אשקלון,4613,1788,2825,700,3913,2679,4498,247,8%
2011-08,הדרום,9000,באר שבע,7695,3236,4459,1006,6689,4877,7638,660,8%
2011-08,הדרום,2200,דימונה,2248,946,1302,141,2107,1479,2208,98,13%
2011-08,הדרום,1303,חורה,734,310,424,0,734,677,733,9,24%
2011-08,הדרום,831,ירוחם,485,238,247,23,462,281,476,49,11%
2011-08,הדרום,1059,כסיפה,995,410,585,5,990,904,994,12,27%
2011-08,הדרום,1271,להבים,60,30,30,25,35,5,60,20,2%
2011-08,הדרום,1060,לקיה,928,405,523,6,922,846,925,18,29%
2011-08,הדרום,1268,מיתר,89,35,54,28,61,7,88,26,2%
2011-08,הדרום,99,מצפה רמון,242,80,162,16,226,123,230,33,10%
2011-08,הדרום,246,נתיבות,1153,437,716,69,1084,561,1142,98,10%
2011-08,הדרום,666,עומר,59,21,38,25,34,7,59,16,2%
2011-08,הדרום,2560,ערד,936,399,537,174,762,523,916,126,7%
2011-08,הדרום,1192,ערערה-בנגב,958,382,576,5,953,899,957,10,30%
2011-08,הדרום,2630,קריית גת,2447,991,1456,196,2251,1545,2441,110,10%
2011-08,הדרום,1034,קריית מלאכי,1314,603,711,34,1280,832,1291,143,12%
2011-08,הדרום,1161,רהט,2983,1153,1830,11,2972,2601,2981,142,21%
2011-08,הדרום,1286,שגב-שלום,457,156,301,0,457,424,456,32,23%
2011-08,הדרום,1031,שדרות,1129,449,680,63,1066,654,1125,48,10%
2011-08,הדרום,1054,תל שבע,1184,547,637,3,1181,1094,1184,28,31%
2011-08,המרכז,182,אבן יהודה,123,62,61,42,81,17,123,13,2%
2011-08,המרכז,41,אליכין,67,29,38,6,61,17,66,5,4%
2011-08,המרכז,1309,אלעד,537,185,352,18,519,113,535,134,5%
2011-08,המרכז,2530,באר יעקב,250,114,136,40,210,75,245,20,4%
2011-08,המרכז,466,בית דגן,105,51,54,14,91,34,104,8,3%
2011-08,המרכז,1066,"בני עי""ש",192,82,110,25,167,80,188,3,5%
2011-08,המרכז,681,גבעת שמואל,263,144,119,99,164,54,261,11,3%
2011-08,המרכז,2550,גדרה,370,146,224,71,299,103,365,4,4%
2011-08,המרכז,627,ג'לג'וליה,67,30,37,3,64,34,67,4,2%
2011-08,המרכז,166,גן יבנה,367,121,246,53,314,102,363,23,4%
2011-08,המרכז,229,גני תקווה,199,81,118,53,146,28,199,11,3%
2011-08,המרכז,9700,הוד השרון,797,386,411,231,566,57,793,32,3%
2011-08,המרכז,1290,זמר,155,47,108,7,148,124,155,2,6%
2011-08,המרכז,2730,טייבה,2133,882,1251,4,2129,1840,2121,50,14%
2011-08,המרכז,2720,טירה,318,154,164,14,304,194,318,8,4%
2011-08,המרכז,2660,יבנה,974,469,505,93,881,424,971,90,5%
2011-08,המרכז,9400,יהוד,580,255,325,89,491,84,560,43,4%
2011-08,המרכז,1224,כוכב יאיר,130,62,68,43,87,5,130,2,2%
2011-08,המרכז,633,כפר ברא,24,13,11,0,24,9,24,3,2%
2011-08,המרכז,168,כפר יונה,351,143,208,71,280,78,347,36,4%
2011-08,המרכז,6900,כפר סבא,1356,596,760,364,992,206,1340,74,3%
2011-08,המרכז,634,כפר קאסם,234,95,139,8,226,117,234,8,4%
2011-08,המרכז,7000,לוד,2352,986,1366,200,2152,1282,2337,146,7%
2011-08,המרכז,1200,מודיעין-מכבים-רעות*,1064,420,644,376,688,73,1045,94,3%
2011-08,המרכז,28,מזכרת בתיה,178,65,113,47,131,45,176,0,3%
2011-08,המרכז,7200,נס ציונה,684,280,404,154,530,192,678,4,3%
2011-08,המרכז,7400,נתניה,5005,2154,2851,732,4273,1881,4965,478,5%
2011-08,המרכז,587,סביון*,15,7,8,8,7,0,15,3,1%
2011-08,המרכז,171,פרדסייה,95,40,55,16,79,10,94,5,3%
2011-08,המרכז,7900,פתח תקווה,4301,1794,2507,890,3411,1146,4262,262,4%
2011-08,המרכז,195,קדימה-צורן,244,112,132,64,180,44,243,25,3%
2011-08,המרכז,638,קלנסווה,937,334,603,2,935,770,934,8,13%
2011-08,המרכז,469,קריית עקרון,286,130,156,22,264,121,284,3,5%
2011-08,המרכז,2640,ראש העין,819,363,456,88,731,174,802,107,4%
2011-08,המרכז,8300,ראשון לציון,4577,1972,2605,900,3677,1642,4560,335,4%
2011-08,המרכז,8400,רחובות,2823,1153,1670,543,2280,1069,2773,32,5%
2011-08,המרכז,8500,רמלה,1880,863,1017,119,1761,846,1844,166,6%
2011-08,המרכז,8700,רעננה,1014,489,525,329,685,91,1009,42,3%
2011-08,המרכז,1304,שוהם,158,65,93,59,99,8,158,10,2%
2011-08,המרכז,154,תל מונד,134,58,76,49,85,25,134,5,3%
2011-08,הצפון,473,אבו סנאן,725,269,456,6,719,621,721,17,15%
2011-08,הצפון,478,אכסאל,549,219,330,15,534,479,548,14,12%
2011-08,הצפון,529,אעבלין,634,251,383,12,622,520,634,37,14%
2011-08,הצפון,482,בועיינה-נוג'ידאת,473,199,274,6,467,398,469,4,15%
2011-08,הצפון,4001,בוקעאתא,358,130,228,8,350,316,350,3,15%
2011-08,הצפון,998,ביר אל-מכסור,438,160,278,7,431,334,438,7,15%
2011-08,הצפון,480,בית ג'ן,331,94,237,3,328,253,328,11,8%
2011-08,הצפון,9200,בית שאן,986,385,601,24,962,458,984,125,10%
2011-08,הצפון,944,בסמת טבעון,250,100,150,5,245,194,250,5,9%
2011-08,הצפון,483,בענה,450,167,283,3,447,381,450,9,16%
2011-08,הצפון,1292,ג'דיידה-מכר,1473,610,863,7,1466,1277,1472,38,19%
2011-08,הצפון,485,ג'ולס,208,57,151,2,206,149,207,18,9%
2011-08,הצפון,487,ג'ש (גוש חלב),55,29,26,2,53,28,54,1,4%
2011-08,הצפון,489,דבורייה,411,174,237,17,394,305,410,11,11%
2011-08,הצפון,490,דייר אל-אסד,421,165,256,7,414,335,421,10,10%
2011-08,הצפון,492,דייר חנא,632,263,369,6,626,509,632,16,16%
2011-08,הצפון,975,זרזיר,277,114,163,4,273,185,273,16,11%
2011-08,הצפון,496,חורפיש,149,59,90,7,142,87,149,12,7%
2011-08,הצפון,2034,חצור הגלילית,302,117,185,8,294,130,295,26,7%
2011-08,הצפון,6700,טבריה,1948,803,1145,116,1832,1223,1827,145,9%
2011-08,הצפון,962,טובא-זנגרייה,341,140,201,3,338,245,337,12,13%
2011-08,הצפון,498,טורעאן,527,180,347,10,517,432,525,9,12%
2011-08,הצפון,8900,טמרה,1974,800,1174,28,1946,1707,1968,39,17%
2011-08,הצפון,1295,יאנוח-ג'ת,159,53,106,4,155,112,159,6,8%
2011-08,הצפון,46,יבנאל,142,89,53,8,134,112,132,5,10%
2011-08,הצפון,499,יפיע,631,264,367,11,620,483,629,12,10%
2011-08,הצפון,240,יקנעם עילית,621,274,347,94,527,213,621,61,6%
2011-08,הצפון,502,ירכא,509,216,293,4,505,419,509,18,11%
2011-08,הצפון,504,כאבול,683,258,425,18,665,592,680,14,17%
2011-08,הצפון,505,כאוכב אבו אל-היג'א,211,83,128,8,203,181,211,9,15%
2011-08,הצפון,1296,כסרא-סמיע,235,91,144,2,233,174,234,17,9%
2011-08,הצפון,978,כעביה-טבאש-חג'אג'רה,194,81,113,1,193,141,192,9,10%
2011-08,הצפון,1263,כפר ורדים,89,43,46,35,54,7,89,3,3%
2011-08,הצפון,507,כפר יאסיף,477,192,285,3,474,391,477,13,11%
2011-08,הצפון,508,כפר כמא,74,26,48,2,72,40,72,1,5%
2011-08,הצפון,509,כפר כנא,1163,420,743,23,1140,978,1158,35,16%
2011-08,הצפון,510,כפר מנדא,1017,455,562,14,1003,758,1009,25,17%
2011-08,הצפון,47,כפר תבור,48,21,27,13,35,4,47,0,3%
2011-08,הצפון,1139,כרמיאל,1834,708,1126,375,1459,909,1772,130,7%
2011-08,הצפון,481,מגאר,1438,553,885,38,1400,1259,1435,55,19%
2011-08,הצפון,516,מג'ד אל-כרום,614,245,369,8,606,495,614,23,12%
2011-08,הצפון,874,מגדל העמק,1163,504,659,93,1070,466,1111,140,9%
2011-08,הצפון,4201,מג'דל שמס,448,164,284,19,429,374,446,9,11%
2011-08,הצפון,517,מזרעה,171,60,111,2,169,148,170,8,11%
2011-08,הצפון,4203,מסעדה,186,62,124,3,183,163,185,1,13%
2011-08,הצפון,518,מעיליא,41,19,22,6,35,19,41,3,3%
2011-08,הצפון,1063,מעלות-תרשיחא,961,413,548,119,842,589,958,51,8%
2011-08,הצפון,520,משהד,311,109,202,1,310,263,308,9,12%
2011-08,הצפון,9100,נהרייה,2061,916,1145,237,1824,1281,2052,105,7%
2011-08,הצפון,522,נחף,443,194,249,14,429,360,442,14,11%
2011-08,הצפון,7300,נצרת,2938,1223,1715,83,2855,2255,2924,105,10%
2011-08,הצפון,1061,נצרת עילית,2076,875,1201,308,1768,1126,1975,198,9%
2011-08,הצפון,525,סאג'ור,126,50,76,1,125,92,124,3,9%
2011-08,הצפון,7500,סח'נין,1939,837,1102,36,1903,1695,1939,47,17%
2011-08,הצפון,4501,ע'ג'ר,79,28,51,2,77,66,79,2,10%
2011-08,הצפון,530,עיילבון,184,77,107,6,178,143,183,5,9%
2011-08,הצפון,511,עילוט,332,121,211,6,326,260,332,15,14%
2011-08,הצפון,532,עין מאהל,591,266,325,8,583,502,581,8,14%
2011-08,הצפון,7600,עכו,3369,1489,1880,162,3207,2540,3344,166,14%
2011-08,הצפון,7700,עפולה,1933,801,1132,210,1723,923,1868,186,9%
2011-08,הצפון,531,עראבה,1370,532,838,36,1334,1181,1369,25,17%
2011-08,הצפון,535,פסוטה,134,51,83,5,129,89,134,4,9%
2011-08,הצפון,536,פקיעין (בוקייעה),126,63,63,5,121,90,125,4,5%
2011-08,הצפון,8000,צפת,1080,521,559,78,1002,722,1073,42,9%
2011-08,הצפון,4100,קצרין,202,84,118,38,164,98,201,17,5%
2011-08,הצפון,2800,קריית שמונה,799,361,438,73,726,295,786,97,6%
2011-08,הצפון,543,ראמה,318,133,185,6,312,240,318,5,10%
2011-08,הצפון,26,ראש פינה,59,22,37,9,50,24,59,4,4%
2011-08,הצפון,542,ריינה,607,227,380,18,589,497,604,17,11%
2011-08,הצפון,122,רמת ישי,96,44,52,27,69,9,96,8,3%
2011-08,הצפון,913,שבלי - אום אל-גנם,218,90,128,6,212,179,216,5,10%
2011-08,הצפון,812,שלומי,258,104,154,12,246,155,252,14,8%
2011-08,הצפון,538,שעב,457,188,269,2,455,411,457,13,18%
2011-08,הצפון,8800,שפרעם,1984,751,1233,37,1947,1634,1977,65,13%
2011-08,חיפה,2710,אום אל-פחם,3677,1471,2206,12,3665,3139,3674,36,22%
2011-08,חיפה,1020,אור עקיבא,599,249,350,44,555,226,589,52,7%
2011-08,חיפה,6000,באקה אל-גרביה,666,312,354,8,658,446,666,28,NULL
2011-08,חיפה,9800,בנימינה-גבעת עדה*,188,77,111,61,127,50,186,14,3%
2011-08,חיפה,1326,"בסמ""ה",405,175,230,3,402,332,405,10,13%
2011-08,חיפה,541,ג'סר א-זרקא,449,256,193,0,449,279,446,12,9%
2011-08,חיפה,628,ג'ת,193,77,116,6,187,128,192,4,NULL
2011-08,חיפה,494,דאלית אל-כרמל,491,183,308,12,479,293,485,23,7%
2011-08,חיפה,9300,זכרון יעקב,236,105,131,72,164,49,234,21,3%
2011-08,חיפה,6500,חדרה,2487,999,1488,287,2200,930,2441,209,6%
2011-08,חיפה,4000,חיפה,7512,3322,4190,1450,6062,4761,7466,557,6%
2011-08,חיפה,1247,חריש-קציר,23,12,11,2,21,7,23,5,1%
2011-08,חיפה,2100,טירת כרמל,768,349,419,37,731,482,761,88,8%
2011-08,חיפה,654,כפר קרע,362,168,194,6,356,228,361,10,5%
2011-08,חיפה,1327,מעלה עירון,885,343,542,1,884,742,885,13,19%
2011-08,חיפה,2500,נשר,543,262,281,102,441,268,539,38,4%
2011-08,חיפה,534,עספיא,359,153,206,8,351,200,356,25,7%
2011-08,חיפה,637,ערערה,533,189,344,8,525,384,532,23,8%
2011-08,חיפה,537,פוריידיס,401,183,218,8,393,258,400,12,8%
2011-08,חיפה,7800,פרדס חנה-כרכור,869,378,491,131,738,289,857,93,5%
2011-08,חיפה,6800,קריית אתא,1979,791,1188,155,1824,1163,1972,151,7%
2011-08,חיפה,9500,קריית ביאליק,1234,508,726,141,1093,680,1230,97,6%
2011-08,חיפה,2300,קריית טבעון,210,104,106,71,139,48,208,16,3%
2011-08,חיפה,9600,קריית ים,1719,766,953,173,1546,1122,1712,116,9%
2011-08,חיפה,8200,קריית מוצקין,1162,467,695,170,992,618,1154,95,6%
2011-08,חיפה,922,רכסים,196,70,126,11,185,102,195,10,7%
2011-08,ירושלים,472,אבו גוש,241,116,125,8,233,184,241,6,10%
2011-08,ירושלים,2610,בית שמש,1442,558,884,120,1322,583,1435,122,6%
2011-08,ירושלים,3000,ירושלים,11093,4627,6466,1273,9820,6119,11016,479,4%
2011-08,ירושלים,1015,מבשרת ציון,400,185,215,74,326,159,398,28,3%
2011-08,ירושלים,1137,קריית יערים,35,11,24,4,31,14,35,1,3%
2011-08,תל אביב,2400,אור יהודה,941,382,559,44,897,299,931,101,5%
2011-08,תל אביב,565,אזור,170,88,82,20,150,39,169,18,3%
2011-08,תל אביב,6100,בני ברק,2835,1123,1712,142,2693,1447,2818,400,6%
2011-08,תל אביב,6200,בת ים,3396,1518,1878,467,2929,1442,3339,279,5%
2011-08,תל אביב,6300,גבעתיים,709,283,426,270,439,122,704,56,3%
2011-08,תל אביב,6400,הרצלייה,1127,471,656,334,793,82,1105,202,2%
2011-08,תל אביב,6600,חולון,3072,1365,1707,506,2566,982,3014,288,3%
2011-08,תל אביב,2620,קריית אונו,417,165,252,137,280,47,415,24,3%
2011-08,תל אביב,8600,רמת גן,2180,942,1238,645,1535,496,2163,192,3%
2011-08,תל אביב,2650,רמת השרון,427,178,249,147,280,24,425,70,2%
2011-08,תל אביב,5000,תל אביב -יפו,7852,3842,4010,2304,5548,2767,7790,557,3%
2011-09,אזור יהודה והשומרון,3760,אורנית,87,37,50,38,49,5,86,5,2%
2011-09,אזור יהודה והשומרון,3750,אלפי מנשה,80,37,43,25,55,1,80,5,2%
2011-09,אזור יהודה והשומרון,3560,אלקנה,36,17,19,18,18,2,36,3,2%
2011-09,אזור יהודה והשומרון,3650,אפרתה,55,30,25,26,29,7,55,3,2%
2011-09,אזור יהודה והשומרון,3570,אריאל,381,184,197,87,294,105,378,41,4%
2011-09,אזור יהודה והשומרון,3574,בית אל,49,28,21,11,38,14,49,7,2%
2011-09,אזור יהודה והשומרון,3652,בית אריה,56,25,31,9,47,5,56,7,3%
2011-09,אזור יהודה והשומרון,3780,ביתר עילית,475,213,262,14,461,231,468,84,6%
2011-09,אזור יהודה והשומרון,3730,גבעת זאב,184,88,96,25,159,50,184,14,3%
2011-09,אזור יהודה והשומרון,3769,הר אדר,29,11,18,16,13,0,29,3,2%
2011-09,אזור יהודה והשומרון,3797,מודיעין עילית,368,121,247,20,348,99,364,24,3%
2011-09,אזור יהודה והשומרון,3616,מעלה אדומים,630,253,377,86,544,220,626,63,4%
2011-09,אזור יהודה והשומרון,3660,עמנואל,71,36,35,3,68,56,71,15,8%
2011-09,אזור יהודה והשומרון,3557,קדומים,30,11,19,9,21,7,30,7,2%
2011-09,אזור יהודה והשומרון,3611,קריית ארבע,123,65,58,23,100,63,123,15,4%
2011-09,אזור יהודה והשומרון,3640,קרני שומרון,76,39,37,20,56,20,76,9,2%
2011-09,הדרום,31,אופקים,1411,554,857,113,1298,978,1402,52,12%
2011-09,הדרום,2600,אילת,1330,570,760,92,1238,608,1311,118,4%
2011-09,הדרום,70,אשדוד,6886,2708,4178,824,6062,3939,6832,482,7%
2011-09,הדרום,7100,אשקלון,4325,1667,2658,662,3663,2652,4216,252,7%
2011-09,הדרום,9000,באר שבע,7255,3022,4233,997,6258,4752,7203,584,8%
2011-09,הדרום,2200,דימונה,2115,898,1217,140,1975,1452,2083,145,12%
2011-09,הדרום,1303,חורה,736,312,424,1,735,680,735,14,24%
2011-09,הדרום,831,ירוחם,470,220,250,21,449,268,463,71,11%
2011-09,הדרום,1059,כסיפה,1001,420,581,4,997,921,999,27,27%
2011-09,הדרום,1271,להבים,39,16,23,20,19,3,39,8,1%
2011-09,הדרום,1060,לקיה,932,403,529,5,927,858,930,16,29%
2011-09,הדרום,1268,מיתר,72,27,45,25,47,7,71,10,2%
2011-09,הדרום,99,מצפה רמון,241,86,155,18,223,119,229,26,10%
2011-09,הדרום,246,נתיבות,1027,398,629,63,964,545,1019,97,9%
2011-09,הדרום,666,עומר,56,17,39,26,30,11,56,6,2%
2011-09,הדרום,2560,ערד,867,367,500,176,691,503,854,108,7%
2011-09,הדרום,1192,ערערה-בנגב,973,400,573,4,969,896,972,15,30%
2011-09,הדרום,2630,קריית גת,2275,917,1358,200,2075,1514,2270,89,9%
2011-09,הדרום,1034,קריית מלאכי,1206,517,689,33,1173,820,1185,116,11%
2011-09,הדרום,1161,רהט,2876,1076,1800,11,2865,2576,2876,135,21%
2011-09,הדרום,1286,שגב-שלום,452,160,292,0,452,426,451,15,23%
2011-09,הדרום,1031,שדרות,1059,425,634,61,998,647,1056,49,10%
2011-09,הדרום,1054,תל שבע,1191,553,638,3,1188,1104,1190,34,31%
2011-09,המרכז,182,אבן יהודה,132,68,64,46,86,18,132,11,2%
2011-09,המרכז,41,אליכין,57,26,31,6,51,17,55,12,3%
2011-09,המרכז,1309,אלעד,360,152,208,16,344,105,357,21,3%
2011-09,המרכז,2530,באר יעקב,219,90,129,41,178,73,213,22,3%
2011-09,המרכז,466,בית דגן,101,52,49,16,85,32,101,8,3%
2011-09,המרכז,1066,"בני עי""ש",190,85,105,29,161,77,187,1,5%
2011-09,המרכז,681,גבעת שמואל,239,128,111,90,149,53,238,15,2%
2011-09,המרכז,2550,גדרה,381,150,231,77,304,110,374,3,4%
2011-09,המרכז,627,ג'לג'וליה,82,41,41,4,78,35,82,7,3%
2011-09,המרכז,166,גן יבנה,347,124,223,48,299,104,344,29,4%
2011-09,המרכז,229,גני תקווה,171,71,100,49,122,30,171,13,2%
2011-09,המרכז,9700,הוד השרון,603,264,339,223,380,63,598,65,2%
2011-09,המרכז,1290,זמר,152,50,102,7,145,119,152,3,6%
2011-09,המרכז,2730,טייבה,2118,879,1239,5,2113,1843,2104,40,14%
2011-09,המרכז,2720,טירה,309,153,156,13,296,188,308,17,3%
2011-09,המרכז,2660,יבנה,869,399,470,74,795,421,865,92,5%
2011-09,המרכז,9400,יהוד,526,218,308,75,451,89,507,42,3%
2011-09,המרכז,1224,כוכב יאיר,91,42,49,42,49,5,91,17,2%
2011-09,המרכז,633,כפר ברא,25,15,10,0,25,9,25,3,2%
2011-09,המרכז,168,כפר יונה,319,138,181,67,252,74,319,33,3%
2011-09,המרכז,6900,כפר סבא,1115,470,645,349,766,194,1108,117,2%
2011-09,המרכז,634,כפר קאסם,191,89,102,3,188,113,190,39,3%
2011-09,המרכז,7000,לוד,2149,917,1232,174,1975,1269,2142,219,7%
2011-09,המרכז,1200,מודיעין-מכבים-רעות*,909,390,519,377,532,79,899,91,2%
2011-09,המרכז,28,מזכרת בתיה,158,63,95,43,115,43,156,0,3%
2011-09,המרכז,7200,נס ציונה,647,271,376,143,504,195,643,6,3%
2011-09,המרכז,7400,נתניה,4394,1930,2464,651,3743,1807,4350,588,5%
2011-09,המרכז,587,סביון*,12,5,7,7,5,0,12,0,1%
2011-09,המרכז,171,פרדסייה,86,39,47,14,72,8,86,8,3%
2011-09,המרכז,7900,פתח תקווה,3927,1690,2237,813,3114,1121,3895,367,4%
2011-09,המרכז,195,קדימה-צורן,223,94,129,65,158,38,222,22,3%
2011-09,המרכז,638,קלנסווה,919,329,590,2,917,774,916,27,13%
2011-09,המרכז,469,קריית עקרון,256,120,136,22,234,113,255,1,5%
2011-09,המרכז,2640,ראש העין,700,324,376,76,624,167,688,73,3%
2011-09,המרכז,8300,ראשון לציון,4213,1767,2446,876,3337,1619,4192,316,3%
2011-09,המרכז,8400,רחובות,2667,1116,1551,552,2115,1055,2622,13,5%
2011-09,המרכז,8500,רמלה,1704,762,942,101,1603,833,1669,215,5%
2011-09,המרכז,8700,רעננה,755,354,401,305,450,92,752,100,2%
2011-09,המרכז,1304,שוהם,146,61,85,67,79,3,145,19,2%
2011-09,המרכז,154,תל מונד,128,61,67,49,79,23,127,18,2%
2011-09,הצפון,473,אבו סנאן,720,259,461,5,715,619,716,18,15%
2011-09,הצפון,478,אכסאל,525,204,321,14,511,467,525,15,12%
2011-09,הצפון,529,אעבלין,610,241,369,16,594,506,609,24,13%
2011-09,הצפון,482,בועיינה-נוג'ידאת,450,189,261,4,446,389,446,19,14%
2011-09,הצפון,4001,בוקעאתא,351,125,226,7,344,317,343,5,15%
2011-09,הצפון,998,ביר אל-מכסור,426,154,272,8,418,325,426,13,14%
2011-09,הצפון,480,בית ג'ן,320,92,228,3,317,240,319,7,8%
2011-09,הצפון,9200,בית שאן,853,333,520,17,836,448,851,147,9%
2011-09,הצפון,944,בסמת טבעון,258,105,153,4,254,193,258,11,10%
2011-09,הצפון,483,בענה,428,167,261,2,426,377,428,26,15%
2011-09,הצפון,1292,ג'דיידה-מכר,1452,594,858,8,1444,1281,1451,30,19%
2011-09,הצפון,485,ג'ולס,199,55,144,2,197,152,198,4,8%
2011-09,הצפון,487,ג'ש (גוש חלב),52,28,24,2,50,27,51,3,4%
2011-09,הצפון,489,דבורייה,408,179,229,12,396,308,407,13,11%
2011-09,הצפון,490,דייר אל-אסד,394,160,234,7,387,329,394,16,10%
2011-09,הצפון,492,דייר חנא,631,265,366,7,624,518,631,38,16%
2011-09,הצפון,975,זרזיר,285,114,171,6,279,192,282,13,12%
2011-09,הצפון,496,חורפיש,144,55,89,6,138,89,143,8,7%
2011-09,הצפון,2034,חצור הגלילית,263,94,169,7,256,120,257,54,6%
2011-09,הצפון,6700,טבריה,1820,724,1096,117,1703,1210,1704,155,9%
2011-09,הצפון,962,טובא-זנגרייה,334,140,194,4,330,241,329,17,13%
2011-09,הצפון,498,טורעאן,482,178,304,9,473,421,480,40,11%
2011-09,הצפון,8900,טמרה,1949,789,1160,19,1930,1709,1942,101,17%
2011-09,הצפון,1295,יאנוח-ג'ת,152,48,104,4,148,110,152,5,7%
2011-09,הצפון,46,יבנאל,137,89,48,8,129,106,128,7,10%
2011-09,הצפון,499,יפיע,614,259,355,15,599,474,612,28,10%
2011-09,הצפון,240,יקנעם עילית,524,233,291,92,432,200,524,53,5%
2011-09,הצפון,502,ירכא,482,194,288,3,479,409,482,14,11%
2011-09,הצפון,504,כאבול,646,251,395,12,634,583,644,25,16%
2011-09,הצפון,505,כאוכב אבו אל-היג'א,209,83,126,6,203,184,209,12,15%
2011-09,הצפון,1296,כסרא-סמיע,231,93,138,3,228,174,230,13,9%
2011-09,הצפון,978,כעביה-טבאש-חג'אג'רה,187,74,113,2,185,134,187,7,10%
2011-09,הצפון,1263,כפר ורדים,75,34,41,32,43,6,75,7,3%
2011-09,הצפון,507,כפר יאסיף,470,194,276,4,466,396,470,13,11%
2011-09,הצפון,508,כפר כמא,68,27,41,1,67,39,67,5,5%
2011-09,הצפון,509,כפר כנא,1091,398,693,21,1070,966,1083,49,15%
2011-09,הצפון,510,כפר מנדא,958,432,526,12,946,728,949,45,16%
2011-09,הצפון,47,כפר תבור,51,18,33,15,36,5,51,2,3%
2011-09,הצפון,1139,כרמיאל,1781,684,1097,367,1414,902,1729,115,7%
2011-09,הצפון,481,מגאר,1374,524,850,28,1346,1242,1371,67,19%
2011-09,הצפון,516,מג'ד אל-כרום,581,239,342,10,571,483,581,23,11%
2011-09,הצפון,874,מגדל העמק,1003,419,584,83,920,432,965,179,8%
2011-09,הצפון,4201,מג'דל שמס,445,156,289,15,430,375,443,12,11%
2011-09,הצפון,517,מזרעה,167,61,106,2,165,146,166,0,10%
2011-09,הצפון,4203,מסעדה,191,71,120,4,187,164,190,2,13%
2011-09,הצפון,518,מעיליא,42,21,21,5,37,22,42,4,3%
2011-09,הצפון,1063,מעלות-תרשיחא,908,383,525,119,789,583,906,62,8%
2011-09,הצפון,520,משהד,298,102,196,2,296,259,296,14,12%
2011-09,הצפון,9100,נהרייה,1992,878,1114,227,1765,1296,1977,101,7%
2011-09,הצפון,522,נחף,421,181,240,12,409,351,420,13,10%
2011-09,הצפון,7300,נצרת,2855,1173,1682,69,2786,2259,2838,146,10%
2011-09,הצפון,1061,נצרת עילית,1987,847,1140,312,1675,1127,1880,210,8%
2011-09,הצפון,525,סאג'ור,112,46,66,0,112,91,111,3,8%
2011-09,הצפון,7500,סח'נין,1936,837,1099,38,1898,1705,1936,70,17%
2011-09,הצפון,4501,ע'ג'ר,82,29,53,3,79,66,82,1,10%
2011-09,הצפון,530,עיילבון,178,71,107,7,171,145,177,12,8%
2011-09,הצפון,511,עילוט,312,119,193,4,308,251,312,20,14%
2011-09,הצפון,532,עין מאהל,586,266,320,11,575,500,578,18,14%
2011-09,הצפון,7600,עכו,3165,1399,1766,161,3004,2457,3143,234,13%
2011-09,הצפון,7700,עפולה,1830,721,1109,218,1612,902,1773,191,8%
2011-09,הצפון,531,עראבה,1341,525,816,34,1307,1199,1340,52,17%
2011-09,הצפון,535,פסוטה,120,46,74,5,115,87,120,11,8%
2011-09,הצפון,536,פקיעין (בוקייעה),123,61,62,4,119,87,122,7,5%
2011-09,הצפון,8000,צפת,1027,492,535,78,949,716,1021,68,9%
2011-09,הצפון,4100,קצרין,201,83,118,36,165,95,200,12,5%
2011-09,הצפון,2800,קריית שמונה,708,299,409,66,642,263,697,99,6%
2011-09,הצפון,543,ראמה,314,132,182,4,310,244,314,11,10%
2011-09,הצפון,26,ראש פינה,44,15,29,7,37,19,44,5,3%
2011-09,הצפון,542,ריינה,596,216,380,15,581,504,592,28,11%
2011-09,הצפון,122,רמת ישי,87,40,47,29,58,7,87,9,2%
2011-09,הצפון,913,שבלי - אום אל-גנם,224,92,132,4,220,177,223,3,11%
2011-09,הצפון,812,שלומי,238,91,147,13,225,153,235,15,7%
2011-09,הצפון,538,שעב,449,183,266,1,448,408,449,8,18%
2011-09,הצפון,8800,שפרעם,1966,739,1227,42,1924,1653,1960,87,13%
2011-09,חיפה,2710,אום אל-פחם,3644,1461,2183,13,3631,3149,3640,70,21%
2011-09,חיפה,1020,אור עקיבא,573,221,352,45,528,216,562,95,6%
2011-09,חיפה,6000,באקה אל-גרביה,651,305,346,9,642,430,651,42,NULL
2011-09,חיפה,9800,בנימינה-גבעת עדה*,186,78,108,62,124,48,185,24,3%
2011-09,חיפה,1326,"בסמ""ה",400,172,228,3,397,329,400,16,13%
2011-09,חיפה,541,ג'סר א-זרקא,467,277,190,0,467,285,462,27,9%
2011-09,חיפה,628,ג'ת,198,83,115,5,193,128,197,8,NULL
2011-09,חיפה,494,דאלית אל-כרמל,464,182,282,8,456,295,458,46,7%
2011-09,חיפה,9300,זכרון יעקב,212,89,123,85,127,47,211,30,2%
2011-09,חיפה,6500,חדרה,2334,924,1410,278,2056,936,2292,272,5%
2011-09,חיפה,4000,חיפה,7332,3213,4119,1426,5906,4675,7288,571,6%
2011-09,חיפה,1247,חריש-קציר,17,9,8,2,15,4,17,4,1%
2011-09,חיפה,2100,טירת כרמל,728,320,408,34,694,464,725,62,8%
2011-09,חיפה,654,כפר קרע,363,170,193,6,357,227,362,17,5%
2011-09,חיפה,1327,מעלה עירון,887,341,546,2,885,738,887,9,19%
2011-09,חיפה,2500,נשר,501,225,276,90,411,267,498,48,4%
2011-09,חיפה,534,עספיא,321,142,179,8,313,209,320,37,7%
2011-09,חיפה,637,ערערה,553,197,356,9,544,385,553,29,8%
2011-09,חיפה,537,פוריידיס,371,179,192,7,364,252,370,39,8%
2011-09,חיפה,7800,פרדס חנה-כרכור,810,332,478,127,683,284,804,110,5%
2011-09,חיפה,6800,קריית אתא,1787,732,1055,150,1637,1156,1778,160,7%
2011-09,חיפה,9500,קריית ביאליק,1160,464,696,129,1031,659,1156,75,6%
2011-09,חיפה,2300,קריית טבעון,171,74,97,68,103,41,168,13,2%
2011-09,חיפה,9600,קריית ים,1617,705,912,164,1453,1097,1612,95,8%
2011-09,חיפה,8200,קריית מוצקין,1152,433,719,185,967,620,1143,84,6%
2011-09,חיפה,922,רכסים,161,62,99,11,150,95,161,45,6%
2011-09,ירושלים,472,אבו גוש,248,121,127,7,241,183,247,4,10%
2011-09,ירושלים,2610,בית שמש,1255,499,756,122,1133,564,1242,225,5%
2011-09,ירושלים,3000,ירושלים,10379,4376,6003,1330,9049,6167,10299,739,4%
2011-09,ירושלים,1015,מבשרת ציון,342,160,182,76,266,157,341,23,3%
2011-09,ירושלים,1137,קריית יערים,29,8,21,3,26,13,29,2,3%
2011-09,תל אביב,2400,אור יהודה,831,361,470,35,796,303,820,93,5%
2011-09,תל אביב,565,אזור,130,60,70,19,111,32,127,17,2%
2011-09,תל אביב,6100,בני ברק,2351,1077,1274,125,2226,1398,2331,137,5%
2011-09,תל אביב,6200,בת ים,3179,1400,1779,431,2748,1435,3119,335,5%
2011-09,תל אביב,6300,גבעתיים,657,271,386,271,386,116,652,58,2%
2011-09,תל אביב,6400,הרצלייה,976,435,541,305,671,83,959,192,2%
2011-09,תל אביב,6600,חולון,2766,1226,1540,451,2315,923,2715,310,3%
2011-09,תל אביב,2620,קריית אונו,398,160,238,139,259,49,394,29,2%
2011-09,תל אביב,8600,רמת גן,1949,854,1095,603,1346,491,1928,200,3%
2011-09,תל אביב,2650,רמת השרון,373,161,212,157,216,26,370,43,2%
2011-09,תל אביב,5000,תל אביב -יפו,7328,3580,3748,2190,5138,2704,7271,509,3%
2011-10,אזור יהודה והשומרון,3760,אורנית,83,34,49,37,46,4,82,6,2%
2011-10,אזור יהודה והשומרון,3750,אלפי מנשה,83,36,47,26,57,1,83,3,2%
2011-10,אזור יהודה והשומרון,3560,אלקנה,32,14,18,16,16,3,32,0,2%
2011-10,אזור יהודה והשומרון,3650,אפרתה,52,27,25,27,25,6,51,0,1%
2011-10,אזור יהודה והשומרון,3570,אריאל,380,182,198,91,289,105,378,32,4%
2011-10,אזור יהודה והשומרון,3574,בית אל,50,25,25,14,36,18,50,6,2%
2011-10,אזור יהודה והשומרון,3652,בית אריה,56,21,35,10,46,5,56,0,3%
2011-10,אזור יהודה והשומרון,3780,ביתר עילית,417,197,220,15,402,208,411,29,5%
2011-10,אזור יהודה והשומרון,3730,גבעת זאב,185,90,95,26,159,50,185,9,3%
2011-10,אזור יהודה והשומרון,3769,הר אדר,24,7,17,11,13,1,24,1,1%
2011-10,אזור יהודה והשומרון,3797,מודיעין עילית,358,118,240,22,336,96,353,13,3%
2011-10,אזור יהודה והשומרון,3616,מעלה אדומים,618,251,367,97,521,206,613,32,3%
2011-10,אזור יהודה והשומרון,3660,עמנואל,72,36,36,3,69,60,72,0,8%
2011-10,אזור יהודה והשומרון,3557,קדומים,25,13,12,11,14,7,25,3,2%
2011-10,אזור יהודה והשומרון,3611,קריית ארבע,110,48,62,17,93,65,110,8,4%
2011-10,אזור יהודה והשומרון,3640,קרני שומרון,76,39,37,19,57,20,75,4,2%
2011-10,הדרום,31,אופקים,1370,558,812,96,1274,981,1365,81,12%
2011-10,הדרום,2600,אילת,1325,571,754,78,1247,590,1314,75,4%
2011-10,הדרום,70,אשדוד,6671,2643,4028,766,5905,3927,6625,267,7%
2011-10,הדרום,7100,אשקלון,4225,1655,2570,645,3580,2624,4116,190,7%
2011-10,הדרום,9000,באר שבע,7086,2992,4094,975,6111,4659,7044,360,8%
2011-10,הדרום,2200,דימונה,2065,892,1173,128,1937,1457,2037,61,12%
2011-10,הדרום,1303,חורה,727,308,419,1,726,677,726,12,24%
2011-10,הדרום,831,ירוחם,436,218,218,19,417,272,430,47,10%
2011-10,הדרום,1059,כסיפה,996,424,572,4,992,915,993,16,27%
2011-10,הדרום,1271,להבים,40,20,20,21,19,4,40,3,1%
2011-10,הדרום,1060,לקיה,925,409,516,5,920,863,923,15,29%
2011-10,הדרום,1268,מיתר,59,21,38,26,33,5,58,5,2%
2011-10,הדרום,99,מצפה רמון,241,87,154,21,220,123,222,26,10%
2011-10,הדרום,246,נתיבות,1008,413,595,62,946,524,1001,110,9%
2011-10,הדרום,666,עומר,55,15,40,22,33,9,55,6,1%
2011-10,הדרום,2560,ערד,867,386,481,169,698,505,848,62,7%
2011-10,הדרום,1192,ערערה-בנגב,942,386,556,2,940,879,942,39,30%
2011-10,הדרום,2630,קריית גת,2270,927,1343,189,2081,1496,2265,70,9%
2011-10,הדרום,1034,קריית מלאכי,1239,528,711,28,1211,817,1220,108,11%
2011-10,הדרום,1161,רהט,2796,1062,1734,10,2786,2542,2796,113,20%
2011-10,הדרום,1286,שגב-שלום,461,162,299,0,461,435,460,36,23%
2011-10,הדרום,1031,שדרות,1045,431,614,64,981,643,1042,64,9%
2011-10,הדרום,1054,תל שבע,1156,529,627,4,1152,1082,1156,48,30%
2011-10,המרכז,182,אבן יהודה,131,67,64,44,87,17,131,9,2%
2011-10,המרכז,41,אליכין,51,22,29,4,47,15,50,4,3%
2011-10,המרכז,1309,אלעד,381,167,214,20,361,105,380,14,4%
2011-10,המרכז,2530,באר יעקב,219,96,123,41,178,68,214,11,3%
2011-10,המרכז,466,בית דגן,94,47,47,16,78,31,94,1,3%
2011-10,המרכז,1066,"בני עי""ש",186,89,97,28,158,67,185,2,5%
2011-10,המרכז,681,גבעת שמואל,229,119,110,91,138,56,228,16,2%
2011-10,המרכז,2550,גדרה,371,150,221,75,296,105,362,5,4%
2011-10,המרכז,627,ג'לג'וליה,81,44,37,5,76,38,81,2,3%
2011-10,המרכז,166,גן יבנה,333,131,202,47,286,102,330,18,3%
2011-10,המרכז,229,גני תקווה,172,68,104,46,126,25,171,9,2%
2011-10,המרכז,9700,הוד השרון,566,247,319,220,346,60,563,28,2%
2011-10,המרכז,1290,זמר,150,48,102,9,141,119,150,4,6%
2011-10,המרכז,2730,טייבה,2142,890,1252,4,2138,1850,2127,36,14%
2011-10,המרכז,2720,טירה,290,138,152,10,280,177,289,14,3%
2011-10,המרכז,2660,יבנה,821,403,418,72,749,411,818,48,5%
2011-10,המרכז,9400,יהוד,494,197,297,73,421,83,477,42,3%
2011-10,המרכז,1224,כוכב יאיר,88,43,45,38,50,4,88,6,2%
2011-10,המרכז,633,כפר ברא,25,16,9,0,25,7,25,2,2%
2011-10,המרכז,168,כפר יונה,336,148,188,76,260,78,335,26,4%
2011-10,המרכז,6900,כפר סבא,1076,446,630,352,724,182,1070,61,2%
2011-10,המרכז,634,כפר קאסם,203,106,97,0,203,117,203,8,3%
2011-10,המרכז,7000,לוד,2098,921,1177,167,1931,1231,2089,90,6%
2011-10,המרכז,1200,מודיעין-מכבים-רעות*,893,376,517,371,522,74,881,46,2%
2011-10,המרכז,28,מזכרת בתיה,151,64,87,40,111,39,151,0,3%
2011-10,המרכז,7200,נס ציונה,627,273,354,125,502,196,621,3,3%
2011-10,המרכז,7400,נתניה,4271,1909,2362,635,3636,1781,4228,318,5%
2011-10,המרכז,587,סביון*,12,4,8,7,5,0,12,0,1%
2011-10,המרכז,171,פרדסייה,76,34,42,8,68,8,76,2,2%
2011-10,המרכז,7900,פתח תקווה,3720,1631,2089,771,2949,1094,3692,173,3%
2011-10,המרכז,195,קדימה-צורן,212,87,125,55,157,42,212,14,2%
2011-10,המרכז,638,קלנסווה,893,317,576,0,893,774,891,21,13%
2011-10,המרכז,469,קריית עקרון,272,136,136,20,252,116,272,2,5%
2011-10,המרכז,2640,ראש העין,663,310,353,81,582,164,655,39,3%
2011-10,המרכז,8300,ראשון לציון,4102,1739,2363,865,3237,1595,4082,188,3%
2011-10,המרכז,8400,רחובות,2470,1077,1393,523,1947,1041,2426,13,4%
2011-10,המרכז,8500,רמלה,1649,766,883,101,1548,802,1623,91,5%
2011-10,המרכז,8700,רעננה,736,342,394,294,442,86,736,42,2%
2011-10,המרכז,1304,שוהם,164,72,92,76,88,3,163,14,2%
2011-10,המרכז,154,תל מונד,136,67,69,50,86,26,135,6,3%
2011-10,הצפון,473,אבו סנאן,707,260,447,6,701,614,703,20,15%
2011-10,הצפון,478,אכסאל,517,209,308,14,503,458,517,13,11%
2011-10,הצפון,529,אעבלין,620,248,372,10,610,524,620,17,13%
2011-10,הצפון,482,בועיינה-נוג'ידאת,436,175,261,2,434,385,432,18,14%
2011-10,הצפון,4001,בוקעאתא,350,128,222,6,344,312,342,2,15%
2011-10,הצפון,998,ביר אל-מכסור,420,156,264,7,413,325,420,4,14%
2011-10,הצפון,480,בית ג'ן,326,105,221,3,323,235,324,7,8%
2011-10,הצפון,9200,בית שאן,786,309,477,20,766,432,785,71,9%
2011-10,הצפון,944,בסמת טבעון,249,105,144,2,247,189,249,6,9%
2011-10,הצפון,483,בענה,402,152,250,3,399,362,402,13,15%
2011-10,הצפון,1292,ג'דיידה-מכר,1446,592,854,7,1439,1269,1445,28,19%
2011-10,הצפון,485,ג'ולס,193,56,137,2,191,147,192,7,8%
2011-10,הצפון,487,ג'ש (גוש חלב),52,28,24,2,50,26,51,2,4%
2011-10,הצפון,489,דבורייה,386,163,223,9,377,302,384,7,11%
2011-10,הצפון,490,דייר אל-אסד,371,153,218,6,365,314,371,10,9%
2011-10,הצפון,492,דייר חנא,619,255,364,10,609,513,619,15,16%
2011-10,הצפון,975,זרזיר,268,104,164,2,266,191,265,11,11%
2011-10,הצפון,496,חורפיש,136,57,79,6,130,86,135,7,7%
2011-10,הצפון,2034,חצור הגלילית,270,94,176,10,260,130,263,16,6%
2011-10,הצפון,6700,טבריה,1811,736,1075,115,1696,1212,1697,109,8%
2011-10,הצפון,962,טובא-זנגרייה,332,145,187,4,328,242,327,7,13%
2011-10,הצפון,498,טורעאן,470,162,308,10,460,418,468,14,10%
2011-10,הצפון,8900,טמרה,1900,765,1135,17,1883,1696,1897,51,17%
2011-10,הצפון,1295,יאנוח-ג'ת,143,44,99,3,140,107,143,6,7%
2011-10,הצפון,46,יבנאל,137,88,49,7,130,104,128,3,10%
2011-10,הצפון,499,יפיע,592,246,346,12,580,473,588,24,9%
2011-10,הצפון,240,יקנעם עילית,483,212,271,89,394,183,483,39,5%
2011-10,הצפון,502,ירכא,470,186,284,3,467,405,470,7,10%
2011-10,הצפון,504,כאבול,659,256,403,10,649,600,656,15,16%
2011-10,הצפון,505,כאוכב אבו אל-היג'א,209,83,126,6,203,186,209,7,15%
2011-10,הצפון,1296,כסרא-סמיע,219,87,132,1,218,163,217,17,8%
2011-10,הצפון,978,כעביה-טבאש-חג'אג'רה,181,73,108,2,179,133,180,6,10%
2011-10,הצפון,1263,כפר ורדים,70,37,33,31,39,4,70,4,2%
2011-10,הצפון,507,כפר יאסיף,472,184,288,4,468,403,472,19,11%
2011-10,הצפון,508,כפר כמא,67,24,43,1,66,38,66,1,5%
2011-10,הצפון,509,כפר כנא,1094,402,692,22,1072,969,1083,39,15%
2011-10,הצפון,510,כפר מנדא,948,435,513,9,939,723,943,30,16%
2011-10,הצפון,47,כפר תבור,50,22,28,13,37,5,50,3,3%
2011-10,הצפון,1139,כרמיאל,1765,702,1063,349,1416,905,1704,77,7%
2011-10,הצפון,481,מגאר,1342,500,842,25,1317,1226,1338,62,18%
2011-10,הצפון,516,מג'ד אל-כרום,569,246,323,10,559,462,569,19,11%
2011-10,הצפון,874,מגדל העמק,995,426,569,85,910,439,959,107,8%
2011-10,הצפון,4201,מג'דל שמס,457,163,294,13,444,384,455,2,12%
2011-10,הצפון,517,מזרעה,163,59,104,2,161,143,162,3,10%
2011-10,הצפון,4203,מסעדה,178,61,117,3,175,156,177,5,12%
2011-10,הצפון,518,מעיליא,42,23,19,3,39,20,42,3,3%
2011-10,הצפון,1063,מעלות-תרשיחא,865,382,483,109,756,559,861,45,8%
2011-10,הצפון,520,משהד,283,102,181,2,281,251,280,13,11%
2011-10,הצפון,9100,נהרייה,2007,889,1118,220,1787,1291,1994,90,7%
2011-10,הצפון,522,נחף,399,170,229,12,387,335,399,13,10%
2011-10,הצפון,7300,נצרת,2825,1161,1664,69,2756,2258,2814,77,10%
2011-10,הצפון,1061,נצרת עילית,1923,831,1092,286,1637,1101,1825,198,8%
2011-10,הצפון,525,סאג'ור,112,45,67,0,112,91,111,3,8%
2011-10,הצפון,7500,סח'נין,1925,825,1100,31,1894,1695,1925,42,17%
2011-10,הצפון,4501,ע'ג'ר,79,31,48,4,75,69,79,1,10%
2011-10,הצפון,530,עיילבון,177,67,110,6,171,143,176,9,8%
2011-10,הצפון,511,עילוט,314,128,186,6,308,252,313,6,14%
2011-10,הצפון,532,עין מאהל,572,251,321,8,564,496,565,7,13%
2011-10,הצפון,7600,עכו,3128,1399,1729,157,2971,2440,3106,126,13%
2011-10,הצפון,7700,עפולה,1759,697,1062,206,1553,901,1707,137,8%
2011-10,הצפון,531,עראבה,1340,529,811,34,1306,1214,1339,26,17%
2011-10,הצפון,535,פסוטה,110,45,65,2,108,84,110,4,8%
2011-10,הצפון,536,פקיעין (בוקייעה),117,57,60,3,114,89,115,2,5%
2011-10,הצפון,8000,צפת,1013,495,518,71,942,705,1007,31,9%
2011-10,הצפון,4100,קצרין,182,73,109,27,155,90,181,9,5%
2011-10,הצפון,2800,קריית שמונה,692,309,383,63,629,267,674,71,6%
2011-10,הצפון,543,ראמה,303,126,177,4,299,239,303,3,9%
2011-10,הצפון,26,ראש פינה,42,12,30,9,33,19,42,2,3%
2011-10,הצפון,542,ריינה,596,223,373,13,583,502,593,26,11%
2011-10,הצפון,122,רמת ישי,84,36,48,30,54,7,83,5,2%
2011-10,הצפון,913,שבלי - אום אל-גנם,230,96,134,7,223,180,229,5,11%
2011-10,הצפון,812,שלומי,245,92,153,15,230,152,243,10,7%
2011-10,הצפון,538,שעב,446,179,267,5,441,406,446,7,18%
2011-10,הצפון,8800,שפרעם,1979,762,1217,39,1940,1653,1974,56,13%
2011-10,חיפה,2710,אום אל-פחם,3611,1457,2154,13,3598,3125,3608,41,21%
2011-10,חיפה,1020,אור עקיבא,576,236,340,44,532,221,565,49,6%
2011-10,חיפה,6000,באקה אל-גרביה,633,298,335,8,625,429,633,28,NULL
2011-10,חיפה,9800,בנימינה-גבעת עדה*,165,70,95,59,106,43,164,8,3%
2011-10,חיפה,1326,"בסמ""ה",397,169,228,1,396,337,397,5,12%
2011-10,חיפה,541,ג'סר א-זרקא,441,260,181,0,441,279,440,37,9%
2011-10,חיפה,628,ג'ת,187,83,104,7,180,121,186,7,NULL
2011-10,חיפה,494,דאלית אל-כרמל,450,183,267,8,442,289,447,16,7%
2011-10,חיפה,9300,זכרון יעקב,207,91,116,79,128,45,207,22,2%
2011-10,חיפה,6500,חדרה,2275,946,1329,276,1999,932,2238,198,5%
2011-10,חיפה,4000,חיפה,7180,3186,3994,1368,5812,4590,7145,415,6%
2011-10,חיפה,1247,חריש-קציר,13,6,7,2,11,5,12,5,1%
2011-10,חיפה,2100,טירת כרמל,725,326,399,36,689,468,720,41,8%
2011-10,חיפה,654,כפר קרע,350,158,192,6,344,226,349,14,5%
2011-10,חיפה,1327,מעלה עירון,894,348,546,3,891,739,894,17,19%
2011-10,חיפה,2500,נשר,506,231,275,97,409,261,503,40,4%
2011-10,חיפה,534,עספיא,332,145,187,5,327,210,332,12,7%
2011-10,חיפה,637,ערערה,543,200,343,6,537,386,542,24,8%
2011-10,חיפה,537,פוריידיס,371,185,186,2,369,266,370,14,8%
2011-10,חיפה,7800,פרדס חנה-כרכור,792,336,456,131,661,281,787,76,5%
2011-10,חיפה,6800,קריית אתא,1750,732,1018,135,1615,1109,1746,91,7%
2011-10,חיפה,9500,קריית ביאליק,1142,481,661,121,1021,642,1137,61,6%
2011-10,חיפה,2300,קריית טבעון,180,80,100,69,111,43,176,14,2%
2011-10,חיפה,9600,קריית ים,1616,706,910,166,1450,1096,1610,65,8%
2011-10,חיפה,8200,קריית מוצקין,1111,432,679,175,936,572,1103,77,5%
2011-10,חיפה,922,רכסים,146,62,84,11,135,93,146,5,5%
2011-10,ירושלים,472,אבו גוש,249,114,135,8,241,178,248,8,10%
2011-10,ירושלים,2610,בית שמש,1104,451,653,107,997,533,1096,107,4%
2011-10,ירושלים,3000,ירושלים,10023,4266,5757,1270,8753,6122,9965,475,4%
2011-10,ירושלים,1015,מבשרת ציון,324,139,185,67,257,152,322,18,3%
2011-10,ירושלים,1137,קריית יערים,24,10,14,2,22,11,24,2,2%
2011-10,תל אביב,2400,אור יהודה,788,362,426,35,753,287,773,64,4%
2011-10,תל אביב,565,אזור,137,63,74,18,119,35,135,9,2%
2011-10,תל אביב,6100,בני ברק,2276,1085,1191,115,2161,1367,2264,83,5%
2011-10,תל אביב,6200,בת ים,3197,1447,1750,421,2776,1414,3152,174,5%
2011-10,תל אביב,6300,גבעתיים,656,279,377,290,366,118,650,34,2%
2011-10,תל אביב,6400,הרצלייה,957,433,524,309,648,80,943,154,2%
2011-10,תל אביב,6600,חולון,2822,1286,1536,464,2358,935,2770,155,3%
2011-10,תל אביב,2620,קריית אונו,379,151,228,134,245,48,376,21,2%
2011-10,תל אביב,8600,רמת גן,1958,869,1089,619,1339,490,1940,99,3%
2011-10,תל אביב,2650,רמת השרון,377,153,224,162,215,25,373,40,2%
2011-10,תל אביב,5000,תל אביב -יפו,7355,3636,3719,2189,5166,2690,7292,386,3%
2011-11,אזור יהודה והשומרון,3760,אורנית,93,42,51,40,53,4,92,6,2%
2011-11,אזור יהודה והשומרון,3750,אלפי מנשה,80,31,49,23,57,0,80,4,2%
2011-11,אזור יהודה והשומרון,3560,אלקנה,29,15,14,14,15,2,28,2,2%
2011-11,אזור יהודה והשומרון,3650,אפרתה,56,29,27,27,29,9,56,5,2%
2011-11,אזור יהודה והשומרון,3570,אריאל,388,181,207,93,295,106,386,38,4%
2011-11,אזור יהודה והשומרון,3574,בית אל,54,29,25,11,43,20,54,2,3%
2011-11,אזור יהודה והשומרון,3652,בית אריה,64,26,38,14,50,6,64,2,3%
2011-11,אזור יהודה והשומרון,3780,ביתר עילית,414,191,223,18,396,202,408,47,5%
2011-11,אזור יהודה והשומרון,3730,גבעת זאב,182,84,98,22,160,48,182,17,3%
2011-11,אזור יהודה והשומרון,3769,הר אדר,23,7,16,10,13,0,23,2,1%
2011-11,אזור יהודה והשומרון,3797,מודיעין עילית,349,123,226,21,328,97,347,16,3%
2011-11,אזור יהודה והשומרון,3616,מעלה אדומים,631,269,362,99,532,211,622,46,4%
2011-11,אזור יהודה והשומרון,3660,עמנואל,75,37,38,4,71,57,75,0,8%
2011-11,אזור יהודה והשומרון,3557,קדומים,26,14,12,11,15,7,26,2,2%
2011-11,אזור יהודה והשומרון,3611,קריית ארבע,122,54,68,20,102,77,121,10,4%
2011-11,אזור יהודה והשומרון,3640,קרני שומרון,86,46,40,21,65,21,84,3,3%
2011-11,הדרום,31,אופקים,1399,579,820,98,1301,982,1391,38,12%
2011-11,הדרום,2600,אילת,1380,620,760,70,1310,621,1364,77,4%
2011-11,הדרום,70,אשדוד,6931,2780,4151,784,6147,4012,6892,392,7%
2011-11,הדרום,7100,אשקלון,4345,1716,2629,650,3695,2664,4230,216,7%
2011-11,הדרום,9000,באר שבע,7264,3082,4182,1002,6262,4762,7204,547,8%
2011-11,הדרום,2200,דימונה,2176,953,1223,134,2042,1515,2143,105,12%
2011-11,הדרום,1303,חורה,717,302,415,1,716,669,717,14,24%
2011-11,הדרום,831,ירוחם,456,230,226,21,435,287,450,46,11%
2011-11,הדרום,1059,כסיפה,984,416,568,5,979,908,982,26,26%
2011-11,הדרום,1271,להבים,45,20,25,25,20,4,45,5,1%
2011-11,הדרום,1060,לקיה,923,404,519,3,920,866,921,15,29%
2011-11,הדרום,1268,מיתר,59,21,38,25,34,8,58,4,2%
2011-11,הדרום,99,מצפה רמון,235,83,152,18,217,127,219,26,10%
2011-11,הדרום,246,נתיבות,1022,416,606,64,958,540,1014,90,9%
2011-11,הדרום,666,עומר,57,16,41,23,34,9,57,11,2%
2011-11,הדרום,2560,ערד,899,400,499,186,713,518,881,115,7%
2011-11,הדרום,1192,ערערה-בנגב,928,390,538,2,926,863,927,9,29%
2011-11,הדרום,2630,קריית גת,2335,957,1378,191,2144,1537,2326,109,9%
2011-11,הדרום,1034,קריית מלאכי,1238,556,682,25,1213,830,1221,130,11%
2011-11,הדרום,1161,רהט,2859,1125,1734,10,2849,2598,2859,80,21%
2011-11,הדרום,1286,שגב-שלום,462,166,296,0,462,429,461,17,23%
2011-11,הדרום,1031,שדרות,1085,458,627,61,1024,668,1080,61,10%
2011-11,הדרום,1054,תל שבע,1117,511,606,1,1116,1047,1117,29,29%
2011-11,המרכז,182,אבן יהודה,139,75,64,44,95,19,139,10,2%
2011-11,המרכז,41,אליכין,49,23,26,4,45,16,49,6,3%
2011-11,המרכז,1309,אלעד,371,151,220,18,353,105,371,21,4%
2011-11,המרכז,2530,באר יעקב,243,104,139,44,199,76,237,25,3%
2011-11,המרכז,466,בית דגן,93,45,48,16,77,32,92,7,3%
2011-11,המרכז,1066,"בני עי""ש",186,90,96,27,159,71,186,2,5%
2011-11,המרכז,681,גבעת שמואל,242,125,117,97,145,57,242,10,2%
2011-11,המרכז,2550,גדרה,381,149,232,80,301,102,376,4,4%
2011-11,המרכז,627,ג'לג'וליה,56,29,27,2,54,33,56,3,2%
2011-11,המרכז,166,גן יבנה,320,136,184,46,274,98,317,23,3%
2011-11,המרכז,229,גני תקווה,182,74,108,54,128,26,181,7,3%
2011-11,המרכז,9700,הוד השרון,577,254,323,218,359,61,576,34,2%
2011-11,המרכז,1290,זמר,156,55,101,7,149,123,156,3,6%
2011-11,המרכז,2730,טייבה,2150,885,1265,4,2146,1863,2139,32,15%
2011-11,המרכז,2720,טירה,295,148,147,13,282,180,294,17,3%
2011-11,המרכז,2660,יבנה,872,438,434,73,799,434,870,85,5%
2011-11,המרכז,9400,יהוד,510,195,315,81,429,84,489,40,3%
2011-11,המרכז,1224,כוכב יאיר,92,47,45,47,45,4,92,4,2%
2011-11,המרכז,633,כפר ברא,22,15,7,0,22,7,22,1,2%
2011-11,המרכז,168,כפר יונה,327,148,179,72,255,81,326,42,3%
2011-11,המרכז,6900,כפר סבא,1162,485,677,358,804,192,1150,71,3%
2011-11,המרכז,634,כפר קאסם,207,105,102,1,206,115,207,8,3%
2011-11,המרכז,7000,לוד,2217,1004,1213,174,2043,1260,2207,181,7%
2011-11,המרכז,1200,מודיעין-מכבים-רעות*,941,413,528,398,543,70,930,71,3%
2011-11,המרכז,28,מזכרת בתיה,147,65,82,43,104,39,146,0,3%
2011-11,המרכז,7200,נס ציונה,635,276,359,123,512,197,629,5,3%
2011-11,המרכז,7400,נתניה,4287,1974,2313,642,3645,1757,4253,448,5%
2011-11,המרכז,587,סביון*,12,3,9,8,4,1,12,0,1%
2011-11,המרכז,171,פרדסייה,78,37,41,15,63,7,78,5,2%
2011-11,המרכז,7900,פתח תקווה,3887,1703,2184,772,3115,1125,3854,279,4%
2011-11,המרכז,195,קדימה-צורן,215,95,120,56,159,39,215,18,3%
2011-11,המרכז,638,קלנסווה,871,309,562,1,870,763,869,21,12%
2011-11,המרכז,469,קריית עקרון,263,134,129,13,250,113,263,5,5%
2011-11,המרכז,2640,ראש העין,700,349,351,82,618,167,690,61,3%
2011-11,המרכז,8300,ראשון לציון,4243,1870,2373,864,3379,1631,4226,316,3%
2011-11,המרכז,8400,רחובות,2489,1084,1405,497,1992,1066,2448,32,4%
2011-11,המרכז,8500,רמלה,1736,823,913,104,1632,828,1705,142,5%
2011-11,המרכז,8700,רעננה,739,349,390,301,438,85,738,40,2%
2011-11,המרכז,1304,שוהם,169,73,96,82,87,3,168,13,2%
2011-11,המרכז,154,תל מונד,138,70,68,52,86,24,138,6,3%
2011-11,הצפון,473,אבו סנאן,719,263,456,7,712,620,715,18,15%
2011-11,הצפון,478,אכסאל,521,216,305,14,507,458,521,10,12%
2011-11,הצפון,529,אעבלין,607,238,369,9,598,520,607,28,13%
2011-11,הצפון,482,בועיינה-נוג'ידאת,443,185,258,4,439,399,437,6,14%
2011-11,הצפון,4001,בוקעאתא,366,132,234,7,359,329,357,4,15%
2011-11,הצפון,998,ביר אל-מכסור,412,155,257,5,407,322,412,2,14%
2011-11,הצפון,480,בית ג'ן,328,110,218,4,324,231,326,2,8%
2011-11,הצפון,9200,בית שאן,789,329,460,20,769,456,787,83,9%
2011-11,הצפון,944,בסמת טבעון,244,98,146,2,242,188,244,9,9%
2011-11,הצפון,483,בענה,410,158,252,1,409,375,410,10,15%
2011-11,הצפון,1292,ג'דיידה-מכר,1481,613,868,8,1473,1305,1478,40,19%
2011-11,הצפון,485,ג'ולס,209,55,154,2,207,149,208,14,9%
2011-11,הצפון,487,ג'ש (גוש חלב),50,24,26,1,49,24,49,0,3%
2011-11,הצפון,489,דבורייה,386,166,220,9,377,304,385,8,11%
2011-11,הצפון,490,דייר אל-אסד,378,162,216,10,368,321,378,10,9%
2011-11,הצפון,492,דייר חנא,632,260,372,9,623,519,632,22,16%
2011-11,הצפון,975,זרזיר,293,119,174,3,290,201,288,14,12%
2011-11,הצפון,496,חורפיש,115,48,67,6,109,78,114,4,6%
2011-11,הצפון,2034,חצור הגלילית,268,99,169,10,258,132,263,13,6%
2011-11,הצפון,6700,טבריה,1835,765,1070,107,1728,1226,1715,152,9%
2011-11,הצפון,962,טובא-זנגרייה,333,153,180,4,329,251,329,4,13%
2011-11,הצפון,498,טורעאן,520,183,337,12,508,438,518,13,11%
2011-11,הצפון,8900,טמרה,1927,779,1148,12,1915,1723,1923,66,17%
2011-11,הצפון,1295,יאנוח-ג'ת,142,44,98,1,141,105,142,2,7%
2011-11,הצפון,46,יבנאל,129,89,40,6,123,104,120,2,9%
2011-11,הצפון,499,יפיע,593,245,348,13,580,475,590,23,9%
2011-11,הצפון,240,יקנעם עילית,504,220,284,94,410,184,503,62,5%
2011-11,הצפון,502,ירכא,479,185,294,2,477,404,479,16,11%
2011-11,הצפון,504,כאבול,657,250,407,10,647,596,654,18,16%
2011-11,הצפון,505,כאוכב אבו אל-היג'א,210,87,123,5,205,180,210,8,15%
2011-11,הצפון,1296,כסרא-סמיע,210,90,120,1,209,158,209,9,8%
2011-11,הצפון,978,כעביה-טבאש-חג'אג'רה,189,77,112,2,187,139,188,2,10%
2011-11,הצפון,1263,כפר ורדים,64,36,28,30,34,6,64,5,2%
2011-11,הצפון,507,כפר יאסיף,478,188,290,6,472,408,477,18,11%
2011-11,הצפון,508,כפר כמא,67,29,38,1,66,40,65,3,5%
2011-11,הצפון,509,כפר כנא,1112,415,697,21,1091,986,1101,51,15%
2011-11,הצפון,510,כפר מנדא,925,419,506,10,915,721,920,38,16%
2011-11,הצפון,47,כפר תבור,50,21,29,16,34,6,50,1,3%
2011-11,הצפון,1139,כרמיאל,1783,707,1076,380,1403,910,1731,127,7%
2011-11,הצפון,481,מגאר,1339,506,833,21,1318,1235,1335,79,18%
2011-11,הצפון,516,מג'ד אל-כרום,583,256,327,9,574,470,583,24,11%
2011-11,הצפון,874,מגדל העמק,1030,437,593,83,947,478,982,140,8%
2011-11,הצפון,4201,מג'דל שמס,481,183,298,13,468,400,477,15,12%
2011-11,הצפון,517,מזרעה,158,55,103,1,157,140,157,6,10%
2011-11,הצפון,4203,מסעדה,189,66,123,4,185,165,188,2,13%
2011-11,הצפון,518,מעיליא,42,22,20,3,39,24,42,0,3%
2011-11,הצפון,1063,מעלות-תרשיחא,874,396,478,109,765,565,873,63,8%
2011-11,הצפון,520,משהד,281,101,180,2,279,250,279,7,11%
2011-11,הצפון,9100,נהרייה,2036,920,1116,212,1824,1305,2022,103,7%
2011-11,הצפון,522,נחף,394,172,222,8,386,336,394,11,10%
2011-11,הצפון,7300,נצרת,2844,1187,1657,74,2770,2266,2830,109,10%
2011-11,הצפון,1061,נצרת עילית,1900,829,1071,279,1621,1083,1808,236,8%
2011-11,הצפון,525,סאג'ור,115,43,72,0,115,96,114,2,8%
2011-11,הצפון,7500,סח'נין,1955,847,1108,34,1921,1717,1954,50,17%
2011-11,הצפון,4501,ע'ג'ר,82,31,51,3,79,70,82,2,10%
2011-11,הצפון,530,עיילבון,180,71,109,4,176,142,179,11,8%
2011-11,הצפון,511,עילוט,311,125,186,5,306,250,310,11,14%
2011-11,הצפון,532,עין מאהל,578,253,325,12,566,499,571,6,14%
2011-11,הצפון,7600,עכו,3201,1414,1787,159,3042,2508,3172,173,13%
2011-11,הצפון,7700,עפולה,1793,749,1044,192,1601,936,1744,164,8%
2011-11,הצפון,531,עראבה,1352,533,819,34,1318,1225,1351,38,17%
2011-11,הצפון,535,פסוטה,111,47,64,2,109,84,111,3,8%
2011-11,הצפון,536,פקיעין (בוקייעה),115,55,60,3,112,86,113,4,5%
2011-11,הצפון,8000,צפת,1073,516,557,74,999,761,1063,29,9%
2011-11,הצפון,4100,קצרין,191,81,110,34,157,91,189,17,5%
2011-11,הצפון,2800,קריית שמונה,721,332,389,70,651,287,701,79,6%
2011-11,הצפון,543,ראמה,313,125,188,7,306,250,312,5,10%
2011-11,הצפון,26,ראש פינה,46,13,33,10,36,19,46,3,3%
2011-11,הצפון,542,ריינה,595,228,367,10,585,504,592,27,11%
2011-11,הצפון,122,רמת ישי,82,29,53,33,49,7,81,2,2%
2011-11,הצפון,913,שבלי - אום אל-גנם,235,106,129,5,230,177,234,7,11%
2011-11,הצפון,812,שלומי,251,97,154,17,234,149,248,17,8%
2011-11,הצפון,538,שעב,446,176,270,4,442,410,446,9,18%
2011-11,הצפון,8800,שפרעם,1957,751,1206,29,1928,1640,1951,69,13%
2011-11,חיפה,2710,אום אל-פחם,3608,1464,2144,15,3593,3136,3605,39,21%
2011-11,חיפה,1020,אור עקיבא,605,270,335,47,558,228,595,76,7%
2011-11,חיפה,6000,באקה אל-גרביה,642,303,339,11,631,436,642,28,NULL
2011-11,חיפה,9800,בנימינה-גבעת עדה*,183,75,108,59,124,49,183,18,3%
2011-11,חיפה,1326,"בסמ""ה",402,174,228,1,401,336,402,10,13%
2011-11,חיפה,541,ג'סר א-זרקא,422,262,160,0,422,291,420,22,8%
2011-11,חיפה,628,ג'ת,185,78,107,8,177,122,184,7,NULL
2011-11,חיפה,494,דאלית אל-כרמל,487,200,287,10,477,296,480,13,7%
2011-11,חיפה,9300,זכרון יעקב,212,98,114,85,127,44,211,24,2%
2011-11,חיפה,6500,חדרה,2318,995,1323,282,2036,971,2279,207,5%
2011-11,חיפה,4000,חיפה,7339,3302,4037,1383,5956,4626,7301,615,6%
2011-11,חיפה,1247,חריש-קציר,11,6,5,3,8,5,11,0,1%
2011-11,חיפה,2100,טירת כרמל,742,333,409,38,704,484,737,61,8%
2011-11,חיפה,654,כפר קרע,354,160,194,3,351,228,352,11,5%
2011-11,חיפה,1327,מעלה עירון,888,345,543,4,884,738,888,8,19%
2011-11,חיפה,2500,נשר,523,241,282,89,434,274,519,61,4%
2011-11,חיפה,534,עספיא,327,147,180,5,322,204,325,9,7%
2011-11,חיפה,637,ערערה,531,195,336,2,529,387,530,27,8%
2011-11,חיפה,537,פוריידיס,381,194,187,1,380,264,380,19,8%
2011-11,חיפה,7800,פרדס חנה-כרכור,792,354,438,135,657,289,789,108,5%
2011-11,חיפה,6800,קריית אתא,1779,752,1027,145,1634,1127,1771,136,7%
2011-11,חיפה,9500,קריית ביאליק,1168,482,686,117,1051,654,1163,90,6%
2011-11,חיפה,2300,קריית טבעון,177,80,97,65,112,45,172,16,2%
2011-11,חיפה,9600,קריית ים,1647,711,936,166,1481,1116,1639,124,8%
2011-11,חיפה,8200,קריית מוצקין,1104,435,669,169,935,579,1096,82,5%
2011-11,חיפה,922,רכסים,149,65,84,11,138,95,148,8,5%
2011-11,ירושלים,472,אבו גוש,236,109,127,5,231,179,236,7,10%
2011-11,ירושלים,2610,בית שמש,1162,493,669,110,1052,550,1152,112,5%
2011-11,ירושלים,3000,ירושלים,10217,4428,5789,1277,8940,6177,10142,611,4%
2011-11,ירושלים,1015,מבשרת ציון,332,147,185,58,274,157,329,26,3%
2011-11,ירושלים,1137,קריית יערים,29,10,19,4,25,11,29,1,3%
2011-11,תל אביב,2400,אור יהודה,803,377,426,30,773,301,789,79,5%
2011-11,תל אביב,565,אזור,148,66,82,20,128,41,146,23,3%
2011-11,תל אביב,6100,בני ברק,2298,1115,1183,111,2187,1385,2289,93,5%
2011-11,תל אביב,6200,בת ים,3385,1526,1859,450,2935,1437,3329,336,5%
2011-11,תל אביב,6300,גבעתיים,667,278,389,295,372,115,660,59,2%
2011-11,תל אביב,6400,הרצלייה,1038,483,555,322,716,80,1015,156,2%
2011-11,תל אביב,6600,חולון,2984,1367,1617,460,2524,927,2935,302,3%
2011-11,תל אביב,2620,קריית אונו,387,163,224,123,264,51,383,24,2%
2011-11,תל אביב,8600,רמת גן,2058,941,1117,654,1404,499,2040,140,3%
2011-11,תל אביב,2650,רמת השרון,364,156,208,160,204,20,363,33,2%
2011-11,תל אביב,5000,תל אביב -יפו,7699,3803,3896,2373,5326,2724,7633,560,3%
2011-12,אזור יהודה והשומרון,3760,אורנית,92,40,52,38,54,4,91,7,2%
2011-12,אזור יהודה והשומרון,3750,אלפי מנשה,82,28,54,22,60,1,82,3,2%
2011-12,אזור יהודה והשומרון,3560,אלקנה,23,13,10,11,12,1,23,1,1%
2011-12,אזור יהודה והשומרון,3650,אפרתה,47,31,16,22,25,7,47,5,1%
2011-12,אזור יהודה והשומרון,3570,אריאל,397,190,207,88,309,104,396,32,4%
2011-12,אזור יהודה והשומרון,3574,בית אל,47,24,23,8,39,20,47,2,2%
2011-12,אזור יהודה והשומרון,3652,בית אריה,71,28,43,17,54,5,71,5,3%
2011-12,אזור יהודה והשומרון,3780,ביתר עילית,394,188,206,16,378,190,390,40,5%
2011-12,אזור יהודה והשומרון,3730,גבעת זאב,161,76,85,21,140,43,160,13,3%
2011-12,אזור יהודה והשומרון,3769,הר אדר,27,13,14,11,16,0,26,0,2%
2011-12,אזור יהודה והשומרון,3797,מודיעין עילית,355,124,231,21,334,97,352,11,3%
2011-12,אזור יהודה והשומרון,3616,מעלה אדומים,627,259,368,91,536,224,618,50,4%
2011-12,אזור יהודה והשומרון,3660,עמנואל,79,41,38,3,76,63,79,1,8%
2011-12,אזור יהודה והשומרון,3557,קדומים,27,16,11,10,17,6,27,3,2%
2011-12,אזור יהודה והשומרון,3611,קריית ארבע,101,45,56,17,84,67,101,12,4%
2011-12,אזור יהודה והשומרון,3640,קרני שומרון,87,42,45,21,66,19,86,6,3%
2011-12,הדרום,31,אופקים,1356,571,785,95,1261,979,1344,43,12%
2011-12,הדרום,2600,אילת,1442,673,769,66,1376,608,1429,64,5%
2011-12,הדרום,70,אשדוד,6770,2727,4043,772,5998,3968,6719,332,7%
2011-12,הדרום,7100,אשקלון,4172,1668,2504,618,3554,2664,4061,182,7%
2011-12,הדרום,9000,באר שבע,7175,3093,4082,980,6195,4735,7122,439,8%
2011-12,הדרום,2200,דימונה,2148,946,1202,136,2012,1503,2112,133,12%
2011-12,הדרום,1303,חורה,724,308,416,3,721,673,724,8,24%
2011-12,הדרום,831,ירוחם,436,209,227,23,413,282,429,44,10%
2011-12,הדרום,1059,כסיפה,971,417,554,4,967,897,969,18,26%
2011-12,הדרום,1271,להבים,39,19,20,21,18,3,39,2,1%
2011-12,הדרום,1060,לקיה,923,404,519,1,922,868,920,11,29%
2011-12,הדרום,1268,מיתר,58,26,32,24,34,7,57,3,2%
2011-12,הדרום,99,מצפה רמון,220,87,133,18,202,128,211,21,10%
2011-12,הדרום,246,נתיבות,936,391,545,54,882,524,930,78,8%
2011-12,הדרום,666,עומר,57,18,39,24,33,9,55,3,1%
2011-12,הדרום,2560,ערד,874,397,477,182,692,513,855,78,7%
2011-12,הדרום,1192,ערערה-בנגב,947,397,550,2,945,885,947,15,30%
2011-12,הדרום,2630,קריית גת,2278,910,1368,192,2086,1519,2270,64,9%
2011-12,הדרום,1034,קריית מלאכי,1236,556,680,28,1208,819,1212,114,11%
2011-12,הדרום,1161,רהט,2889,1145,1744,8,2881,2622,2888,117,21%
2011-12,הדרום,1286,שגב-שלום,453,156,297,0,453,427,452,5,23%
2011-12,הדרום,1031,שדרות,1017,429,588,60,957,652,1013,56,9%
2011-12,הדרום,1054,תל שבע,1118,514,604,2,1116,1046,1118,20,29%
2011-12,המרכז,182,אבן יהודה,116,65,51,39,77,19,116,14,2%
2011-12,המרכז,41,אליכין,45,22,23,3,42,14,45,1,3%
2011-12,המרכז,1309,אלעד,372,153,219,18,354,100,372,27,4%
2011-12,המרכז,2530,באר יעקב,245,110,135,45,200,79,242,10,3%
2011-12,המרכז,466,בית דגן,92,42,50,14,78,34,92,6,3%
2011-12,המרכז,1066,"בני עי""ש",175,83,92,28,147,72,175,0,5%
2011-12,המרכז,681,גבעת שמואל,246,129,117,108,138,57,244,13,2%
2011-12,המרכז,2550,גדרה,364,153,211,80,284,106,358,1,4%
2011-12,המרכז,627,ג'לג'וליה,59,30,29,2,57,33,59,3,2%
2011-12,המרכז,166,גן יבנה,326,139,187,48,278,98,323,13,3%
2011-12,המרכז,229,גני תקווה,171,73,98,48,123,23,169,7,2%
2011-12,המרכז,9700,הוד השרון,567,254,313,206,361,62,564,29,2%
2011-12,המרכז,1290,זמר,159,56,103,8,151,124,159,3,7%
2011-12,המרכז,2730,טייבה,2185,902,1283,4,2181,1880,2175,41,15%
2011-12,המרכז,2720,טירה,307,153,154,7,300,183,306,16,3%
2011-12,המרכז,2660,יבנה,840,425,415,76,764,420,837,66,5%
2011-12,המרכז,9400,יהוד,499,190,309,77,422,87,479,45,3%
2011-12,המרכז,1224,כוכב יאיר,81,43,38,40,41,4,81,7,2%
2011-12,המרכז,633,כפר ברא,27,18,9,2,25,8,27,1,3%
2011-12,המרכז,168,כפר יונה,324,154,170,71,253,75,324,28,3%
2011-12,המרכז,6900,כפר סבא,1133,484,649,364,769,184,1121,64,2%
2011-12,המרכז,634,כפר קאסם,230,124,106,1,229,123,228,11,3%
2011-12,המרכז,7000,לוד,2215,990,1225,164,2051,1284,2206,143,7%
2011-12,המרכז,1200,מודיעין-מכבים-רעות*,905,403,502,370,535,70,894,45,2%
2011-12,המרכז,28,מזכרת בתיה,143,65,78,44,99,35,142,1,3%
2011-12,המרכז,7200,נס ציונה,610,270,340,120,490,197,603,9,3%
2011-12,המרכז,7400,נתניה,4142,1932,2210,622,3520,1758,4102,405,4%
2011-12,המרכז,587,סביון*,11,2,9,7,4,1,11,0,1%
2011-12,המרכז,171,פרדסייה,78,42,36,18,60,6,78,7,2%
2011-12,המרכז,7900,פתח תקווה,3775,1696,2079,772,3003,1106,3745,247,3%
2011-12,המרכז,195,קדימה-צורן,232,100,132,58,174,41,232,10,3%
2011-12,המרכז,638,קלנסווה,888,316,572,3,885,769,885,20,13%
2011-12,המרכז,469,קריית עקרון,272,133,139,15,257,124,271,3,5%
2011-12,המרכז,2640,ראש העין,683,337,346,90,593,168,673,43,3%
2011-12,המרכז,8300,ראשון לציון,4264,1865,2399,858,3406,1641,4251,297,3%
2011-12,המרכז,8400,רחובות,2447,1082,1365,513,1934,1040,2405,23,4%
2011-12,המרכז,8500,רמלה,1696,800,896,100,1596,829,1659,138,5%
2011-12,המרכז,8700,רעננה,728,358,370,294,434,83,725,37,2%
2011-12,המרכז,1304,שוהם,176,85,91,76,100,5,175,9,2%
2011-12,המרכז,154,תל מונד,138,64,74,55,83,24,138,8,3%
2011-12,הצפון,473,אבו סנאן,724,271,453,7,717,624,720,17,15%
2011-12,הצפון,478,אכסאל,529,220,309,11,518,461,529,9,12%
2011-12,הצפון,529,אעבלין,609,242,367,10,599,524,609,26,13%
2011-12,הצפון,482,בועיינה-נוג'ידאת,444,195,249,4,440,397,438,5,14%
2011-12,הצפון,4001,בוקעאתא,366,131,235,7,359,332,358,17,16%
2011-12,הצפון,998,ביר אל-מכסור,418,160,258,4,414,324,418,14,14%
2011-12,הצפון,480,בית ג'ן,332,115,217,5,327,239,330,10,8%
2011-12,הצפון,9200,בית שאן,762,319,443,20,742,441,759,71,8%
2011-12,הצפון,944,בסמת טבעון,245,105,140,2,243,185,245,18,9%
2011-12,הצפון,483,בענה,414,159,255,2,412,374,414,8,15%
2011-12,הצפון,1292,ג'דיידה-מכר,1505,620,885,8,1497,1320,1501,34,19%
2011-12,הצפון,485,ג'ולס,207,52,155,2,205,147,207,16,9%
2011-12,הצפון,487,ג'ש (גוש חלב),46,23,23,0,46,23,45,0,3%
2011-12,הצפון,489,דבורייה,403,183,220,9,394,308,402,7,11%
2011-12,הצפון,490,דייר אל-אסד,385,164,221,11,374,325,385,10,9%
2011-12,הצפון,492,דייר חנא,655,275,380,10,645,529,655,19,17%
2011-12,הצפון,975,זרזיר,299,128,171,2,297,207,295,21,12%
2011-12,הצפון,496,חורפיש,117,54,63,6,111,73,116,1,6%
2011-12,הצפון,2034,חצור הגלילית,266,102,164,10,256,132,261,10,6%
2011-12,הצפון,6700,טבריה,1833,796,1037,110,1723,1257,1710,119,9%
2011-12,הצפון,962,טובא-זנגרייה,349,168,181,3,346,252,345,1,13%
2011-12,הצפון,498,טורעאן,507,184,323,12,495,446,504,22,11%
2011-12,הצפון,8900,טמרה,1945,778,1167,13,1932,1735,1940,68,17%
2011-12,הצפון,1295,יאנוח-ג'ת,145,45,100,2,143,105,145,3,7%
2011-12,הצפון,46,יבנאל,141,94,47,7,134,109,131,3,10%
2011-12,הצפון,499,יפיע,602,250,352,12,590,481,597,23,9%
2011-12,הצפון,240,יקנעם עילית,489,217,272,86,403,176,488,51,5%
2011-12,הצפון,502,ירכא,493,195,298,2,491,409,493,17,11%
2011-12,הצפון,504,כאבול,681,263,418,11,670,615,679,14,17%
2011-12,הצפון,505,כאוכב אבו אל-היג'א,218,91,127,6,212,185,218,3,15%
2011-12,הצפון,1296,כסרא-סמיע,219,100,119,1,218,161,218,8,8%
2011-12,הצפון,978,כעביה-טבאש-חג'אג'רה,218,94,124,3,215,142,218,2,12%
2011-12,הצפון,1263,כפר ורדים,71,38,33,31,40,7,71,1,2%
2011-12,הצפון,507,כפר יאסיף,492,199,293,5,487,415,492,15,12%
2011-12,הצפון,508,כפר כמא,68,26,42,2,66,43,66,1,5%
2011-12,הצפון,509,כפר כנא,1145,439,706,14,1131,1013,1131,43,16%
2011-12,הצפון,510,כפר מנדא,944,428,516,9,935,743,937,47,16%
2011-12,הצפון,47,כפר תבור,54,23,31,16,38,7,54,3,3%
2011-12,הצפון,1139,כרמיאל,1721,670,1051,357,1364,913,1672,99,7%
2011-12,הצפון,481,מגאר,1358,516,842,24,1334,1254,1353,72,19%
2011-12,הצפון,516,מג'ד אל-כרום,573,248,325,6,567,469,573,19,11%
2011-12,הצפון,874,מגדל העמק,968,417,551,85,883,467,932,127,8%
2011-12,הצפון,4201,מג'דל שמס,500,186,314,12,488,416,494,12,13%
2011-12,הצפון,517,מזרעה,169,66,103,2,167,142,168,6,11%
2011-12,הצפון,4203,מסעדה,193,70,123,5,188,166,192,4,13%
2011-12,הצפון,518,מעיליא,44,24,20,4,40,25,44,3,3%
2011-12,הצפון,1063,מעלות-תרשיחא,829,381,448,107,722,545,827,56,7%
2011-12,הצפון,520,משהד,278,101,177,2,276,247,276,11,11%
2011-12,הצפון,9100,נהרייה,2051,921,1130,214,1837,1323,2040,94,7%
2011-12,הצפון,522,נחף,401,175,226,6,395,341,401,14,10%
2011-12,הצפון,7300,נצרת,2861,1198,1663,65,2796,2279,2843,95,10%
2011-12,הצפון,1061,נצרת עילית,1831,794,1037,268,1563,1082,1743,176,8%
2011-12,הצפון,525,סאג'ור,121,43,78,0,121,99,118,4,8%
2011-12,הצפון,7500,סח'נין,1979,854,1125,31,1948,1725,1979,39,17%
2011-12,הצפון,4501,ע'ג'ר,88,37,51,3,85,72,88,5,11%
2011-12,הצפון,530,עיילבון,181,72,109,4,177,140,180,10,9%
2011-12,הצפון,511,עילוט,325,137,188,8,317,255,324,14,14%
2011-12,הצפון,532,עין מאהל,593,271,322,11,582,502,585,7,14%
2011-12,הצפון,7600,עכו,3189,1422,1767,160,3029,2523,3163,147,13%
2011-12,הצפון,7700,עפולה,1728,726,1002,195,1533,903,1675,164,8%
2011-12,הצפון,531,עראבה,1371,547,824,30,1341,1238,1370,37,17%
2011-12,הצפון,535,פסוטה,110,49,61,3,107,85,110,8,8%
2011-12,הצפון,536,פקיעין (בוקייעה),123,63,60,3,120,85,121,6,5%
2011-12,הצפון,8000,צפת,1047,531,516,73,974,763,1040,28,9%
2011-12,הצפון,4100,קצרין,182,72,110,33,149,94,181,8,5%
2011-12,הצפון,2800,קריית שמונה,715,335,380,70,645,306,693,85,6%
2011-12,הצפון,543,ראמה,306,123,183,4,302,248,304,1,10%
2011-12,הצפון,26,ראש פינה,54,19,35,11,43,24,54,3,4%
2011-12,הצפון,542,ריינה,596,232,364,9,587,505,592,18,11%
2011-12,הצפון,122,רמת ישי,89,33,56,38,51,11,88,4,2%
2011-12,הצפון,913,שבלי - אום אל-גנם,249,116,133,3,246,179,246,5,11%
2011-12,הצפון,812,שלומי,243,97,146,20,223,154,240,13,7%
2011-12,הצפון,538,שעב,455,177,278,5,450,411,454,6,18%
2011-12,הצפון,8800,שפרעם,1985,766,1219,27,1958,1689,1978,95,13%
2011-12,חיפה,2710,אום אל-פחם,3663,1481,2182,12,3651,3169,3660,48,21%
2011-12,חיפה,1020,אור עקיבא,600,241,359,39,561,238,590,60,7%
2011-12,חיפה,6000,באקה אל-גרביה,657,316,341,10,647,434,657,37,NULL
2011-12,חיפה,9800,בנימינה-גבעת עדה*,179,80,99,56,123,49,179,14,3%
2011-12,חיפה,1326,"בסמ""ה",412,182,230,1,411,340,412,6,13%
2011-12,חיפה,541,ג'סר א-זרקא,429,263,166,0,429,289,427,23,8%
2011-12,חיפה,628,ג'ת,208,90,118,11,197,129,207,13,NULL
2011-12,חיפה,494,דאלית אל-כרמל,464,178,286,9,455,297,462,25,7%
2011-12,חיפה,9300,זכרון יעקב,225,99,126,87,138,45,225,12,3%
2011-12,חיפה,6500,חדרה,2319,1014,1305,273,2046,982,2282,180,5%
2011-12,חיפה,4000,חיפה,7270,3322,3948,1390,5880,4540,7222,576,6%
2011-12,חיפה,1247,חריש-קציר,14,8,6,4,10,5,13,1,1%
2011-12,חיפה,2100,טירת כרמל,734,327,407,37,697,477,730,64,8%
2011-12,חיפה,654,כפר קרע,366,171,195,3,363,232,364,12,5%
2011-12,חיפה,1327,מעלה עירון,906,356,550,4,902,754,906,11,19%
2011-12,חיפה,2500,נשר,506,239,267,94,412,259,503,50,4%
2011-12,חיפה,534,עספיא,323,148,175,6,317,197,322,18,7%
2011-12,חיפה,637,ערערה,561,210,351,1,560,391,560,22,8%
2011-12,חיפה,537,פוריידיס,390,198,192,2,388,269,388,14,8%
2011-12,חיפה,7800,פרדס חנה-כרכור,777,349,428,126,651,285,774,79,5%
2011-12,חיפה,6800,קריית אתא,1742,743,999,147,1595,1101,1736,108,7%
2011-12,חיפה,9500,קריית ביאליק,1129,464,665,113,1016,641,1126,72,6%
2011-12,חיפה,2300,קריית טבעון,176,86,90,63,113,43,174,12,2%
2011-12,חיפה,9600,קריית ים,1639,708,931,164,1475,1114,1635,97,8%
2011-12,חיפה,8200,קריית מוצקין,1077,428,649,170,907,571,1068,69,5%
2011-12,חיפה,922,רכסים,141,62,79,8,133,94,139,7,5%
2011-12,ירושלים,472,אבו גוש,232,109,123,7,225,176,231,12,10%
2011-12,ירושלים,2610,בית שמש,1143,516,627,115,1028,548,1134,89,5%
2011-12,ירושלים,3000,ירושלים,10119,4438,5681,1227,8892,6286,10049,387,4%
2011-12,ירושלים,1015,מבשרת ציון,324,152,172,51,273,148,322,19,3%
2011-12,ירושלים,1137,קריית יערים,31,11,20,3,28,14,31,0,3%
2011-12,תל אביב,2400,אור יהודה,766,371,395,28,738,301,751,65,4%
2011-12,תל אביב,565,אזור,152,69,83,29,123,39,151,7,3%
2011-12,תל אביב,6100,בני ברק,2252,1104,1148,105,2147,1369,2241,71,5%
2011-12,תל אביב,6200,בת ים,3289,1497,1792,448,2841,1439,3235,278,5%
2011-12,תל אביב,6300,גבעתיים,678,294,384,308,370,109,672,39,2%
2011-12,תל אביב,6400,הרצלייה,1024,472,552,313,711,89,1006,176,2%
2011-12,תל אביב,6600,חולון,2917,1379,1538,469,2448,943,2869,262,3%
2011-12,תל אביב,2620,קריית אונו,363,150,213,126,237,48,360,14,2%
2011-12,תל אביב,8600,רמת גן,2021,932,1089,655,1366,492,2006,126,3%
2011-12,תל אביב,2650,רמת השרון,385,168,217,170,215,19,382,25,2%
2011-12,תל אביב,5000,תל אביב -יפו,7616,3783,3833,2330,5286,2699,7551,437,3%
2012-01,אזור יהודה והשומרון,3760,אורנית,97,45,52,40,57,5,96,6,2%
2012-01,אזור יהודה והשומרון,3750,אלפי מנשה,98,42,56,26,72,0,98,6,2%
2012-01,אזור יהודה והשומרון,3560,אלקנה,23,10,13,14,9,1,22,0,1%
2012-01,אזור יהודה והשומרון,3650,אפרת,41,24,17,20,21,6,41,0,1%
2012-01,אזור יהודה והשומרון,3570,אריאל,430,219,211,100,330,104,428,38,4%
2012-01,אזור יהודה והשומרון,3574,בית אל,45,26,19,8,37,17,45,3,2%
2012-01,אזור יהודה והשומרון,3652,בית אריה,77,27,50,20,57,4,77,4,3%
2012-01,אזור יהודה והשומרון,3780,ביתר עילית,405,196,209,16,389,205,398,20,4%
2012-01,אזור יהודה והשומרון,3730,גבעת זאב,171,78,93,24,147,42,171,8,3%
2012-01,אזור יהודה והשומרון,3769,הר אדר,28,14,14,11,17,2,28,2,1%
2012-01,אזור יהודה והשומרון,3797,מודיעין עילית,353,137,216,19,334,101,351,11,3%
2012-01,אזור יהודה והשומרון,3616,מעלה אדומים,651,272,379,99,552,219,643,53,3%
2012-01,אזור יהודה והשומרון,3660,עמנואל,82,41,41,3,79,62,82,1,8%
2012-01,אזור יהודה והשומרון,3557,קדומים,32,18,14,12,20,6,32,4,2%
2012-01,אזור יהודה והשומרון,3611,קריית ארבע,107,46,61,17,90,71,107,6,4%
2012-01,אזור יהודה והשומרון,3640,קרני שומרון,81,40,41,17,64,18,79,7,2%
2012-01,הדרום,31,אופקים,1409,605,804,104,1305,990,1393,54,11%
2012-01,הדרום,2600,אילת,1727,813,914,71,1656,631,1708,90,5%
2012-01,הדרום,70,אשדוד,7013,2873,4140,811,6202,4039,6955,414,7%
2012-01,הדרום,7100,אשקלון,4290,1712,2578,624,3666,2675,4188,225,7%
2012-01,הדרום,9000,באר שבע,7534,3251,4283,1015,6519,4827,7472,547,8%
2012-01,הדרום,2200,דימונה,2195,979,1216,135,2060,1549,2159,151,12%
2012-01,הדרום,1303,חורה,742,322,420,3,739,686,742,11,21%
2012-01,הדרום,831,ירוחם,457,228,229,24,433,296,446,51,11%
2012-01,הדרום,1059,כסיפה,985,429,556,5,980,897,984,18,24%
2012-01,הדרום,1271,להבים,35,18,17,20,15,3,35,5,1%
2012-01,הדרום,1060,לקיה,949,417,532,3,946,896,946,10,26%
2012-01,הדרום,1268,מיתר,59,27,32,28,31,6,58,4,1%
2012-01,הדרום,99,מצפה רמון,238,97,141,23,215,123,226,34,9%
2012-01,הדרום,246,נתיבות,917,392,525,53,864,544,908,63,7%
2012-01,הדרום,666,עומר,68,22,46,23,45,12,68,4,2%
2012-01,הדרום,2560,ערד,903,395,508,183,720,518,886,93,7%
2012-01,הדרום,1192,ערערה-בנגב,939,388,551,2,937,886,939,5,25%
2012-01,הדרום,2630,קריית גת,2401,971,1430,202,2199,1572,2391,101,9%
2012-01,הדרום,1034,קריית מלאכי,1283,597,686,28,1255,822,1260,102,11%
2012-01,הדרום,1161,רהט,2930,1168,1762,10,2920,2647,2928,46,18%
2012-01,הדרום,1286,שגב-שלום,474,169,305,0,474,446,473,5,20%
2012-01,הדרום,1031,שדרות,1048,457,591,64,984,680,1044,68,9%
2012-01,הדרום,1054,תל שבע,1140,538,602,1,1139,1072,1139,14,26%
2012-01,המרכז,182,אבן יהודה,105,56,49,40,65,19,104,9,2%
2012-01,המרכז,41,אליכין,50,24,26,3,47,15,50,2,3%
2012-01,המרכז,1309,אלעד,391,163,228,23,368,113,390,18,3%
2012-01,המרכז,2530,באר יעקב,236,105,131,44,192,81,233,21,3%
2012-01,המרכז,466,בית דגן,96,46,50,15,81,34,96,7,3%
2012-01,המרכז,1066,"בני עי""ש",189,83,106,28,161,70,188,1,5%
2012-01,המרכז,681,גבעת שמואל,259,140,119,106,153,58,259,10,2%
2012-01,המרכז,2550,גדרה,381,170,211,82,299,102,372,5,3%
2012-01,המרכז,627,ג'לג'וליה,59,32,27,2,57,34,59,3,2%
2012-01,המרכז,166,גן יבנה,324,132,192,48,276,97,322,15,3%
2012-01,המרכז,229,גני תקווה,184,79,105,52,132,26,183,9,2%
2012-01,המרכז,9700,הוד השרון,583,251,332,237,346,62,582,33,2%
2012-01,המרכז,1290,זמר,168,62,106,8,160,125,168,13,6%
2012-01,המרכז,2730,טייבה,2244,955,1289,4,2240,1903,2232,45,14%
2012-01,המרכז,2720,טירה,331,177,154,9,322,184,330,15,3%
2012-01,המרכז,2660,יבנה,878,445,433,75,803,401,872,65,4%
2012-01,המרכז,9400,יהוד,510,203,307,72,438,82,488,39,3%
2012-01,המרכז,1224,כוכב יאיר,81,42,39,40,41,5,81,2,2%
2012-01,המרכז,633,כפר ברא,31,21,10,1,30,9,31,2,3%
2012-01,המרכז,168,כפר יונה,345,164,181,73,272,74,341,28,3%
2012-01,המרכז,6900,כפר סבא,1206,509,697,381,825,186,1197,66,2%
2012-01,המרכז,634,כפר קאסם,221,111,110,2,219,120,219,9,3%
2012-01,המרכז,7000,לוד,2353,1051,1302,161,2192,1371,2334,160,7%
2012-01,המרכז,1200,מודיעין-מכבים-רעות*,931,434,497,391,540,68,925,83,2%
2012-01,המרכז,28,מזכרת בתיה,153,73,80,42,111,34,151,3,2%
2012-01,המרכז,7200,נס ציונה,614,283,331,123,491,202,604,3,3%
2012-01,המרכז,7400,נתניה,4328,1970,2358,642,3686,1866,4281,405,4%
2012-01,המרכז,587,סביון*,14,4,10,9,5,1,14,2,1%
2012-01,המרכז,171,פרדסייה,74,39,35,19,55,8,74,6,2%
2012-01,המרכז,7900,פתח תקווה,3899,1793,2106,793,3106,1086,3864,221,3%
2012-01,המרכז,195,קדימה-צורן,228,93,135,62,166,41,226,25,2%
2012-01,המרכז,638,קלנסווה,910,336,574,1,909,787,908,25,12%
2012-01,המרכז,469,קריית עקרון,296,149,147,15,281,128,291,2,5%
2012-01,המרכז,2640,ראש העין,723,368,355,83,640,173,715,69,3%
2012-01,המרכז,8300,ראשון לציון,4405,1948,2457,898,3507,1642,4387,280,3%
2012-01,המרכז,8400,רחובות,2553,1148,1405,545,2008,1032,2522,29,4%
2012-01,המרכז,8500,רמלה,1804,835,969,100,1704,854,1773,142,5%
2012-01,המרכז,8700,רעננה,748,364,384,297,451,82,748,38,2%
2012-01,המרכז,1304,שוהם,185,84,101,83,102,8,184,17,2%
2012-01,המרכז,154,תל מונד,147,71,76,59,88,28,147,9,3%
2012-01,הצפון,473,אבו סנאן,747,290,457,6,741,632,743,21,14%
2012-01,הצפון,478,אכסאל,540,228,312,12,528,460,539,11,11%
2012-01,הצפון,529,אעבלין,624,253,371,8,616,530,624,20,12%
2012-01,הצפון,482,בועיינה-נוג'ידאת,450,194,256,5,445,400,446,7,13%
2012-01,הצפון,4001,בוקעאתא,379,142,237,6,373,335,370,7,14%
2012-01,הצפון,998,ביר אל-מכסור,425,165,260,3,422,335,425,14,13%
2012-01,הצפון,480,בית ג'ן,348,118,230,3,345,253,344,5,7%
2012-01,הצפון,9200,בית שאן,790,345,445,19,771,461,786,76,8%
2012-01,הצפון,944,בסמת טבעון,231,106,125,0,231,172,231,17,8%
2012-01,הצפון,483,בענה,403,157,246,3,400,369,403,6,13%
2012-01,הצפון,1292,ג'דיידה-מכר,1529,640,889,8,1521,1341,1526,46,18%
2012-01,הצפון,485,ג'ולס,203,50,153,2,201,148,203,20,8%
2012-01,הצפון,487,ג'ש (גוש חלב),52,26,26,2,50,24,51,2,3%
2012-01,הצפון,489,דבורייה,419,186,233,11,408,314,418,7,11%
2012-01,הצפון,490,דייר אל-אסד,404,169,235,10,394,340,404,6,9%
2012-01,הצפון,492,דייר חנא,663,280,383,9,654,534,663,24,15%
2012-01,הצפון,975,זרזיר,314,147,167,2,312,200,311,12,12%
2012-01,הצפון,496,חורפיש,123,50,73,7,116,84,122,3,5%
2012-01,הצפון,2034,חצור הגלילית,264,101,163,11,253,138,260,24,6%
2012-01,הצפון,6700,טבריה,1943,847,1096,116,1827,1293,1814,119,9%
2012-01,הצפון,962,טובא-זנגרייה,370,178,192,5,365,265,364,6,13%
2012-01,הצפון,498,טורעאן,532,200,332,13,519,465,530,22,11%
2012-01,הצפון,8900,טמרה,1981,798,1183,12,1969,1761,1978,64,15%
2012-01,הצפון,1295,יאנוח-ג'ת,169,60,109,3,166,122,169,7,7%
2012-01,הצפון,46,יבנאל,142,95,47,7,135,111,132,6,9%
2012-01,הצפון,499,יפיע,638,280,358,13,625,492,634,22,9%
2012-01,הצפון,240,יקנעם עילית,504,222,282,86,418,178,502,46,5%
2012-01,הצפון,502,ירכא,510,202,308,2,508,421,510,15,9%
2012-01,הצפון,504,כאבול,686,272,414,13,673,615,683,16,15%
2012-01,הצפון,505,כאוכב אבו אל-היג'א,230,96,134,6,224,195,230,9,15%
2012-01,הצפון,1296,כסרא-סמיע,258,100,158,1,257,212,257,15,8%
2012-01,הצפון,978,כעביה-טבאש-חג'אג'רה,220,92,128,5,215,145,218,9,11%
2012-01,הצפון,1263,כפר ורדים,82,40,42,34,48,9,82,2,3%
2012-01,הצפון,507,כפר יאסיף,509,211,298,6,503,422,509,23,11%
2012-01,הצפון,508,כפר כמא,72,27,45,2,70,42,70,3,5%
2012-01,הצפון,509,כפר כנא,1162,458,704,16,1146,1027,1151,69,14%
2012-01,הצפון,510,כפר מנדא,985,469,516,7,978,770,976,27,15%
2012-01,הצפון,47,כפר תבור,52,25,27,13,39,6,51,2,3%
2012-01,הצפון,1139,כרמיאל,1818,719,1099,367,1451,953,1761,86,7%
2012-01,הצפון,481,מגאר,1407,535,872,24,1383,1289,1403,61,17%
2012-01,הצפון,516,מג'ד אל-כרום,597,261,336,5,592,472,597,11,10%
2012-01,הצפון,874,מגדל העמק,1042,431,611,84,958,496,985,126,8%
2012-01,הצפון,4201,מג'דל שמס,503,191,312,13,490,408,498,18,11%
2012-01,הצפון,517,מזרעה,162,63,99,3,159,134,160,1,9%
2012-01,הצפון,4203,מסעדה,186,67,119,5,181,164,185,4,12%
2012-01,הצפון,518,מעיליא,50,26,24,5,45,27,50,2,3%
2012-01,הצפון,1063,מעלות-תרשיחא,899,405,494,113,786,598,897,41,8%
2012-01,הצפון,520,משהד,292,107,185,2,290,251,289,8,10%
2012-01,הצפון,9100,נהרייה,2124,949,1175,226,1898,1316,2109,100,7%
2012-01,הצפון,522,נחף,400,177,223,8,392,340,400,9,9%
2012-01,הצפון,7300,נצרת,2945,1255,1690,75,2870,2324,2929,100,10%
2012-01,הצפון,1061,נצרת עילית,2018,859,1159,286,1732,1171,1920,195,8%
2012-01,הצפון,525,סאג'ור,116,38,78,1,115,92,115,3,7%
2012-01,הצפון,7500,סח'נין,2018,881,1137,35,1983,1745,2017,54,16%
2012-01,הצפון,4501,ע'ג'ר,87,37,50,1,86,71,86,3,9%
2012-01,הצפון,530,עיילבון,195,83,112,5,190,140,194,9,8%
2012-01,הצפון,511,עילוט,326,140,186,6,320,253,325,15,13%
2012-01,הצפון,532,עין מאהל,607,281,326,10,597,520,599,7,13%
2012-01,הצפון,7600,עכו,3281,1469,1812,162,3119,2568,3257,143,13%
2012-01,הצפון,7700,עפולה,1834,769,1065,196,1638,946,1765,165,8%
2012-01,הצפון,531,עראבה,1397,564,833,31,1366,1253,1396,29,15%
2012-01,הצפון,535,פסוטה,112,49,63,5,107,86,112,8,7%
2012-01,הצפון,536,פקיעין (בוקייעה),141,67,74,3,138,97,139,5,5%
2012-01,הצפון,8000,צפת,1122,584,538,76,1046,824,1112,30,9%
2012-01,הצפון,4100,קצרין,204,82,122,31,173,100,202,17,5%
2012-01,הצפון,2800,קריית שמונה,731,349,382,70,661,301,713,80,6%
2012-01,הצפון,543,ראמה,312,128,184,3,309,254,312,3,9%
2012-01,הצפון,26,ראש פינה,58,21,37,13,45,23,58,2,4%
2012-01,הצפון,542,ריינה,617,244,373,9,608,523,612,24,10%
2012-01,הצפון,122,רמת ישי,101,41,60,37,64,12,100,3,3%
2012-01,הצפון,913,שבלי - אום אל-גנם,268,132,136,2,266,189,267,6,11%
2012-01,הצפון,812,שלומי,246,100,146,14,232,151,244,13,7%
2012-01,הצפון,538,שעב,472,191,281,5,467,421,471,16,17%
2012-01,הצפון,8800,שפרעם,2000,769,1231,28,1972,1701,1993,87,12%
2012-01,חיפה,2710,אום אל-פחם,3758,1528,2230,11,3747,3229,3754,46,20%
2012-01,חיפה,1020,אור עקיבא,631,271,360,43,588,245,617,70,6%
2012-01,חיפה,6000,באקה אל-גרביה,690,334,356,12,678,450,690,27,7%
2012-01,חיפה,9800,בנימינה-גבעת עדה*,195,84,111,61,134,51,192,19,3%
2012-01,חיפה,1326,"בסמ""ה",436,199,237,1,435,347,436,6,12%
2012-01,חיפה,541,ג'סר א-זרקא,424,259,165,1,423,294,422,12,8%
2012-01,חיפה,628,ג'ת,218,100,118,11,207,132,217,19,5%
2012-01,חיפה,494,דאלית אל-כרמל,497,200,297,12,485,317,494,22,7%
2012-01,חיפה,9300,זכרון יעקב,247,109,138,88,159,49,247,27,3%
2012-01,חיפה,6500,חדרה,2378,1080,1298,278,2100,960,2335,208,5%
2012-01,חיפה,4000,חיפה,7340,3406,3934,1412,5928,4503,7293,551,5%
2012-01,חיפה,1247,חריש,17,10,7,4,13,9,17,0,1%
2012-01,חיפה,2100,טירת כרמל,768,349,419,36,732,477,761,50,8%
2012-01,חיפה,654,כפר קרע,371,170,201,6,365,235,369,15,5%
2012-01,חיפה,1327,מעלה עירון,936,375,561,3,933,772,936,10,18%
2012-01,חיפה,2500,נשר,526,252,274,95,431,266,521,48,4%
2012-01,חיפה,534,עספיא,341,149,192,9,332,196,341,9,7%
2012-01,חיפה,637,ערערה,559,224,335,0,559,399,558,25,8%
2012-01,חיפה,537,פוריידיס,384,195,189,2,382,261,383,16,8%
2012-01,חיפה,7800,פרדס חנה-כרכור,852,400,452,145,707,294,846,116,5%
2012-01,חיפה,6800,קריית אתא,1791,770,1021,152,1639,1100,1784,117,6%
2012-01,חיפה,9500,קריית ביאליק,1153,488,665,124,1029,628,1148,72,6%
2012-01,חיפה,2300,קריית טבעון,190,97,93,71,119,45,187,12,2%
2012-01,חיפה,9600,קריית ים,1662,750,912,163,1499,1101,1656,111,8%
2012-01,חיפה,8200,קריית מוצקין,1126,469,657,178,948,589,1117,75,5%
2012-01,חיפה,922,רכסים,144,65,79,10,134,97,144,16,5%
2012-01,ירושלים,472,אבו גוש,243,114,129,6,237,174,243,6,9%
2012-01,ירושלים,2610,בית שמש,1180,514,666,125,1055,561,1173,87,4%
2012-01,ירושלים,3000,ירושלים,10465,4702,5763,1254,9211,6353,10404,408,4%
2012-01,ירושלים,1015,מבשרת ציון,329,143,186,47,282,150,327,14,3%
2012-01,ירושלים,1137,קריית יערים,36,11,25,3,33,15,36,0,3%
2012-01,תל אביב,2400,אור יהודה,777,367,410,35,742,305,763,56,4%
2012-01,תל אביב,565,אזור,167,82,85,32,135,38,163,17,3%
2012-01,תל אביב,6100,בני ברק,2265,1115,1150,107,2158,1385,2253,82,4%
2012-01,תל אביב,6200,בת ים,3417,1565,1852,476,2941,1457,3357,308,5%
2012-01,תל אביב,6300,גבעתיים,725,311,414,320,405,113,718,49,3%
2012-01,תל אביב,6400,הרצלייה,1040,484,556,331,709,83,1027,168,2%
2012-01,תל אביב,6600,חולון,3031,1423,1608,487,2544,982,2969,249,3%
2012-01,תל אביב,2620,קריית אונו,380,168,212,140,240,44,375,13,2%
2012-01,תל אביב,8600,רמת גן,2094,958,1136,680,1414,484,2075,137,3%
2012-01,תל אביב,2650,רמת השרון,415,182,233,188,227,17,410,51,2%
2012-01,תל אביב,5000,תל אביב -יפו,8001,3959,4042,2477,5524,2766,7924,498,3%
2012-02,אזור יהודה והשומרון,3760,אורנית,84,40,44,32,52,3,83,3,2%
2012-02,אזור יהודה והשומרון,3750,אלפי מנשה,90,37,53,21,69,1,89,5,2%
2012-02,אזור יהודה והשומרון,3560,אלקנה,27,12,15,14,13,3,27,0,2%
2012-02,אזור יהודה והשומרון,3650,אפרת,41,30,11,23,18,6,40,4,1%
2012-02,אזור יהודה והשומרון,3570,אריאל,420,219,201,99,321,103,420,51,4%
2012-02,אזור יהודה והשומרון,3574,בית אל,47,27,20,8,39,18,47,1,2%
2012-02,אזור יהודה והשומרון,3652,בית אריה,76,29,47,21,55,4,75,1,3%
2012-02,אזור יהודה והשומרון,3780,ביתר עילית,364,190,174,17,347,190,358,14,4%
2012-02,אזור יהודה והשומרון,3730,גבעת זאב,160,70,90,22,138,43,160,4,2%
2012-02,אזור יהודה והשומרון,3769,הר אדר,29,14,15,12,17,1,28,2,1%
2012-02,אזור יהודה והשומרון,3797,מודיעין עילית,335,132,203,13,322,100,334,17,3%
2012-02,אזור יהודה והשומרון,3616,מעלה אדומים,631,268,363,97,534,209,623,53,3%
2012-02,אזור יהודה והשומרון,3660,עמנואל,78,40,38,2,76,60,78,0,7%
2012-02,אזור יהודה והשומרון,3557,קדומים,30,13,17,11,19,7,30,2,2%
2012-02,אזור יהודה והשומרון,3611,קריית ארבע,107,48,59,15,92,68,107,3,4%
2012-02,אזור יהודה והשומרון,3640,קרני שומרון,91,46,45,20,71,20,90,2,3%
2012-02,הדרום,31,אופקים,1342,587,755,98,1244,970,1329,37,11%
2012-02,הדרום,2600,אילת,1698,775,923,67,1631,630,1684,104,5%
2012-02,הדרום,70,אשדוד,6789,2754,4035,764,6025,3970,6735,295,6%
2012-02,הדרום,7100,אשקלון,4206,1668,2538,608,3598,2671,4101,148,6%
2012-02,הדרום,9000,באר שבע,7195,3098,4097,978,6217,4682,7145,474,7%
2012-02,הדרום,2200,דימונה,2130,950,1180,126,2004,1555,2105,84,12%
2012-02,הדרום,1303,חורה,725,300,425,3,722,672,725,8,20%
2012-02,הדרום,831,ירוחם,435,204,231,23,412,295,426,30,10%
2012-02,הדרום,1059,כסיפה,983,420,563,6,977,903,981,20,24%
2012-02,הדרום,1271,להבים,34,17,17,21,13,3,34,6,1%
2012-02,הדרום,1060,לקיה,932,400,532,4,928,879,929,6,26%
2012-02,הדרום,1268,מיתר,67,27,40,26,41,6,64,10,2%
2012-02,הדרום,99,מצפה רמון,232,96,136,24,208,128,221,33,9%
2012-02,הדרום,246,נתיבות,849,365,484,48,801,501,840,50,7%
2012-02,הדרום,666,עומר,67,23,44,22,45,11,67,8,2%
2012-02,הדרום,2560,ערד,858,366,492,178,680,502,844,84,7%
2012-02,הדרום,1192,ערערה-בנגב,959,387,572,4,955,909,957,7,26%
2012-02,הדרום,2630,קריית גת,2352,945,1407,192,2160,1559,2346,88,9%
2012-02,הדרום,1034,קריית מלאכי,1208,556,652,28,1180,815,1193,91,11%
2012-02,הדרום,1161,רהט,2955,1180,1775,8,2947,2666,2955,55,18%
2012-02,הדרום,1286,שגב-שלום,473,170,303,0,473,447,472,4,20%
2012-02,הדרום,1031,שדרות,1047,450,597,63,984,682,1042,62,9%
2012-02,הדרום,1054,תל שבע,1124,523,601,2,1122,1064,1124,16,26%
2012-02,המרכז,182,אבן יהודה,119,68,51,37,82,22,118,8,2%
2012-02,המרכז,41,אליכין,48,23,25,3,45,15,48,4,3%
2012-02,המרכז,1309,אלעד,358,155,203,18,340,112,358,11,3%
2012-02,המרכז,2530,באר יעקב,240,101,139,42,198,67,236,15,3%
2012-02,המרכז,466,בית דגן,98,47,51,20,78,34,98,7,3%
2012-02,המרכז,1066,"בני עי""ש",192,86,106,27,165,80,190,1,5%
2012-02,המרכז,681,גבעת שמואל,257,139,118,101,156,57,256,13,2%
2012-02,המרכז,2550,גדרה,359,161,198,72,287,104,350,3,3%
2012-02,המרכז,627,ג'לג'וליה,67,35,32,2,65,37,67,3,2%
2012-02,המרכז,166,גן יבנה,318,122,196,39,279,96,317,10,3%
2012-02,המרכז,229,גני תקווה,185,84,101,60,125,27,184,8,2%
2012-02,המרכז,9700,הוד השרון,599,271,328,235,364,64,596,23,2%
2012-02,המרכז,1290,זמר,165,62,103,7,158,124,165,5,6%
2012-02,המרכז,2730,טייבה,2229,947,1282,4,2225,1891,2213,36,14%
2012-02,המרכז,2720,טירה,337,164,173,10,327,181,336,8,3%
2012-02,המרכז,2660,יבנה,802,392,410,65,737,397,799,29,4%
2012-02,המרכז,9400,יהוד,491,208,283,66,425,83,474,38,3%
2012-02,המרכז,1224,כוכב יאיר,92,56,36,44,48,4,91,1,2%
2012-02,המרכז,633,כפר ברא,26,15,11,2,24,10,25,2,2%
2012-02,המרכז,168,כפר יונה,324,152,172,70,254,78,322,28,3%
2012-02,המרכז,6900,כפר סבא,1178,493,685,378,800,190,1164,58,2%
2012-02,המרכז,634,כפר קאסם,214,108,106,2,212,118,214,9,3%
2012-02,המרכז,7000,לוד,2227,1008,1219,163,2064,1279,2218,143,7%
2012-02,המרכז,1200,מודיעין-מכבים-רעות*,885,397,488,369,516,69,878,56,2%
2012-02,המרכז,28,מזכרת בתיה,148,75,73,39,109,35,148,0,2%
2012-02,המרכז,7200,נס ציונה,610,282,328,118,492,206,604,4,3%
2012-02,המרכז,7400,נתניה,4072,1880,2192,621,3451,1737,4028,329,4%
2012-02,המרכז,587,סביון*,13,2,11,10,3,1,13,2,1%
2012-02,המרכז,171,פרדסייה,68,32,36,18,50,8,68,7,2%
2012-02,המרכז,7900,פתח תקווה,3827,1739,2088,752,3075,1088,3791,222,3%
2012-02,המרכז,195,קדימה-צורן,206,87,119,59,147,35,206,9,2%
2012-02,המרכז,638,קלנסווה,876,324,552,1,875,766,874,16,11%
2012-02,המרכז,469,קריית עקרון,291,136,155,19,272,128,288,3,5%
2012-02,המרכז,2640,ראש העין,679,337,342,80,599,167,673,49,3%
2012-02,המרכז,8300,ראשון לציון,4354,1963,2391,900,3454,1649,4344,229,3%
2012-02,המרכז,8400,רחובות,2467,1097,1370,498,1969,1027,2434,15,4%
2012-02,המרכז,8500,רמלה,1694,824,870,101,1593,819,1668,128,5%
2012-02,המרכז,8700,רעננה,733,347,386,295,438,71,731,40,2%
2012-02,המרכז,1304,שוהם,175,83,92,78,97,5,173,18,2%
2012-02,המרכז,154,תל מונד,151,69,82,55,96,30,151,5,3%
2012-02,הצפון,473,אבו סנאן,740,285,455,5,735,633,736,22,14%
2012-02,הצפון,478,אכסאל,545,233,312,15,530,460,543,16,11%
2012-02,הצפון,529,אעבלין,625,257,368,11,614,534,625,9,12%
2012-02,הצפון,482,בועיינה-נוג'ידאת,455,194,261,5,450,404,449,13,13%
2012-02,הצפון,4001,בוקעאתא,385,145,240,8,377,337,376,5,15%
2012-02,הצפון,998,ביר אל-מכסור,424,159,265,4,420,342,424,9,13%
2012-02,הצפון,480,בית ג'ן,355,117,238,2,353,254,352,9,7%
2012-02,הצפון,9200,בית שאן,775,346,429,19,756,445,772,87,8%
2012-02,הצפון,944,בסמת טבעון,210,91,119,0,210,168,210,9,7%
2012-02,הצפון,483,בענה,409,158,251,4,405,373,409,9,13%
2012-02,הצפון,1292,ג'דיידה-מכר,1507,618,889,7,1500,1316,1505,29,18%
2012-02,הצפון,485,ג'ולס,192,52,140,3,189,151,192,10,7%
2012-02,הצפון,487,ג'ש (גוש חלב),53,26,27,2,51,26,52,1,3%
2012-02,הצפון,489,דבורייה,407,184,223,14,393,305,407,4,10%
2012-02,הצפון,490,דייר אל-אסד,388,154,234,8,380,331,388,20,8%
2012-02,הצפון,492,דייר חנא,661,281,380,10,651,530,661,29,15%
2012-02,הצפון,975,זרזיר,307,138,169,3,304,200,303,5,11%
2012-02,הצפון,496,חורפיש,118,55,63,6,112,79,116,6,5%
2012-02,הצפון,2034,חצור הגלילית,269,102,167,13,256,131,263,16,6%
2012-02,הצפון,6700,טבריה,1914,844,1070,104,1810,1281,1785,106,9%
2012-02,הצפון,962,טובא-זנגרייה,368,174,194,6,362,274,364,2,13%
2012-02,הצפון,498,טורעאן,529,200,329,11,518,459,527,24,10%
2012-02,הצפון,8900,טמרה,1949,790,1159,10,1939,1739,1941,23,15%
2012-02,הצפון,1295,יאנוח-ג'ת,153,53,100,3,150,110,153,12,6%
2012-02,הצפון,46,יבנאל,145,90,55,9,136,112,136,2,9%
2012-02,הצפון,499,יפיע,643,287,356,14,629,498,640,21,9%
2012-02,הצפון,240,יקנעם עילית,510,220,290,86,424,181,509,54,5%
2012-02,הצפון,502,ירכא,538,209,329,2,536,425,538,20,10%
2012-02,הצפון,504,כאבול,692,273,419,10,682,613,688,10,15%
2012-02,הצפון,505,כאוכב אבו אל-היג'א,225,96,129,5,220,189,225,11,14%
2012-02,הצפון,1296,כסרא-סמיע,220,97,123,1,219,167,220,14,7%
2012-02,הצפון,978,כעביה-טבאש-חג'אג'רה,214,80,134,6,208,149,213,4,11%
2012-02,הצפון,1263,כפר ורדים,71,38,33,30,41,7,71,2,2%
2012-02,הצפון,507,כפר יאסיף,503,203,300,5,498,422,503,15,11%
2012-02,הצפון,508,כפר כמא,74,29,45,2,72,40,72,0,5%
2012-02,הצפון,509,כפר כנא,1156,441,715,18,1138,1026,1148,55,14%
2012-02,הצפון,510,כפר מנדא,1011,470,541,9,1002,765,1004,24,15%
2012-02,הצפון,47,כפר תבור,48,19,29,11,37,5,48,0,3%
2012-02,הצפון,1139,כרמיאל,1771,696,1075,354,1417,935,1720,102,7%
2012-02,הצפון,481,מגאר,1422,544,878,19,1403,1293,1420,73,17%
2012-02,הצפון,516,מג'ד אל-כרום,586,258,328,6,580,469,586,26,10%
2012-02,הצפון,874,מגדל העמק,965,415,550,87,878,495,917,82,7%
2012-02,הצפון,4201,מג'דל שמס,495,187,308,13,482,403,489,12,11%
2012-02,הצפון,517,מזרעה,186,76,110,3,183,147,185,5,10%
2012-02,הצפון,4203,מסעדה,192,70,122,9,183,164,191,4,12%
2012-02,הצפון,518,מעיליא,55,31,24,4,51,27,54,3,4%
2012-02,הצפון,1063,מעלות-תרשיחא,898,428,470,117,781,567,894,36,8%
2012-02,הצפון,520,משהד,284,108,176,4,280,246,281,9,10%
2012-02,הצפון,9100,נהרייה,2071,956,1115,232,1839,1281,2060,101,7%
2012-02,הצפון,522,נחף,406,180,226,6,400,343,406,11,9%
2012-02,הצפון,7300,נצרת,2953,1264,1689,82,2871,2323,2938,77,10%
2012-02,הצפון,1061,נצרת עילית,1938,830,1108,253,1685,1132,1843,175,8%
2012-02,הצפון,525,סאג'ור,120,42,78,2,118,88,120,4,7%
2012-02,הצפון,7500,סח'נין,2035,910,1125,36,1999,1749,2035,47,16%
2012-02,הצפון,4501,ע'ג'ר,78,30,48,2,76,64,78,1,8%
2012-02,הצפון,530,עיילבון,189,81,108,6,183,137,188,4,8%
2012-02,הצפון,511,עילוט,321,134,187,5,316,247,320,12,12%
2012-02,הצפון,532,עין מאהל,580,263,317,12,568,489,573,9,13%
2012-02,הצפון,7600,עכו,3310,1496,1814,165,3145,2602,3285,147,13%
2012-02,הצפון,7700,עפולה,1733,731,1002,194,1539,900,1674,144,7%
2012-02,הצפון,531,עראבה,1419,595,824,29,1390,1253,1418,28,16%
2012-02,הצפון,535,פסוטה,103,47,56,3,100,78,103,3,7%
2012-02,הצפון,536,פקיעין (בוקייעה),134,68,66,3,131,95,133,5,5%
2012-02,הצפון,8000,צפת,1094,571,523,70,1024,817,1082,22,9%
2012-02,הצפון,4100,קצרין,191,88,103,34,157,100,189,12,5%
2012-02,הצפון,2800,קריית שמונה,683,323,360,59,624,283,662,104,5%
2012-02,הצפון,543,ראמה,314,129,185,5,309,258,313,6,9%
2012-02,הצפון,26,ראש פינה,56,18,38,11,45,22,55,6,4%
2012-02,הצפון,542,ריינה,632,250,382,8,624,533,626,28,10%
2012-02,הצפון,122,רמת ישי,110,44,66,41,69,9,110,3,3%
2012-02,הצפון,913,שבלי - אום אל-גנם,259,118,141,2,257,183,258,8,11%
2012-02,הצפון,812,שלומי,256,103,153,13,243,159,254,15,7%
2012-02,הצפון,538,שעב,463,181,282,6,457,417,463,9,17%
2012-02,הצפון,8800,שפרעם,2012,779,1233,30,1982,1723,2007,37,12%
2012-02,חיפה,2710,אום אל-פחם,3766,1530,2236,12,3754,3257,3760,50,20%
2012-02,חיפה,1020,אור עקיבא,635,273,362,44,591,242,623,72,7%
2012-02,חיפה,6000,באקה אל-גרביה,703,348,355,14,689,441,703,32,7%
2012-02,חיפה,9800,בנימינה-גבעת עדה*,179,81,98,53,126,56,178,15,3%
2012-02,חיפה,1326,"בסמ""ה",436,198,238,1,435,347,436,6,12%
2012-02,חיפה,541,ג'סר א-זרקא,429,260,169,2,427,292,426,14,8%
2012-02,חיפה,628,ג'ת,218,101,117,14,204,134,217,5,5%
2012-02,חיפה,494,דאלית אל-כרמל,479,198,281,12,467,307,475,18,7%
2012-02,חיפה,9300,זכרון יעקב,240,104,136,86,154,48,240,10,2%
2012-02,חיפה,6500,חדרה,2309,1037,1272,262,2047,961,2272,147,5%
2012-02,חיפה,4000,חיפה,7122,3313,3809,1361,5761,4379,7074,535,5%
2012-02,חיפה,1247,חריש,18,9,9,3,15,9,18,1,1%
2012-02,חיפה,2100,טירת כרמל,750,358,392,36,714,458,746,51,7%
2012-02,חיפה,654,כפר קרע,378,173,205,10,368,235,376,14,5%
2012-02,חיפה,1327,מעלה עירון,942,380,562,4,938,775,942,18,18%
2012-02,חיפה,2500,נשר,500,243,257,81,419,269,496,49,4%
2012-02,חיפה,534,עספיא,324,142,182,7,317,189,322,12,6%
2012-02,חיפה,637,ערערה,557,227,330,2,555,395,556,24,8%
2012-02,חיפה,537,פוריידיס,374,180,194,3,371,258,373,18,7%
2012-02,חיפה,7800,פרדס חנה-כרכור,795,366,429,137,658,277,778,106,4%
2012-02,חיפה,6800,קריית אתא,1761,766,995,140,1621,1081,1755,118,6%
2012-02,חיפה,9500,קריית ביאליק,1197,502,695,133,1064,636,1190,95,6%
2012-02,חיפה,2300,קריית טבעון,184,92,92,70,114,39,181,24,2%
2012-02,חיפה,9600,קריית ים,1643,725,918,172,1471,1097,1640,99,8%
2012-02,חיפה,8200,קריית מוצקין,1095,445,650,161,934,577,1089,83,5%
2012-02,חיפה,922,רכסים,131,63,68,8,123,85,131,8,4%
2012-02,ירושלים,472,אבו גוש,243,114,129,8,235,180,243,4,9%
2012-02,ירושלים,2610,בית שמש,1129,484,645,116,1013,531,1121,79,4%
2012-02,ירושלים,3000,ירושלים,9975,4464,5511,1193,8782,6244,9933,305,4%
2012-02,ירושלים,1015,מבשרת ציון,343,157,186,51,292,172,343,11,3%
2012-02,ירושלים,1137,קריית יערים,30,11,19,6,24,14,28,0,2%
2012-02,תל אביב,2400,אור יהודה,764,353,411,32,732,296,757,63,4%
2012-02,תל אביב,565,אזור,156,73,83,27,129,36,152,11,3%
2012-02,תל אביב,6100,בני ברק,2196,1093,1103,99,2097,1337,2183,63,4%
2012-02,תל אביב,6200,בת ים,3295,1528,1767,472,2823,1354,3240,254,5%
2012-02,תל אביב,6300,גבעתיים,715,331,384,314,401,104,710,42,3%
2012-02,תל אביב,6400,הרצלייה,1004,472,532,313,691,86,983,137,2%
2012-02,תל אביב,6600,חולון,2982,1408,1574,488,2494,946,2923,215,3%
2012-02,תל אביב,2620,קריית אונו,360,163,197,130,230,44,355,14,2%
2012-02,תל אביב,8600,רמת גן,2063,935,1128,639,1424,457,2043,153,3%
2012-02,תל אביב,2650,רמת השרון,425,195,230,188,237,19,423,44,2%
2012-02,תל אביב,5000,תל אביב -יפו,7715,3936,3779,2391,5324,2669,7664,465,3%
2012-03,אזור יהודה והשומרון,3760,אורנית,93,36,57,31,62,2,92,8,2%
2012-03,אזור יהודה והשומרון,3750,אלפי מנשה,89,34,55,25,64,2,89,3,2%
2012-03,אזור יהודה והשומרון,3560,אלקנה,24,11,13,14,10,2,24,2,1%
2012-03,אזור יהודה והשומרון,3650,אפרת,46,28,18,21,25,6,46,1,1%
2012-03,אזור יהודה והשומרון,3570,אריאל,424,220,204,107,317,103,422,21,4%
2012-03,אזור יהודה והשומרון,3574,בית אל,43,23,20,9,34,17,43,4,2%
2012-03,אזור יהודה והשומרון,3652,בית אריה,73,26,47,17,56,4,73,7,3%
2012-03,אזור יהודה והשומרון,3780,ביתר עילית,374,196,178,16,358,195,370,8,4%
2012-03,אזור יהודה והשומרון,3730,גבעת זאב,171,71,100,27,144,41,170,13,3%
2012-03,אזור יהודה והשומרון,3769,הר אדר,26,15,11,12,14,2,26,3,1%
2012-03,אזור יהודה והשומרון,3797,מודיעין עילית,352,131,221,16,336,99,350,24,3%
2012-03,אזור יהודה והשומרון,3616,מעלה אדומים,638,279,359,98,540,208,632,52,3%
2012-03,אזור יהודה והשומרון,3660,עמנואל,77,38,39,2,75,58,77,3,7%
2012-03,אזור יהודה והשומרון,3557,קדומים,28,14,14,11,17,6,28,1,2%
2012-03,אזור יהודה והשומרון,3611,קריית ארבע,99,46,53,14,85,63,99,4,3%
2012-03,אזור יהודה והשומרון,3640,קרני שומרון,93,44,49,21,72,23,92,7,3%
2012-03,הדרום,31,אופקים,1311,576,735,96,1215,972,1303,41,11%
2012-03,הדרום,2600,אילת,1610,744,866,65,1545,628,1593,117,5%
2012-03,הדרום,70,אשדוד,6703,2773,3930,767,5936,3932,6657,243,6%
2012-03,הדרום,7100,אשקלון,4354,1758,2596,618,3736,2689,4246,288,7%
2012-03,הדרום,9000,באר שבע,7171,3129,4042,987,6184,4667,7119,429,7%
2012-03,הדרום,2200,דימונה,2117,937,1180,136,1981,1538,2086,86,12%
2012-03,הדרום,1303,חורה,729,302,427,3,726,679,729,14,21%
2012-03,הדרום,831,ירוחם,461,224,237,23,438,298,453,44,11%
2012-03,הדרום,1059,כסיפה,976,411,565,7,969,900,974,19,24%
2012-03,הדרום,1271,להבים,32,17,15,20,12,3,32,5,1%
2012-03,הדרום,1060,לקיה,964,413,551,4,960,891,960,25,27%
2012-03,הדרום,1268,מיתר,55,26,29,22,33,6,54,3,1%
2012-03,הדרום,99,מצפה רמון,230,95,135,20,210,124,218,31,9%
2012-03,הדרום,246,נתיבות,856,381,475,48,808,506,849,50,7%
2012-03,הדרום,666,עומר,62,19,43,24,38,10,62,5,2%
2012-03,הדרום,2560,ערד,860,364,496,178,682,487,834,89,7%
2012-03,הדרום,1192,ערערה-בנגב,955,387,568,4,951,912,953,7,25%
2012-03,הדרום,2630,קריית גת,2334,940,1394,190,2144,1540,2327,93,9%
2012-03,הדרום,1034,קריית מלאכי,1177,526,651,22,1155,793,1164,84,10%
2012-03,הדרום,1161,רהט,2965,1198,1767,7,2958,2670,2965,50,18%
2012-03,הדרום,1286,שגב-שלום,491,182,309,0,491,451,490,22,20%
2012-03,הדרום,1031,שדרות,1009,441,568,55,954,673,1004,53,8%
2012-03,הדרום,1054,תל שבע,1136,519,617,2,1134,1079,1135,9,26%
2012-03,המרכז,182,אבן יהודה,119,65,54,39,80,21,118,8,2%
2012-03,המרכז,41,אליכין,41,20,21,3,38,19,41,2,2%
2012-03,המרכז,1309,אלעד,341,147,194,19,322,108,341,12,3%
2012-03,המרכז,2530,באר יעקב,235,100,135,41,194,74,230,12,3%
2012-03,המרכז,466,בית דגן,96,51,45,18,78,31,96,3,3%
2012-03,המרכז,1066,"בני עי""ש",185,82,103,30,155,80,183,2,5%
2012-03,המרכז,681,גבעת שמואל,243,137,106,103,140,55,243,17,2%
2012-03,המרכז,2550,גדרה,335,152,183,64,271,96,330,3,3%
2012-03,המרכז,627,ג'לג'וליה,77,34,43,2,75,42,77,2,3%
2012-03,המרכז,166,גן יבנה,314,119,195,36,278,97,314,12,3%
2012-03,המרכז,229,גני תקווה,183,85,98,67,116,28,182,10,2%
2012-03,המרכז,9700,הוד השרון,615,296,319,246,369,65,615,45,2%
2012-03,המרכז,1290,זמר,170,64,106,5,165,123,170,13,6%
2012-03,המרכז,2730,טייבה,2250,944,1306,4,2246,1913,2240,36,14%
2012-03,המרכז,2720,טירה,381,164,217,10,371,196,380,16,4%
2012-03,המרכז,2660,יבנה,848,425,423,65,783,396,846,53,4%
2012-03,המרכז,9400,יהוד,458,187,271,67,391,77,446,37,3%
2012-03,המרכז,1224,כוכב יאיר,93,59,34,44,49,3,93,7,2%
2012-03,המרכז,633,כפר ברא,26,18,8,1,25,10,26,2,2%
2012-03,המרכז,168,כפר יונה,321,148,173,69,252,73,320,19,3%
2012-03,המרכז,6900,כפר סבא,1206,524,682,376,830,191,1192,67,2%
2012-03,המרכז,634,כפר קאסם,212,109,103,2,210,117,212,10,3%
2012-03,המרכז,7000,לוד,2210,1007,1203,180,2030,1264,2203,114,6%
2012-03,המרכז,1200,מודיעין-מכבים-רעות*,899,407,492,375,524,66,892,51,2%
2012-03,המרכז,28,מזכרת בתיה,149,76,73,41,108,37,148,1,2%
2012-03,המרכז,7200,נס ציונה,613,270,343,126,487,198,607,3,3%
2012-03,המרכז,7400,נתניה,4024,1896,2128,604,3420,1688,3989,295,4%
2012-03,המרכז,587,סביון*,12,1,11,8,4,1,12,0,1%
2012-03,המרכז,171,פרדסייה,68,31,37,19,49,8,68,2,2%
2012-03,המרכז,7900,פתח תקווה,3888,1758,2130,752,3136,1094,3866,247,3%
2012-03,המרכז,195,קדימה-צורן,204,86,118,55,149,31,203,11,2%
2012-03,המרכז,638,קלנסווה,890,327,563,2,888,774,885,19,11%
2012-03,המרכז,469,קריית עקרון,274,129,145,20,254,130,273,4,5%
2012-03,המרכז,2640,ראש העין,700,357,343,89,611,169,691,44,3%
2012-03,המרכז,8300,ראשון לציון,4407,1970,2437,916,3491,1630,4394,271,3%
2012-03,המרכז,8400,רחובות,2448,1091,1357,486,1962,1022,2412,16,4%
2012-03,המרכז,8500,רמלה,1640,798,842,101,1539,800,1611,110,5%
2012-03,המרכז,8700,רעננה,750,379,371,301,449,79,748,40,2%
2012-03,המרכז,1304,שוהם,178,85,93,83,95,5,178,19,2%
2012-03,המרכז,154,תל מונד,163,78,85,69,94,30,163,5,3%
2012-03,הצפון,473,אבו סנאן,754,295,459,5,749,640,749,22,14%
2012-03,הצפון,478,אכסאל,540,227,313,13,527,458,540,16,11%
2012-03,הצפון,529,אעבלין,629,259,370,12,617,530,629,22,12%
2012-03,הצפון,482,בועיינה-נוג'ידאת,469,188,281,3,466,401,464,9,13%
2012-03,הצפון,4001,בוקעאתא,387,145,242,7,380,339,380,9,15%
2012-03,הצפון,998,ביר אל-מכסור,419,158,261,3,416,336,419,4,13%
2012-03,הצפון,480,בית ג'ן,362,120,242,3,359,259,359,12,7%
2012-03,הצפון,9200,בית שאן,785,369,416,24,761,459,784,78,8%
2012-03,הצפון,944,בסמת טבעון,214,95,119,0,214,176,213,10,8%
2012-03,הצפון,483,בענה,407,160,247,3,404,372,407,8,13%
2012-03,הצפון,1292,ג'דיידה-מכר,1523,635,888,9,1514,1332,1521,45,18%
2012-03,הצפון,485,ג'ולס,198,56,142,3,195,158,198,12,8%
2012-03,הצפון,487,ג'ש (גוש חלב),53,25,28,3,50,28,52,0,3%
2012-03,הצפון,489,דבורייה,405,181,224,13,392,305,405,3,10%
2012-03,הצפון,490,דייר אל-אסד,396,157,239,6,390,335,396,8,9%
2012-03,הצפון,492,דייר חנא,672,286,386,17,655,539,672,34,15%
2012-03,הצפון,975,זרזיר,303,136,167,2,301,205,300,17,11%
2012-03,הצפון,496,חורפיש,124,54,70,5,119,88,122,6,5%
2012-03,הצפון,2034,חצור הגלילית,260,99,161,13,247,133,254,8,6%
2012-03,הצפון,6700,טבריה,1885,847,1038,105,1780,1260,1758,101,8%
2012-03,הצפון,962,טובא-זנגרייה,374,179,195,5,369,277,369,10,13%
2012-03,הצפון,498,טורעאן,544,203,341,12,532,472,540,32,11%
2012-03,הצפון,8900,טמרה,1966,794,1172,10,1956,1753,1963,36,15%
2012-03,הצפון,1295,יאנוח-ג'ת,157,57,100,3,154,106,157,6,6%
2012-03,הצפון,46,יבנאל,140,86,54,11,129,104,131,2,9%
2012-03,הצפון,499,יפיע,631,280,351,9,622,493,628,33,9%
2012-03,הצפון,240,יקנעם עילית,504,220,284,89,415,175,502,47,5%
2012-03,הצפון,502,ירכא,546,217,329,2,544,448,546,15,10%
2012-03,הצפון,504,כאבול,694,270,424,9,685,608,689,14,15%
2012-03,הצפון,505,כאוכב אבו אל-היג'א,225,98,127,6,219,186,225,7,14%
2012-03,הצפון,1296,כסרא-סמיע,219,100,119,1,218,161,218,18,7%
2012-03,הצפון,978,כעביה-טבאש-חג'אג'רה,223,90,133,5,218,149,219,8,11%
2012-03,הצפון,1263,כפר ורדים,64,31,33,26,38,6,64,3,2%
2012-03,הצפון,507,כפר יאסיף,511,206,305,5,506,422,510,11,11%
2012-03,הצפון,508,כפר כמא,72,28,44,0,72,41,70,3,5%
2012-03,הצפון,509,כפר כנא,1173,441,732,21,1152,1041,1164,48,15%
2012-03,הצפון,510,כפר מנדא,1015,468,547,11,1004,761,1005,39,15%
2012-03,הצפון,47,כפר תבור,50,21,29,9,41,7,50,0,3%
2012-03,הצפון,1139,כרמיאל,1749,687,1062,345,1404,912,1696,105,7%
2012-03,הצפון,481,מגאר,1427,532,895,20,1407,1305,1424,53,17%
2012-03,הצפון,516,מג'ד אל-כרום,574,250,324,7,567,463,574,25,10%
2012-03,הצפון,874,מגדל העמק,938,387,551,86,852,477,902,77,7%
2012-03,הצפון,4201,מג'דל שמס,481,181,300,13,468,399,474,10,11%
2012-03,הצפון,517,מזרעה,189,78,111,4,185,151,188,5,10%
2012-03,הצפון,4203,מסעדה,190,68,122,9,181,164,189,5,12%
2012-03,הצפון,518,מעיליא,50,31,19,5,45,25,50,1,3%
2012-03,הצפון,1063,מעלות-תרשיחא,891,423,468,115,776,561,888,47,8%
2012-03,הצפון,520,משהד,293,113,180,6,287,255,289,7,10%
2012-03,הצפון,9100,נהרייה,2060,947,1113,232,1828,1293,2051,87,7%
2012-03,הצפון,522,נחף,406,180,226,7,399,339,406,14,9%
2012-03,הצפון,7300,נצרת,2959,1267,1692,84,2875,2345,2946,77,10%
2012-03,הצפון,1061,נצרת עילית,1901,823,1078,259,1642,1105,1804,179,8%
2012-03,הצפון,525,סאג'ור,121,45,76,3,118,88,121,1,7%
2012-03,הצפון,7500,סח'נין,2047,906,1141,33,2014,1757,2047,52,16%
2012-03,הצפון,4501,ע'ג'ר,84,32,52,2,82,69,83,4,9%
2012-03,הצפון,530,עיילבון,192,85,107,5,187,138,191,16,8%
2012-03,הצפון,511,עילוט,309,126,183,6,303,242,308,11,12%
2012-03,הצפון,532,עין מאהל,591,267,324,10,581,498,583,10,13%
2012-03,הצפון,7600,עכו,3286,1486,1800,159,3127,2600,3255,146,13%
2012-03,הצפון,7700,עפולה,1694,708,986,180,1514,880,1640,156,7%
2012-03,הצפון,531,עראבה,1395,581,814,24,1371,1247,1394,27,15%
2012-03,הצפון,535,פסוטה,110,47,63,4,106,83,110,4,7%
2012-03,הצפון,536,פקיעין (בוקייעה),129,69,60,2,127,88,128,8,5%
2012-03,הצפון,8000,צפת,1108,585,523,70,1038,838,1098,24,9%
2012-03,הצפון,4100,קצרין,183,85,98,37,146,91,182,18,5%
2012-03,הצפון,2800,קריית שמונה,641,292,349,62,579,285,621,83,5%
2012-03,הצפון,543,ראמה,316,129,187,4,312,264,313,5,9%
2012-03,הצפון,26,ראש פינה,60,23,37,11,49,24,60,1,4%
2012-03,הצפון,542,ריינה,639,248,391,11,628,530,634,20,10%
2012-03,הצפון,122,רמת ישי,105,39,66,35,70,14,104,3,3%
2012-03,הצפון,913,שבלי - אום אל-גנם,263,126,137,2,261,184,260,7,11%
2012-03,הצפון,812,שלומי,263,109,154,15,248,154,260,18,7%
2012-03,הצפון,538,שעב,470,187,283,6,464,421,470,10,17%
2012-03,הצפון,8800,שפרעם,2024,769,1255,34,1990,1736,2018,48,12%
2012-03,חיפה,2710,אום אל-פחם,3778,1544,2234,16,3762,3263,3773,75,20%
2012-03,חיפה,1020,אור עקיבא,589,256,333,40,549,233,583,70,6%
2012-03,חיפה,6000,באקה אל-גרביה,697,345,352,16,681,442,697,40,7%
2012-03,חיפה,9800,בנימינה-גבעת עדה*,180,79,101,54,126,51,178,12,3%
2012-03,חיפה,1326,"בסמ""ה",422,187,235,1,421,342,422,7,12%
2012-03,חיפה,541,ג'סר א-זרקא,423,248,175,2,421,293,421,18,8%
2012-03,חיפה,628,ג'ת,214,99,115,11,203,133,213,10,5%
2012-03,חיפה,494,דאלית אל-כרמל,490,207,283,13,477,295,486,22,7%
2012-03,חיפה,9300,זכרון יעקב,232,102,130,81,151,48,230,27,2%
2012-03,חיפה,6500,חדרה,2388,1048,1340,265,2123,1006,2345,103,5%
2012-03,חיפה,4000,חיפה,7098,3322,3776,1341,5757,4323,7042,575,5%
2012-03,חיפה,1247,חריש,17,9,8,3,14,9,16,2,1%
2012-03,חיפה,2100,טירת כרמל,745,353,392,36,709,474,739,57,7%
2012-03,חיפה,654,כפר קרע,383,167,216,9,374,237,381,24,5%
2012-03,חיפה,1327,מעלה עירון,936,373,563,4,932,776,936,13,18%
2012-03,חיפה,2500,נשר,500,246,254,78,422,261,498,45,4%
2012-03,חיפה,534,עספיא,325,141,184,6,319,196,321,12,6%
2012-03,חיפה,637,ערערה,565,235,330,2,563,390,565,29,8%
2012-03,חיפה,537,פוריידיס,377,179,198,4,373,259,376,16,7%
2012-03,חיפה,7800,פרדס חנה-כרכור,783,362,421,131,652,270,771,110,4%
2012-03,חיפה,6800,קריית אתא,1719,757,962,139,1580,1051,1711,108,6%
2012-03,חיפה,9500,קריית ביאליק,1161,485,676,137,1024,625,1154,75,6%
2012-03,חיפה,2300,קריית טבעון,183,88,95,61,122,42,181,19,2%
2012-03,חיפה,9600,קריית ים,1657,740,917,172,1485,1094,1652,100,8%
2012-03,חיפה,8200,קריית מוצקין,1060,432,628,156,904,568,1054,83,5%
2012-03,חיפה,922,רכסים,133,68,65,9,124,82,132,4,4%
2012-03,ירושלים,472,אבו גוש,241,120,121,5,236,179,241,7,9%
2012-03,ירושלים,2610,בית שמש,1088,474,614,123,965,536,1082,66,4%
2012-03,ירושלים,3000,ירושלים,10076,4496,5580,1194,8882,6311,10032,371,4%
2012-03,ירושלים,1015,מבשרת ציון,347,166,181,47,300,166,347,25,3%
2012-03,ירושלים,1137,קריית יערים,29,12,17,4,25,16,29,1,3%
2012-03,תל אביב,2400,אור יהודה,748,362,386,35,713,292,738,61,4%
2012-03,תל אביב,565,אזור,150,69,81,23,127,39,147,17,2%
2012-03,תל אביב,6100,בני ברק,2204,1116,1088,107,2097,1337,2194,87,4%
2012-03,תל אביב,6200,בת ים,3271,1508,1763,470,2801,1337,3221,270,5%
2012-03,תל אביב,6300,גבעתיים,714,344,370,313,401,105,705,45,3%
2012-03,תל אביב,6400,הרצלייה,1026,479,547,311,715,57,1019,143,2%
2012-03,תל אביב,6600,חולון,2961,1415,1546,469,2492,941,2915,242,3%
2012-03,תל אביב,2620,קריית אונו,356,163,193,133,223,41,353,26,2%
2012-03,תל אביב,8600,רמת גן,1995,892,1103,614,1381,464,1979,128,3%
2012-03,תל אביב,2650,רמת השרון,392,187,205,185,207,16,388,34,2%
2012-03,תל אביב,5000,תל אביב -יפו,7699,3886,3813,2371,5328,2660,7649,451,3%
2012-04,אזור יהודה והשומרון,3760,אורנית,89,32,57,33,56,3,87,4,2%
2012-04,אזור יהודה והשומרון,3750,אלפי מנשה,93,41,52,25,68,5,93,7,2%
2012-04,אזור יהודה והשומרון,3560,אלקנה,27,13,14,15,12,2,27,1,2%
2012-04,אזור יהודה והשומרון,3650,אפרת,44,21,23,22,22,5,44,4,1%
2012-04,אזור יהודה והשומרון,3570,אריאל,416,221,195,102,314,98,415,16,4%
2012-04,אזור יהודה והשומרון,3574,בית אל,46,20,26,10,36,17,46,1,2%
2012-04,אזור יהודה והשומרון,3652,בית אריה,71,23,48,19,52,4,71,4,3%
2012-04,אזור יהודה והשומרון,3780,ביתר עילית,376,183,193,16,360,191,373,11,4%
2012-04,אזור יהודה והשומרון,3730,גבעת זאב,155,72,83,20,135,34,154,7,2%
2012-04,אזור יהודה והשומרון,3769,הר אדר,29,17,12,12,17,2,29,1,2%
2012-04,אזור יהודה והשומרון,3797,מודיעין עילית,311,127,184,16,295,99,309,3,3%
2012-04,אזור יהודה והשומרון,3616,מעלה אדומים,602,254,348,96,506,189,597,51,3%
2012-04,אזור יהודה והשומרון,3660,עמנואל,74,34,40,2,72,59,74,0,7%
2012-04,אזור יהודה והשומרון,3557,קדומים,26,14,12,11,15,7,25,4,1%
2012-04,אזור יהודה והשומרון,3611,קריית ארבע,92,36,56,14,78,59,92,4,3%
2012-04,אזור יהודה והשומרון,3640,קרני שומרון,87,46,41,22,65,21,86,6,2%
2012-04,הדרום,31,אופקים,1336,593,743,97,1239,961,1330,21,11%
2012-04,הדרום,2600,אילת,1353,626,727,61,1292,602,1340,128,4%
2012-04,הדרום,70,אשדוד,6657,2761,3896,767,5890,3882,6608,194,6%
2012-04,הדרום,7100,אשקלון,4278,1705,2573,622,3656,2648,4173,139,7%
2012-04,הדרום,9000,באר שבע,7092,3083,4009,949,6143,4638,7052,346,7%
2012-04,הדרום,2200,דימונה,2095,914,1181,136,1959,1517,2071,72,12%
2012-04,הדרום,1303,חורה,726,294,432,2,724,687,724,7,20%
2012-04,הדרום,831,ירוחם,432,209,223,23,409,294,430,30,10%
2012-04,הדרום,1059,כסיפה,966,400,566,6,960,890,966,20,23%
2012-04,הדרום,1271,להבים,31,16,15,18,13,3,31,3,1%
2012-04,הדרום,1060,לקיה,935,403,532,3,932,882,930,14,26%
2012-04,הדרום,1268,מיתר,66,32,34,24,42,6,65,10,2%
2012-04,הדרום,99,מצפה רמון,208,84,124,20,188,125,203,12,9%
2012-04,הדרום,246,נתיבות,873,386,487,51,822,493,868,34,7%
2012-04,הדרום,666,עומר,62,19,43,24,38,8,62,7,2%
2012-04,הדרום,2560,ערד,801,347,454,166,635,464,784,87,6%
2012-04,הדרום,1192,ערערה-בנגב,952,390,562,5,947,905,952,2,25%
2012-04,הדרום,2630,קריית גת,2292,932,1360,186,2106,1521,2288,66,9%
2012-04,הדרום,1034,קריית מלאכי,1173,522,651,20,1153,784,1158,70,10%
2012-04,הדרום,1161,רהט,2937,1158,1779,8,2929,2658,2935,25,18%
2012-04,הדרום,1286,שגב-שלום,481,173,308,0,481,449,478,9,20%
2012-04,הדרום,1031,שדרות,1042,439,603,61,981,663,1039,39,9%
2012-04,הדרום,1054,תל שבע,1125,510,615,2,1123,1071,1124,14,26%
2012-04,המרכז,182,אבן יהודה,125,67,58,41,84,17,125,8,2%
2012-04,המרכז,41,אליכין,43,20,23,3,40,18,43,5,3%
2012-04,המרכז,1309,אלעד,352,149,203,19,333,106,349,15,3%
2012-04,המרכז,2530,באר יעקב,236,93,143,43,193,70,231,8,3%
2012-04,המרכז,466,בית דגן,91,48,43,14,77,32,91,5,3%
2012-04,המרכז,1066,"בני עי""ש",188,89,99,32,156,72,187,1,5%
2012-04,המרכז,681,גבעת שמואל,229,123,106,98,131,52,229,5,2%
2012-04,המרכז,2550,גדרה,334,158,176,65,269,93,329,4,3%
2012-04,המרכז,627,ג'לג'וליה,67,34,33,1,66,41,67,1,2%
2012-04,המרכז,166,גן יבנה,317,116,201,34,283,89,314,14,3%
2012-04,המרכז,229,גני תקווה,162,73,89,58,104,25,161,8,2%
2012-04,המרכז,9700,הוד השרון,579,275,304,229,350,67,577,31,2%
2012-04,המרכז,1290,זמר,162,56,106,3,159,121,162,12,6%
2012-04,המרכז,2730,טייבה,2180,901,1279,4,2176,1871,2171,35,14%
2012-04,המרכז,2720,טירה,336,171,165,13,323,185,336,8,3%
2012-04,המרכז,2660,יבנה,834,418,416,66,768,393,832,58,4%
2012-04,המרכז,9400,יהוד,448,176,272,64,384,75,436,27,3%
2012-04,המרכז,1224,כוכב יאיר,86,50,36,39,47,4,86,7,2%
2012-04,המרכז,633,כפר ברא,21,12,9,0,21,10,21,0,2%
2012-04,המרכז,168,כפר יונה,301,130,171,71,230,65,300,23,3%
2012-04,המרכז,6900,כפר סבא,1163,516,647,365,798,189,1150,70,2%
2012-04,המרכז,634,כפר קאסם,197,102,95,0,197,112,197,5,3%
2012-04,המרכז,7000,לוד,2199,977,1222,180,2019,1313,2187,126,6%
2012-04,המרכז,1200,מודיעין-מכבים-רעות*,880,389,491,371,509,68,871,34,2%
2012-04,המרכז,28,מזכרת בתיה,150,70,80,42,108,39,148,0,2%
2012-04,המרכז,7200,נס ציונה,609,261,348,131,478,195,601,4,3%
2012-04,המרכז,7400,נתניה,3974,1862,2112,560,3414,1655,3945,248,4%
2012-04,המרכז,587,סביון*,15,1,14,9,6,1,15,0,1%
2012-04,המרכז,171,פרדסייה,55,25,30,16,39,7,55,6,2%
2012-04,המרכז,7900,פתח תקווה,3748,1677,2071,751,2997,1059,3733,140,3%
2012-04,המרכז,195,קדימה-צורן,194,83,111,59,135,29,194,13,2%
2012-04,המרכז,638,קלנסווה,885,340,545,1,884,767,883,11,11%
2012-04,המרכז,469,קריית עקרון,266,126,140,19,247,127,264,3,5%
2012-04,המרכז,2640,ראש העין,673,317,356,90,583,170,661,49,3%
2012-04,המרכז,8300,ראשון לציון,4248,1903,2345,873,3375,1587,4240,169,3%
2012-04,המרכז,8400,רחובות,2390,1059,1331,481,1909,1002,2349,11,4%
2012-04,המרכז,8500,רמלה,1670,770,900,97,1573,815,1638,87,5%
2012-04,המרכז,8700,רעננה,700,345,355,289,411,76,699,34,2%
2012-04,המרכז,1304,שוהם,174,79,95,79,95,3,174,11,2%
2012-04,המרכז,154,תל מונד,165,79,86,68,97,27,165,4,3%
2012-04,הצפון,473,אבו סנאן,735,283,452,6,729,634,731,18,14%
2012-04,הצפון,478,אכסאל,525,218,307,14,511,452,524,10,10%
2012-04,הצפון,529,אעבלין,628,254,374,8,620,527,627,12,12%
2012-04,הצפון,482,בועיינה-נוג'ידאת,455,180,275,3,452,396,451,20,13%
2012-04,הצפון,4001,בוקעאתא,397,152,245,6,391,344,390,4,15%
2012-04,הצפון,998,ביר אל-מכסור,430,164,266,3,427,339,429,5,13%
2012-04,הצפון,480,בית ג'ן,364,106,258,1,363,254,360,5,7%
2012-04,הצפון,9200,בית שאן,756,342,414,24,732,456,756,64,8%
2012-04,הצפון,944,בסמת טבעון,197,82,115,0,197,159,196,7,7%
2012-04,הצפון,483,בענה,400,152,248,4,396,363,400,10,13%
2012-04,הצפון,1292,ג'דיידה-מכר,1477,605,872,7,1470,1302,1476,27,18%
2012-04,הצפון,485,ג'ולס,199,54,145,2,197,161,199,7,8%
2012-04,הצפון,487,ג'ש (גוש חלב),54,24,30,4,50,27,53,0,4%
2012-04,הצפון,489,דבורייה,407,166,241,12,395,312,406,8,10%
2012-04,הצפון,490,דייר אל-אסד,383,153,230,6,377,321,383,6,8%
2012-04,הצפון,492,דייר חנא,641,263,378,12,629,523,641,13,15%
2012-04,הצפון,975,זרזיר,293,138,155,3,290,194,288,9,11%
2012-04,הצפון,496,חורפיש,123,55,68,6,117,85,122,8,5%
2012-04,הצפון,2034,חצור הגלילית,269,104,165,11,258,140,260,13,6%
2012-04,הצפון,6700,טבריה,1813,783,1030,108,1705,1252,1685,97,8%
2012-04,הצפון,962,טובא-זנגרייה,373,178,195,7,366,268,369,8,13%
2012-04,הצפון,498,טורעאן,513,192,321,8,505,451,506,21,10%
2012-04,הצפון,8900,טמרה,1950,777,1173,12,1938,1743,1948,41,15%
2012-04,הצפון,1295,יאנוח-ג'ת,159,49,110,3,156,116,159,3,6%
2012-04,הצפון,46,יבנאל,143,90,53,9,134,107,135,2,9%
2012-04,הצפון,499,יפיע,613,257,356,7,606,479,611,22,9%
2012-04,הצפון,240,יקנעם עילית,474,206,268,84,390,170,473,46,4%
2012-04,הצפון,502,ירכא,532,210,322,2,530,441,532,19,10%
2012-04,הצפון,504,כאבול,685,267,418,8,677,602,682,9,15%
2012-04,הצפון,505,כאוכב אבו אל-היג'א,216,92,124,7,209,181,216,5,14%
2012-04,הצפון,1296,כסרא-סמיע,254,101,153,1,253,188,253,8,8%
2012-04,הצפון,978,כעביה-טבאש-חג'אג'רה,199,78,121,3,196,143,198,10,10%
2012-04,הצפון,1263,כפר ורדים,62,29,33,28,34,7,62,3,2%
2012-04,הצפון,507,כפר יאסיף,506,212,294,4,502,412,505,17,11%
2012-04,הצפון,508,כפר כמא,70,26,44,0,70,38,68,4,5%
2012-04,הצפון,509,כפר כנא,1154,418,736,22,1132,1028,1150,35,14%
2012-04,הצפון,510,כפר מנדא,991,457,534,8,983,762,985,29,15%
2012-04,הצפון,47,כפר תבור,44,20,24,11,33,5,44,1,2%
2012-04,הצפון,1139,כרמיאל,1713,674,1039,347,1366,902,1663,71,7%
2012-04,הצפון,481,מגאר,1453,539,914,17,1436,1296,1450,51,17%
2012-04,הצפון,516,מג'ד אל-כרום,565,246,319,6,559,462,565,24,10%
2012-04,הצפון,874,מגדל העמק,970,396,574,75,895,473,933,82,7%
2012-04,הצפון,4201,מג'דל שמס,482,180,302,13,469,401,474,5,11%
2012-04,הצפון,517,מזרעה,183,74,109,3,180,148,182,8,10%
2012-04,הצפון,4203,מסעדה,188,69,119,8,180,162,187,2,12%
2012-04,הצפון,518,מעיליא,45,28,17,6,39,22,45,2,3%
2012-04,הצפון,1063,מעלות-תרשיחא,889,419,470,111,778,561,884,47,8%
2012-04,הצפון,520,משהד,283,99,184,6,277,242,280,7,10%
2012-04,הצפון,9100,נהרייה,2019,938,1081,233,1786,1295,2011,74,7%
2012-04,הצפון,522,נחף,397,175,222,6,391,332,397,15,9%
2012-04,הצפון,7300,נצרת,2926,1252,1674,78,2848,2334,2911,83,9%
2012-04,הצפון,1061,נצרת עילית,1879,797,1082,262,1617,1108,1775,119,8%
2012-04,הצפון,525,סאג'ור,122,40,82,3,119,88,121,3,7%
2012-04,הצפון,7500,סח'נין,2008,877,1131,32,1976,1739,2008,48,16%
2012-04,הצפון,4501,ע'ג'ר,74,28,46,2,72,59,74,3,8%
2012-04,הצפון,530,עיילבון,191,84,107,5,186,140,189,9,8%
2012-04,הצפון,511,עילוט,311,127,184,6,305,247,310,6,12%
2012-04,הצפון,532,עין מאהל,585,259,326,9,576,507,576,11,13%
2012-04,הצפון,7600,עכו,3216,1444,1772,157,3059,2544,3188,126,13%
2012-04,הצפון,7700,עפולה,1614,659,955,180,1434,846,1559,113,7%
2012-04,הצפון,531,עראבה,1380,558,822,30,1350,1234,1379,30,15%
2012-04,הצפון,535,פסוטה,111,50,61,3,108,85,111,2,7%
2012-04,הצפון,536,פקיעין (בוקייעה),130,71,59,2,128,86,129,8,5%
2012-04,הצפון,8000,צפת,1100,577,523,69,1031,855,1087,17,9%
2012-04,הצפון,4100,קצרין,173,80,93,34,139,84,171,13,5%
2012-04,הצפון,2800,קריית שמונה,624,290,334,49,575,272,600,53,5%
2012-04,הצפון,543,ראמה,327,138,189,5,322,259,327,3,9%
2012-04,הצפון,26,ראש פינה,57,22,35,11,46,22,57,2,4%
2012-04,הצפון,542,ריינה,623,244,379,10,613,524,619,17,10%
2012-04,הצפון,122,רמת ישי,102,41,61,31,71,12,101,5,3%
2012-04,הצפון,913,שבלי - אום אל-גנם,225,100,125,2,223,167,223,18,9%
2012-04,הצפון,812,שלומי,232,91,141,14,218,147,229,10,7%
2012-04,הצפון,538,שעב,455,175,280,5,450,418,455,8,16%
2012-04,הצפון,8800,שפרעם,1998,764,1234,33,1965,1710,1992,43,12%
2012-04,חיפה,2710,אום אל-פחם,3735,1512,2223,16,3719,3231,3730,40,20%
2012-04,חיפה,1020,אור עקיבא,559,241,318,39,520,223,554,48,6%
2012-04,חיפה,6000,באקה אל-גרביה,650,312,338,13,637,436,649,38,6%
2012-04,חיפה,9800,בנימינה-גבעת עדה*,162,70,92,46,116,48,161,7,3%
2012-04,חיפה,1326,"בסמ""ה",418,185,233,1,417,341,418,5,12%
2012-04,חיפה,541,ג'סר א-זרקא,401,226,175,1,400,280,399,13,7%
2012-04,חיפה,628,ג'ת,198,87,111,11,187,133,197,15,4%
2012-04,חיפה,494,דאלית אל-כרמל,461,190,271,9,452,292,461,26,6%
2012-04,חיפה,9300,זכרון יעקב,215,99,116,72,143,51,214,17,2%
2012-04,חיפה,6500,חדרה,2410,997,1413,271,2139,998,2366,125,5%
2012-04,חיפה,4000,חיפה,6762,3154,3608,1284,5478,4179,6725,412,5%
2012-04,חיפה,1247,חריש,14,6,8,3,11,7,13,0,1%
2012-04,חיפה,2100,טירת כרמל,718,340,378,32,686,442,711,25,7%
2012-04,חיפה,654,כפר קרע,366,158,208,5,361,228,364,9,5%
2012-04,חיפה,1327,מעלה עירון,937,371,566,3,934,779,937,15,18%
2012-04,חיפה,2500,נשר,475,224,251,88,387,248,472,27,4%
2012-04,חיפה,534,עספיא,308,129,179,6,302,192,307,16,6%
2012-04,חיפה,637,ערערה,552,228,324,2,550,392,552,11,8%
2012-04,חיפה,537,פוריידיס,365,169,196,3,362,258,364,12,7%
2012-04,חיפה,7800,פרדס חנה-כרכור,764,342,422,137,627,270,757,52,4%
2012-04,חיפה,6800,קריית אתא,1661,744,917,134,1527,1038,1658,85,6%
2012-04,חיפה,9500,קריית ביאליק,1129,448,681,145,984,633,1123,75,5%
2012-04,חיפה,2300,קריית טבעון,170,82,88,58,112,37,168,10,2%
2012-04,חיפה,9600,קריית ים,1582,712,870,161,1421,1073,1577,71,8%
2012-04,חיפה,8200,קריית מוצקין,1069,438,631,160,909,577,1066,43,5%
2012-04,חיפה,922,רכסים,120,63,57,5,115,78,120,2,4%
2012-04,ירושלים,472,אבו גוש,236,116,120,6,230,182,236,4,9%
2012-04,ירושלים,2610,בית שמש,1076,464,612,112,964,539,1069,41,4%
2012-04,ירושלים,3000,ירושלים,9773,4327,5446,1128,8645,6251,9725,245,4%
2012-04,ירושלים,1015,מבשרת ציון,345,162,183,54,291,165,345,13,3%
2012-04,ירושלים,1137,קריית יערים,29,11,18,5,24,14,29,0,3%
2012-04,תל אביב,2400,אור יהודה,737,356,381,38,699,293,726,41,4%
2012-04,תל אביב,565,אזור,159,69,90,23,136,42,155,6,3%
2012-04,תל אביב,6100,בני ברק,2178,1109,1069,104,2074,1327,2167,57,4%
2012-04,תל אביב,6200,בת ים,3194,1484,1710,469,2725,1308,3146,199,4%
2012-04,תל אביב,6300,גבעתיים,703,319,384,309,394,100,696,35,2%
2012-04,תל אביב,6400,הרצלייה,971,463,508,302,669,56,962,109,2%
2012-04,תל אביב,6600,חולון,2869,1359,1510,455,2414,912,2836,172,3%
2012-04,תל אביב,2620,קריית אונו,348,153,195,132,216,42,344,16,2%
2012-04,תל אביב,8600,רמת גן,1948,904,1044,591,1357,448,1936,90,3%
2012-04,תל אביב,2650,רמת השרון,362,161,201,171,191,12,362,29,2%
2012-04,תל אביב,5000,תל אביב -יפו,7401,3706,3695,2286,5115,2607,7363,332,3%
2012-05,אזור יהודה והשומרון,3760,אורנית,84,31,53,29,55,2,84,4,2%
2012-05,אזור יהודה והשומרון,3750,אלפי מנשה,96,42,54,27,69,2,96,13,2%
2012-05,אזור יהודה והשומרון,3560,אלקנה,31,17,14,16,15,2,30,2,2%
2012-05,אזור יהודה והשומרון,3650,אפרת,65,33,32,29,36,8,64,5,2%
2012-05,אזור יהודה והשומרון,3570,אריאל,433,226,207,103,330,100,433,29,4%
2012-05,אזור יהודה והשומרון,3574,בית אל,52,21,31,13,39,18,51,2,2%
2012-05,אזור יהודה והשומרון,3652,בית אריה,66,23,43,13,53,4,65,4,3%
2012-05,אזור יהודה והשומרון,3780,ביתר עילית,403,205,198,14,389,203,400,16,4%
2012-05,אזור יהודה והשומרון,3730,גבעת זאב,181,83,98,25,156,34,181,8,3%
2012-05,אזור יהודה והשומרון,3769,הר אדר,33,22,11,14,19,2,33,2,2%
2012-05,אזור יהודה והשומרון,3797,מודיעין עילית,344,129,215,18,326,114,342,11,3%
2012-05,אזור יהודה והשומרון,3616,מעלה אדומים,672,289,383,100,572,206,666,47,3%
2012-05,אזור יהודה והשומרון,3660,עמנואל,81,43,38,3,78,62,81,2,8%
2012-05,אזור יהודה והשומרון,3557,קדומים,35,19,16,14,21,7,34,0,2%
2012-05,אזור יהודה והשומרון,3611,קריית ארבע,82,34,48,13,69,57,82,3,3%
2012-05,אזור יהודה והשומרון,3640,קרני שומרון,92,50,42,23,69,19,92,6,3%
2012-05,הדרום,31,אופקים,1415,621,794,97,1318,973,1406,45,11%
2012-05,הדרום,2600,אילת,1433,670,763,68,1365,615,1412,85,4%
2012-05,הדרום,70,אשדוד,6917,2852,4065,813,6104,3892,6867,311,7%
2012-05,הדרום,7100,אשקלון,4489,1795,2694,661,3828,2691,4374,196,7%
2012-05,הדרום,9000,באר שבע,7363,3216,4147,989,6374,4754,7308,530,7%
2012-05,הדרום,2200,דימונה,2155,943,1212,137,2018,1541,2129,109,12%
2012-05,הדרום,1303,חורה,745,310,435,3,742,694,743,9,21%
2012-05,הדרום,831,ירוחם,449,215,234,27,422,290,446,47,11%
2012-05,הדרום,1059,כסיפה,984,416,568,5,979,901,983,10,24%
2012-05,הדרום,1271,להבים,35,17,18,22,13,3,35,4,1%
2012-05,הדרום,1060,לקיה,955,409,546,2,953,904,953,19,27%
2012-05,הדרום,1268,מיתר,64,29,35,28,36,7,64,2,2%
2012-05,הדרום,99,מצפה רמון,240,92,148,21,219,134,232,29,10%
2012-05,הדרום,246,נתיבות,981,439,542,54,927,518,975,50,8%
2012-05,הדרום,666,עומר,62,20,42,26,36,6,62,3,2%
2012-05,הדרום,2560,ערד,851,380,471,159,692,472,832,110,7%
2012-05,הדרום,1192,ערערה-בנגב,972,393,579,5,967,915,972,27,26%
2012-05,הדרום,2630,קריית גת,2397,989,1408,184,2213,1546,2390,99,9%
2012-05,הדרום,1034,קריית מלאכי,1215,548,667,24,1191,795,1192,99,10%
2012-05,הדרום,1161,רהט,3038,1248,1790,8,3030,2707,3038,66,18%
2012-05,הדרום,1286,שגב-שלום,492,178,314,0,492,457,490,18,20%
2012-05,הדרום,1031,שדרות,1098,457,641,60,1038,682,1093,61,9%
2012-05,הדרום,1054,תל שבע,1149,533,616,3,1146,1092,1148,20,26%
2012-05,המרכז,182,אבן יהודה,125,66,59,42,83,18,125,10,2%
2012-05,המרכז,41,אליכין,62,30,32,6,56,16,62,1,4%
2012-05,המרכז,1309,אלעד,360,170,190,15,345,115,357,17,3%
2012-05,המרכז,2530,באר יעקב,259,101,158,54,205,66,254,11,3%
2012-05,המרכז,466,בית דגן,103,55,48,15,88,36,103,2,3%
2012-05,המרכז,1066,"בני עי""ש",191,88,103,30,161,71,189,1,5%
2012-05,המרכז,681,גבעת שמואל,319,168,151,110,209,54,317,9,3%
2012-05,המרכז,2550,גדרה,373,168,205,76,297,102,367,6,3%
2012-05,המרכז,627,ג'לג'וליה,68,31,37,0,68,43,68,2,2%
2012-05,המרכז,166,גן יבנה,362,140,222,44,318,96,358,16,3%
2012-05,המרכז,229,גני תקווה,170,87,83,53,117,26,169,5,2%
2012-05,המרכז,9700,הוד השרון,740,361,379,253,487,73,738,42,3%
2012-05,המרכז,1290,זמר,168,66,102,5,163,122,168,11,6%
2012-05,המרכז,2730,טייבה,2213,923,1290,5,2208,1877,2205,44,14%
2012-05,המרכז,2720,טירה,345,173,172,13,332,185,345,16,3%
2012-05,המרכז,2660,יבנה,882,444,438,74,808,405,876,80,4%
2012-05,המרכז,9400,יהוד,505,204,301,73,432,72,490,43,3%
2012-05,המרכז,1224,כוכב יאיר,81,41,40,37,44,4,81,4,2%
2012-05,המרכז,633,כפר ברא,27,16,11,0,27,14,27,0,2%
2012-05,המרכז,168,כפר יונה,328,146,182,72,256,66,327,24,3%
2012-05,המרכז,6900,כפר סבא,1205,542,663,388,817,191,1199,82,2%
2012-05,המרכז,634,כפר קאסם,208,109,99,1,207,111,207,6,3%
2012-05,המרכז,7000,לוד,2220,1005,1215,177,2043,1282,2206,128,6%
2012-05,המרכז,1200,מודיעין-מכבים-רעות*,1010,462,548,377,633,67,1001,51,3%
2012-05,המרכז,28,מזכרת בתיה,169,79,90,42,127,38,168,4,3%
2012-05,המרכז,7200,נס ציונה,635,270,365,138,497,196,627,4,3%
2012-05,המרכז,7400,נתניה,4161,1944,2217,620,3541,1677,4133,337,4%
2012-05,המרכז,587,סביון*,15,3,12,9,6,2,15,1,1%
2012-05,המרכז,171,פרדסייה,66,27,39,16,50,7,66,2,2%
2012-05,המרכז,7900,פתח תקווה,4450,1987,2463,794,3656,1096,4417,246,4%
2012-05,המרכז,195,קדימה-צורן,208,90,118,56,152,34,208,17,2%
2012-05,המרכז,638,קלנסווה,898,345,553,1,897,766,896,13,11%
2012-05,המרכז,469,קריית עקרון,281,142,139,21,260,128,279,7,5%
2012-05,המרכז,2640,ראש העין,751,369,382,95,656,175,740,75,3%
2012-05,המרכז,8300,ראשון לציון,4937,2182,2755,956,3981,1642,4927,272,4%
2012-05,המרכז,8400,רחובות,2533,1140,1393,494,2039,1056,2492,15,4%
2012-05,המרכז,8500,רמלה,1792,847,945,113,1679,823,1751,141,5%
2012-05,המרכז,8700,רעננה,778,395,383,321,457,85,774,50,2%
2012-05,המרכז,1304,שוהם,271,130,141,82,189,4,271,10,3%
2012-05,המרכז,154,תל מונד,171,81,90,72,99,31,171,13,3%
2012-05,הצפון,473,אבו סנאן,734,283,451,5,729,641,730,17,14%
2012-05,הצפון,478,אכסאל,527,223,304,17,510,449,525,11,10%
2012-05,הצפון,529,אעבלין,622,249,373,10,612,525,622,17,12%
2012-05,הצפון,482,בועיינה-נוג'ידאת,435,170,265,3,432,391,431,17,12%
2012-05,הצפון,4001,בוקעאתא,401,157,244,6,395,345,393,9,15%
2012-05,הצפון,998,ביר אל-מכסור,420,157,263,3,417,339,420,5,13%
2012-05,הצפון,480,בית ג'ן,384,116,268,2,382,276,378,6,8%
2012-05,הצפון,9200,בית שאן,798,360,438,25,773,464,798,82,8%
2012-05,הצפון,944,בסמת טבעון,197,82,115,0,197,157,196,9,7%
2012-05,הצפון,483,בענה,407,158,249,3,404,371,407,12,13%
2012-05,הצפון,1292,ג'דיידה-מכר,1501,614,887,8,1493,1313,1500,39,18%
2012-05,הצפון,485,ג'ולס,204,52,152,2,202,161,204,6,8%
2012-05,הצפון,487,ג'ש (גוש חלב),61,26,35,6,55,27,60,3,4%
2012-05,הצפון,489,דבורייה,400,164,236,15,385,317,399,5,10%
2012-05,הצפון,490,דייר אל-אסד,393,160,233,6,387,326,393,11,9%
2012-05,הצפון,492,דייר חנא,623,256,367,13,610,509,623,26,14%
2012-05,הצפון,975,זרזיר,299,138,161,4,295,205,297,5,11%
2012-05,הצפון,496,חורפיש,118,48,70,7,111,82,118,6,5%
2012-05,הצפון,2034,חצור הגלילית,274,107,167,14,260,138,268,28,6%
2012-05,הצפון,6700,טבריה,1847,807,1040,99,1748,1260,1711,117,8%
2012-05,הצפון,962,טובא-זנגרייה,410,183,227,7,403,274,405,21,14%
2012-05,הצפון,498,טורעאן,540,209,331,6,534,476,534,31,11%
2012-05,הצפון,8900,טמרה,1995,795,1200,11,1984,1760,1992,49,15%
2012-05,הצפון,1295,יאנוח-ג'ת,158,52,106,3,155,115,158,4,6%
2012-05,הצפון,46,יבנאל,149,95,54,8,141,116,139,2,9%
2012-05,הצפון,499,יפיע,635,273,362,10,625,492,630,27,9%
2012-05,הצפון,240,יקנעם עילית,498,216,282,90,408,170,497,52,5%
2012-05,הצפון,502,ירכא,547,218,329,1,546,447,547,20,10%
2012-05,הצפון,504,כאבול,694,268,426,8,686,612,691,10,15%
2012-05,הצפון,505,כאוכב אבו אל-היג'א,213,90,123,7,206,184,213,8,14%
2012-05,הצפון,1296,כסרא-סמיע,217,97,120,1,216,161,215,19,7%
2012-05,הצפון,978,כעביה-טבאש-חג'אג'רה,200,82,118,3,197,139,198,5,10%
2012-05,הצפון,1263,כפר ורדים,64,30,34,27,37,8,64,3,2%
2012-05,הצפון,507,כפר יאסיף,511,210,301,8,503,414,510,23,11%
2012-05,הצפון,508,כפר כמא,65,24,41,0,65,38,64,0,4%
2012-05,הצפון,509,כפר כנא,1192,447,745,22,1170,1067,1182,63,15%
2012-05,הצפון,510,כפר מנדא,983,448,535,8,975,764,976,36,15%
2012-05,הצפון,47,כפר תבור,42,18,24,12,30,5,42,0,2%
2012-05,הצפון,1139,כרמיאל,1783,694,1089,366,1417,923,1734,105,7%
2012-05,הצפון,481,מגאר,1497,556,941,18,1479,1336,1495,70,18%
2012-05,הצפון,516,מג'ד אל-כרום,573,245,328,4,569,463,573,18,10%
2012-05,הצפון,874,מגדל העמק,1010,425,585,79,931,492,971,113,8%
2012-05,הצפון,4201,מג'דל שמס,478,173,305,13,465,410,471,12,11%
2012-05,הצפון,517,מזרעה,170,64,106,1,169,150,169,7,9%
2012-05,הצפון,4203,מסעדה,184,67,117,7,177,157,183,6,12%
2012-05,הצפון,518,מעיליא,45,25,20,5,40,21,45,5,3%
2012-05,הצפון,1063,מעלות-תרשיחא,899,419,480,110,789,563,896,45,8%
2012-05,הצפון,520,משהד,296,104,192,4,292,252,294,12,10%
2012-05,הצפון,9100,נהרייה,2094,977,1117,243,1851,1327,2086,128,7%
2012-05,הצפון,522,נחף,401,170,231,7,394,338,401,11,9%
2012-05,הצפון,7300,נצרת,2943,1267,1676,83,2860,2356,2929,88,10%
2012-05,הצפון,1061,נצרת עילית,1941,842,1099,254,1687,1126,1845,182,8%
2012-05,הצפון,525,סאג'ור,126,45,81,3,123,87,126,3,7%
2012-05,הצפון,7500,סח'נין,1996,871,1125,29,1967,1734,1996,53,16%
2012-05,הצפון,4501,ע'ג'ר,69,27,42,1,68,58,67,4,7%
2012-05,הצפון,530,עיילבון,197,81,116,6,191,144,196,8,8%
2012-05,הצפון,511,עילוט,317,128,189,6,311,253,316,11,12%
2012-05,הצפון,532,עין מאהל,578,259,319,8,570,498,569,14,13%
2012-05,הצפון,7600,עכו,3290,1476,1814,157,3133,2579,3267,127,13%
2012-05,הצפון,7700,עפולה,1746,725,1021,182,1564,859,1691,155,7%
2012-05,הצפון,531,עראבה,1407,592,815,28,1379,1257,1406,39,15%
2012-05,הצפון,535,פסוטה,110,46,64,2,108,83,110,1,7%
2012-05,הצפון,536,פקיעין (בוקייעה),121,69,52,5,116,77,119,6,5%
2012-05,הצפון,8000,צפת,1158,613,545,73,1085,888,1145,31,9%
2012-05,הצפון,4100,קצרין,173,78,95,31,142,80,172,8,5%
2012-05,הצפון,2800,קריית שמונה,668,298,370,52,616,274,645,109,5%
2012-05,הצפון,543,ראמה,323,137,186,4,319,255,320,6,9%
2012-05,הצפון,26,ראש פינה,52,15,37,10,42,20,52,2,3%
2012-05,הצפון,542,ריינה,630,238,392,12,618,522,625,17,10%
2012-05,הצפון,122,רמת ישי,110,47,63,34,76,13,109,5,3%
2012-05,הצפון,913,שבלי - אום אל-גנם,223,100,123,3,220,171,219,4,9%
2012-05,הצפון,812,שלומי,256,108,148,14,242,155,253,14,7%
2012-05,הצפון,538,שעב,473,187,286,6,467,430,473,6,17%
2012-05,הצפון,8800,שפרעם,2002,764,1238,36,1966,1695,1998,62,12%
2012-05,חיפה,2710,אום אל-פחם,3760,1540,2220,15,3745,3255,3755,47,20%
2012-05,חיפה,1020,אור עקיבא,600,256,344,42,558,236,591,74,6%
2012-05,חיפה,6000,באקה אל-גרביה,656,311,345,14,642,436,656,29,6%
2012-05,חיפה,9800,בנימינה-גבעת עדה*,189,83,106,50,139,57,187,13,3%
2012-05,חיפה,1326,"בסמ""ה",419,183,236,1,418,340,419,9,12%
2012-05,חיפה,541,ג'סר א-זרקא,449,243,206,1,448,284,446,15,8%
2012-05,חיפה,628,ג'ת,204,96,108,8,196,131,203,10,4%
2012-05,חיפה,494,דאלית אל-כרמל,476,196,280,8,468,286,473,19,7%
2012-05,חיפה,9300,זכרון יעקב,228,100,128,73,155,49,228,24,2%
2012-05,חיפה,6500,חדרה,2542,1046,1496,283,2259,1020,2489,188,5%
2012-05,חיפה,4000,חיפה,7057,3297,3760,1375,5682,4284,7031,495,5%
2012-05,חיפה,1247,חריש,21,10,11,3,18,8,20,0,1%
2012-05,חיפה,2100,טירת כרמל,778,366,412,31,747,472,770,68,8%
2012-05,חיפה,654,כפר קרע,359,160,199,5,354,225,357,16,5%
2012-05,חיפה,1327,מעלה עירון,936,371,565,3,933,779,936,13,18%
2012-05,חיפה,2500,נשר,518,243,275,96,422,253,515,52,4%
2012-05,חיפה,534,עספיא,316,136,180,3,313,181,315,11,6%
2012-05,חיפה,637,ערערה,570,237,333,9,561,393,570,14,8%
2012-05,חיפה,537,פוריידיס,368,169,199,2,366,262,367,13,7%
2012-05,חיפה,7800,פרדס חנה-כרכור,859,372,487,153,706,292,849,94,5%
2012-05,חיפה,6800,קריית אתא,1794,792,1002,159,1635,1056,1786,94,6%
2012-05,חיפה,9500,קריית ביאליק,1196,498,698,147,1049,666,1192,88,6%
2012-05,חיפה,2300,קריית טבעון,173,82,91,60,113,38,171,7,2%
2012-05,חיפה,9600,קריית ים,1686,757,929,169,1517,1111,1681,101,8%
2012-05,חיפה,8200,קריית מוצקין,1148,482,666,169,979,602,1145,73,5%
2012-05,חיפה,922,רכסים,132,66,66,6,126,80,132,9,4%
2012-05,ירושלים,472,אבו גוש,244,117,127,6,238,185,244,3,9%
2012-05,ירושלים,2610,בית שמש,1143,497,646,123,1020,573,1138,128,4%
2012-05,ירושלים,3000,ירושלים,10425,4642,5783,1227,9198,6412,10363,375,4%
2012-05,ירושלים,1015,מבשרת ציון,363,181,182,55,308,166,363,8,3%
2012-05,ירושלים,1137,קריית יערים,34,15,19,6,28,15,34,0,3%
2012-05,תל אביב,2400,אור יהודה,814,396,418,40,774,305,803,74,4%
2012-05,תל אביב,565,אזור,162,69,93,19,143,38,159,17,3%
2012-05,תל אביב,6100,בני ברק,2275,1165,1110,112,2163,1362,2265,61,4%
2012-05,תל אביב,6200,בת ים,3449,1628,1821,507,2942,1359,3392,278,5%
2012-05,תל אביב,6300,גבעתיים,740,328,412,304,436,103,734,40,3%
2012-05,תל אביב,6400,הרצלייה,1015,480,535,314,701,69,1007,130,2%
2012-05,תל אביב,6600,חולון,2973,1402,1571,456,2517,921,2944,225,3%
2012-05,תל אביב,2620,קריית אונו,363,168,195,136,227,39,357,29,2%
2012-05,תל אביב,8600,רמת גן,2149,987,1162,631,1518,460,2134,111,3%
2012-05,תל אביב,2650,רמת השרון,407,197,210,184,223,13,403,34,2%
2012-05,תל אביב,5000,תל אביב -יפו,7813,3925,3888,2479,5334,2611,7765,430,3%
2012-06,אזור יהודה והשומרון,3760,אורנית,218,92,126,31,187,4,215,8,5%
2012-06,אזור יהודה והשומרון,3750,אלפי מנשה,141,70,71,18,123,3,141,3,3%
2012-06,אזור יהודה והשומרון,3560,אלקנה,47,26,21,17,30,2,46,2,3%
2012-06,אזור יהודה והשומרון,3650,אפרת,69,36,33,29,40,8,69,9,2%
2012-06,אזור יהודה והשומרון,3570,אריאל,457,251,206,97,360,94,457,33,4%
2012-06,אזור יהודה והשומרון,3574,בית אל,54,27,27,10,44,18,53,3,2%
2012-06,אזור יהודה והשומרון,3652,בית אריה,106,48,58,11,95,5,106,2,5%
2012-06,אזור יהודה והשומרון,3780,ביתר עילית,420,207,213,18,402,208,417,15,4%
2012-06,אזור יהודה והשומרון,3730,גבעת זאב,210,108,102,27,183,35,210,9,3%
2012-06,אזור יהודה והשומרון,3769,הר אדר,39,24,15,15,24,1,39,3,2%
2012-06,אזור יהודה והשומרון,3797,מודיעין עילית,369,134,235,19,350,116,366,2,3%
2012-06,אזור יהודה והשומרון,3616,מעלה אדומים,677,290,387,91,586,202,672,39,3%
2012-06,אזור יהודה והשומרון,3660,עמנואל,81,43,38,3,78,59,81,2,8%
2012-06,אזור יהודה והשומרון,3557,קדומים,72,33,39,11,61,8,72,2,4%
2012-06,אזור יהודה והשומרון,3611,קריית ארבע,90,35,55,15,75,59,90,2,3%
2012-06,אזור יהודה והשומרון,3640,קרני שומרון,114,62,52,23,91,18,114,7,3%
2012-06,הדרום,31,אופקים,1498,650,848,94,1404,962,1489,65,12%
2012-06,הדרום,2600,אילת,1583,691,892,63,1520,597,1567,115,5%
2012-06,הדרום,70,אשדוד,6954,2865,4089,823,6131,3864,6904,264,7%
2012-06,הדרום,7100,אשקלון,4820,1985,2835,663,4157,2652,4720,371,7%
2012-06,הדרום,9000,באר שבע,8273,3659,4614,975,7298,4663,8224,1173,8%
2012-06,הדרום,2200,דימונה,2261,999,1262,145,2116,1522,2235,118,13%
2012-06,הדרום,1303,חורה,735,309,426,2,733,686,735,15,21%
2012-06,הדרום,831,ירוחם,484,229,255,27,457,286,472,41,11%
2012-06,הדרום,1059,כסיפה,983,415,568,6,977,885,982,33,24%
2012-06,הדרום,1271,להבים,91,51,40,22,69,3,91,30,3%
2012-06,הדרום,1060,לקיה,939,414,525,3,936,884,937,10,26%
2012-06,הדרום,1268,מיתר,115,67,48,26,89,6,115,42,3%
2012-06,הדרום,99,מצפה רמון,273,114,159,19,254,129,267,53,11%
2012-06,הדרום,246,נתיבות,1248,579,669,55,1193,532,1245,98,10%
2012-06,הדרום,666,עומר,102,52,50,23,79,6,102,22,3%
2012-06,הדרום,2560,ערד,857,375,482,154,703,459,836,110,7%
2012-06,הדרום,1192,ערערה-בנגב,984,404,580,5,979,924,983,6,26%
2012-06,הדרום,2630,קריית גת,2451,1029,1422,193,2258,1521,2446,73,9%
2012-06,הדרום,1034,קריית מלאכי,1267,561,706,29,1238,781,1252,125,11%
2012-06,הדרום,1161,רהט,3075,1265,1810,10,3065,2692,3075,77,19%
2012-06,הדרום,1286,שגב-שלום,490,179,311,0,490,448,489,20,20%
2012-06,הדרום,1031,שדרות,1204,507,697,58,1146,675,1199,54,10%
2012-06,הדרום,1054,תל שבע,1130,529,601,2,1128,1069,1130,21,26%
2012-06,המרכז,182,אבן יהודה,166,83,83,41,125,20,166,8,3%
2012-06,המרכז,41,אליכין,73,35,38,5,68,17,72,1,4%
2012-06,המרכז,1309,אלעד,418,200,218,15,403,116,414,19,4%
2012-06,המרכז,2530,באר יעקב,267,110,157,44,223,70,263,15,3%
2012-06,המרכז,466,בית דגן,149,70,79,17,132,36,149,32,4%
2012-06,המרכז,1066,"בני עי""ש",198,95,103,30,168,69,198,1,5%
2012-06,המרכז,681,גבעת שמואל,283,145,138,100,183,54,282,13,3%
2012-06,המרכז,2550,גדרה,466,204,262,73,393,96,461,3,4%
2012-06,המרכז,627,ג'לג'וליה,82,39,43,0,82,46,82,2,3%
2012-06,המרכז,166,גן יבנה,352,128,224,45,307,92,351,22,3%
2012-06,המרכז,229,גני תקווה,241,113,128,49,192,24,238,8,3%
2012-06,המרכז,9700,הוד השרון,862,441,421,257,605,65,859,35,3%
2012-06,המרכז,1290,זמר,178,71,107,4,174,122,178,4,7%
2012-06,המרכז,2730,טייבה,2259,968,1291,4,2255,1848,2253,41,14%
2012-06,המרכז,2720,טירה,368,198,170,15,353,180,366,17,4%
2012-06,המרכז,2660,יבנה,978,498,480,73,905,397,972,56,5%
2012-06,המרכז,9400,יהוד,642,254,388,76,566,71,619,33,4%
2012-06,המרכז,1224,כוכב יאיר,276,140,136,36,240,3,276,11,5%
2012-06,המרכז,633,כפר ברא,38,26,12,1,37,12,38,0,3%
2012-06,המרכז,168,כפר יונה,395,184,211,75,320,71,395,29,4%
2012-06,המרכז,6900,כפר סבא,1494,711,783,372,1122,184,1488,86,3%
2012-06,המרכז,634,כפר קאסם,215,108,107,1,214,110,215,5,3%
2012-06,המרכז,7000,לוד,2350,1077,1273,165,2185,1287,2338,127,7%
2012-06,המרכז,1200,מודיעין-מכבים-רעות*,1345,643,702,378,967,64,1334,58,3%
2012-06,המרכז,28,מזכרת בתיה,209,101,108,43,166,36,209,1,3%
2012-06,המרכז,7200,נס ציונה,713,330,383,137,576,192,707,7,3%
2012-06,המרכז,7400,נתניה,4563,2139,2424,604,3959,1610,4535,296,5%
2012-06,המרכז,587,סביון*,25,12,13,9,16,2,25,2,1%
2012-06,המרכז,171,פרדסייה,85,47,38,18,67,6,85,1,2%
2012-06,המרכז,7900,פתח תקווה,5093,2376,2717,855,4238,1086,5067,224,4%
2012-06,המרכז,195,קדימה-צורן,284,118,166,67,217,32,284,8,3%
2012-06,המרכז,638,קלנסווה,900,354,546,2,898,756,897,11,11%
2012-06,המרכז,469,קריית עקרון,321,155,166,16,305,121,316,1,5%
2012-06,המרכז,2640,ראש העין,1013,500,513,99,914,176,1000,51,5%
2012-06,המרכז,8300,ראשון לציון,5405,2527,2878,945,4460,1580,5394,202,4%
2012-06,המרכז,8400,רחובות,2784,1232,1552,494,2290,1029,2739,21,4%
2012-06,המרכז,8500,רמלה,1930,944,986,99,1831,801,1893,130,6%
2012-06,המרכז,8700,רעננה,1376,734,642,332,1044,83,1375,47,4%
2012-06,המרכז,1304,שוהם,399,209,190,79,320,4,399,21,4%
2012-06,המרכז,154,תל מונד,216,96,120,63,153,24,216,14,4%
2012-06,הצפון,473,אבו סנאן,764,304,460,5,759,645,760,21,14%
2012-06,הצפון,478,אכסאל,525,222,303,15,510,446,524,12,10%
2012-06,הצפון,529,אעבלין,623,250,373,9,614,512,623,16,12%
2012-06,הצפון,482,בועיינה-נוג'ידאת,459,191,268,3,456,393,454,16,13%
2012-06,הצפון,4001,בוקעאתא,392,147,245,6,386,340,382,7,15%
2012-06,הצפון,998,ביר אל-מכסור,416,162,254,3,413,329,416,10,13%
2012-06,הצפון,480,בית ג'ן,354,106,248,1,353,254,351,6,7%
2012-06,הצפון,9200,בית שאן,809,341,468,27,782,441,808,64,9%
2012-06,הצפון,944,בסמת טבעון,198,80,118,0,198,157,197,12,7%
2012-06,הצפון,483,בענה,415,170,245,2,413,366,415,8,14%
2012-06,הצפון,1292,ג'דיידה-מכר,1511,628,883,7,1504,1280,1509,47,18%
2012-06,הצפון,485,ג'ולס,210,57,153,2,208,160,210,12,8%
2012-06,הצפון,487,ג'ש (גוש חלב),66,28,38,4,62,26,65,3,4%
2012-06,הצפון,489,דבורייה,405,172,233,18,387,312,405,2,10%
2012-06,הצפון,490,דייר אל-אסד,403,173,230,7,396,320,403,9,9%
2012-06,הצפון,492,דייר חנא,619,251,368,14,605,495,619,19,14%
2012-06,הצפון,975,זרזיר,301,142,159,5,296,205,297,10,11%
2012-06,הצפון,496,חורפיש,119,50,69,6,113,79,119,2,5%
2012-06,הצפון,2034,חצור הגלילית,306,137,169,12,294,134,301,23,7%
2012-06,הצפון,6700,טבריה,1918,849,1069,99,1819,1228,1787,95,9%
2012-06,הצפון,962,טובא-זנגרייה,384,172,212,7,377,264,379,10,13%
2012-06,הצפון,498,טורעאן,547,217,330,8,539,480,544,37,11%
2012-06,הצפון,8900,טמרה,1956,772,1184,11,1945,1718,1951,38,15%
2012-06,הצפון,1295,יאנוח-ג'ת,168,60,108,2,166,120,167,5,7%
2012-06,הצפון,46,יבנאל,148,94,54,7,141,113,135,0,9%
2012-06,הצפון,499,יפיע,644,285,359,15,629,482,641,10,9%
2012-06,הצפון,240,יקנעם עילית,488,204,284,89,399,170,487,51,4%
2012-06,הצפון,502,ירכא,549,218,331,2,547,446,549,19,10%
2012-06,הצפון,504,כאבול,690,268,422,9,681,602,687,8,15%
2012-06,הצפון,505,כאוכב אבו אל-היג'א,220,98,122,5,215,186,220,9,14%
2012-06,הצפון,1296,כסרא-סמיע,214,101,113,2,212,158,213,13,7%
2012-06,הצפון,978,כעביה-טבאש-חג'אג'רה,190,72,118,2,188,140,189,1,10%
2012-06,הצפון,1263,כפר ורדים,84,44,40,24,60,7,84,2,3%
2012-06,הצפון,507,כפר יאסיף,528,219,309,3,525,412,527,20,11%
2012-06,הצפון,508,כפר כמא,68,29,39,1,67,35,67,3,4%
2012-06,הצפון,509,כפר כנא,1221,481,740,26,1195,1071,1209,64,15%
2012-06,הצפון,510,כפר מנדא,964,433,531,8,956,743,954,34,14%
2012-06,הצפון,47,כפר תבור,54,21,33,10,44,4,54,4,3%
2012-06,הצפון,1139,כרמיאל,1934,793,1141,341,1593,910,1885,94,7%
2012-06,הצפון,481,מגאר,1523,592,931,19,1504,1319,1520,60,18%
2012-06,הצפון,516,מג'ד אל-כרום,580,252,328,5,575,463,580,20,10%
2012-06,הצפון,874,מגדל העמק,1051,443,608,82,969,472,1015,92,8%
2012-06,הצפון,4201,מג'דל שמס,471,172,299,12,459,408,461,9,10%
2012-06,הצפון,517,מזרעה,181,73,108,1,180,153,180,8,10%
2012-06,הצפון,4203,מסעדה,178,64,114,6,172,153,177,4,11%
2012-06,הצפון,518,מעיליא,55,28,27,4,51,26,55,2,4%
2012-06,הצפון,1063,מעלות-תרשיחא,941,460,481,109,832,536,937,64,8%
2012-06,הצפון,520,משהד,293,102,191,3,290,250,292,7,10%
2012-06,הצפון,9100,נהרייה,2204,1045,1159,244,1960,1283,2190,123,8%
2012-06,הצפון,522,נחף,410,184,226,7,403,332,410,17,9%
2012-06,הצפון,7300,נצרת,3012,1331,1681,85,2927,2330,2998,68,10%
2012-06,הצפון,1061,נצרת עילית,2088,912,1176,253,1835,1089,2002,141,9%
2012-06,הצפון,525,סאג'ור,134,53,81,1,133,79,134,2,8%
2012-06,הצפון,7500,סח'נין,2020,896,1124,32,1988,1721,2019,63,16%
2012-06,הצפון,4501,ע'ג'ר,70,29,41,1,69,56,70,4,8%
2012-06,הצפון,530,עיילבון,202,84,118,7,195,143,201,11,8%
2012-06,הצפון,511,עילוט,314,134,180,3,311,248,313,10,12%
2012-06,הצפון,532,עין מאהל,588,265,323,7,581,501,580,16,13%
2012-06,הצפון,7600,עכו,3349,1509,1840,160,3189,2550,3320,163,13%
2012-06,הצפון,7700,עפולה,1866,802,1064,178,1688,832,1820,153,8%
2012-06,הצפון,531,עראבה,1381,580,801,24,1357,1244,1378,35,15%
2012-06,הצפון,535,פסוטה,112,50,62,4,108,79,112,5,7%
2012-06,הצפון,536,פקיעין (בוקייעה),117,66,51,4,113,74,116,2,5%
2012-06,הצפון,8000,צפת,1218,670,548,76,1142,907,1205,84,10%
2012-06,הצפון,4100,קצרין,248,114,134,30,218,80,247,61,6%
2012-06,הצפון,2800,קריית שמונה,704,326,378,50,654,259,686,76,5%
2012-06,הצפון,543,ראמה,318,134,184,8,310,246,317,4,9%
2012-06,הצפון,26,ראש פינה,59,22,37,9,50,24,59,2,4%
2012-06,הצפון,542,ריינה,648,270,378,12,636,528,643,23,10%
2012-06,הצפון,122,רמת ישי,133,51,82,33,100,12,133,7,3%
2012-06,הצפון,913,שבלי - אום אל-גנם,226,101,125,6,220,168,225,8,9%
2012-06,הצפון,812,שלומי,282,120,162,14,268,154,280,40,8%
2012-06,הצפון,538,שעב,466,181,285,3,463,422,466,6,17%
2012-06,הצפון,8800,שפרעם,2032,802,1230,33,1999,1672,2028,54,12%
2012-06,חיפה,2710,אום אל-פחם,3754,1554,2200,13,3741,3225,3750,53,20%
2012-06,חיפה,1020,אור עקיבא,666,296,370,41,625,225,659,55,7%
2012-06,חיפה,6000,באקה אל-גרביה,695,341,354,11,684,439,693,26,7%
2012-06,חיפה,9800,בנימינה-גבעת עדה*,213,94,119,44,169,53,211,9,3%
2012-06,חיפה,1326,"בסמ""ה",450,213,237,1,449,338,450,6,13%
2012-06,חיפה,541,ג'סר א-זרקא,462,249,213,1,461,280,459,13,8%
2012-06,חיפה,628,ג'ת,217,113,104,8,209,124,216,8,5%
2012-06,חיפה,494,דאלית אל-כרמל,490,197,293,7,483,297,487,28,7%
2012-06,חיפה,9300,זכרון יעקב,318,146,172,80,238,47,318,18,3%
2012-06,חיפה,6500,חדרה,2677,1117,1560,278,2399,996,2650,140,6%
2012-06,חיפה,4000,חיפה,7799,3734,4065,1311,6488,4146,7766,510,6%
2012-06,חיפה,1247,חריש,26,14,12,3,23,9,26,1,1%
2012-06,חיפה,2100,טירת כרמל,841,388,453,29,812,459,835,55,8%
2012-06,חיפה,654,כפר קרע,366,162,204,4,362,227,364,18,5%
2012-06,חיפה,1327,מעלה עירון,936,368,568,2,934,785,936,15,18%
2012-06,חיפה,2500,נשר,590,265,325,97,493,232,590,42,5%
2012-06,חיפה,534,עספיא,329,148,181,4,325,187,328,15,7%
2012-06,חיפה,637,ערערה,602,261,341,9,593,395,602,19,8%
2012-06,חיפה,537,פוריידיס,395,187,208,3,392,257,394,8,8%
2012-06,חיפה,7800,פרדס חנה-כרכור,915,392,523,144,771,284,907,91,5%
2012-06,חיפה,6800,קריית אתא,1812,803,1009,156,1656,1029,1808,95,6%
2012-06,חיפה,9500,קריית ביאליק,1251,523,728,141,1110,644,1241,58,6%
2012-06,חיפה,2300,קריית טבעון,204,98,106,53,151,43,201,14,3%
2012-06,חיפה,9600,קריית ים,1675,777,898,160,1515,1062,1671,82,8%
2012-06,חיפה,8200,קריית מוצקין,1204,519,685,168,1036,572,1200,59,5%
2012-06,חיפה,922,רכסים,110,56,54,5,105,70,110,8,4%
2012-06,ירושלים,472,אבו גוש,265,125,140,5,260,191,265,1,10%
2012-06,ירושלים,2610,בית שמש,1254,571,683,116,1138,558,1249,112,4%
2012-06,ירושלים,3000,ירושלים,11312,5261,6051,1188,10124,6337,11252,381,4%
2012-06,ירושלים,1015,מבשרת ציון,461,230,231,63,398,159,460,18,4%
2012-06,ירושלים,1137,קריית יערים,37,15,22,6,31,17,37,0,3%
2012-06,תל אביב,2400,אור יהודה,908,432,476,43,865,289,898,68,5%
2012-06,תל אביב,565,אזור,204,101,103,16,188,38,203,10,3%
2012-06,תל אביב,6100,בני ברק,2363,1188,1175,110,2253,1342,2356,84,5%
2012-06,תל אביב,6200,בת ים,3906,1857,2049,482,3424,1337,3855,249,5%
2012-06,תל אביב,6300,גבעתיים,821,377,444,296,525,101,812,46,3%
2012-06,תל אביב,6400,הרצלייה,1407,689,718,296,1111,59,1400,376,3%
2012-06,תל אביב,6600,חולון,3937,1905,2032,466,3471,897,3901,186,4%
2012-06,תל אביב,2620,קריית אונו,505,239,266,130,375,46,500,28,3%
2012-06,תל אביב,8600,רמת גן,2327,1081,1246,597,1730,447,2312,112,3%
2012-06,תל אביב,2650,רמת השרון,600,285,315,187,413,7,596,159,3%
2012-06,תל אביב,5000,תל אביב -יפו,8481,4250,4231,2457,6024,2586,8437,387,4%
2012-07,אזור יהודה והשומרון,3760,אורנית,116,49,67,28,88,6,115,2,3%
2012-07,אזור יהודה והשומרון,3750,אלפי מנשה,107,55,52,21,86,3,107,6,3%
2012-07,אזור יהודה והשומרון,3560,אלקנה,47,23,24,18,29,2,46,3,3%
2012-07,אזור יהודה והשומרון,3650,אפרת,101,58,43,25,76,10,100,2,3%
2012-07,אזור יהודה והשומרון,3570,אריאל,499,269,230,115,384,98,498,24,5%
2012-07,אזור יהודה והשומרון,3574,בית אל,66,39,27,12,54,17,66,5,3%
2012-07,אזור יהודה והשומרון,3652,בית אריה,81,33,48,10,71,4,80,2,3%
2012-07,אזור יהודה והשומרון,3780,ביתר עילית,569,236,333,18,551,215,564,11,5%
2012-07,אזור יהודה והשומרון,3730,גבעת זאב,225,122,103,29,196,34,225,12,3%
2012-07,אזור יהודה והשומרון,3769,הר אדר,48,30,18,14,34,2,48,1,3%
2012-07,אזור יהודה והשומרון,3797,מודיעין עילית,665,170,495,24,641,123,663,21,5%
2012-07,אזור יהודה והשומרון,3616,מעלה אדומים,663,260,403,99,564,186,656,43,3%
2012-07,אזור יהודה והשומרון,3660,עמנואל,115,58,57,4,111,59,114,1,11%
2012-07,אזור יהודה והשומרון,3557,קדומים,70,40,30,17,53,8,69,4,4%
2012-07,אזור יהודה והשומרון,3611,קריית ארבע,132,63,69,17,115,63,132,6,4%
2012-07,אזור יהודה והשומרון,3640,קרני שומרון,172,84,88,33,139,20,172,9,5%
2012-07,הדרום,31,אופקים,1642,672,970,112,1530,998,1624,39,13%
2012-07,הדרום,2600,אילת,1557,680,877,74,1483,596,1539,108,5%
2012-07,הדרום,70,אשדוד,7764,3094,4670,886,6878,3897,7716,309,7%
2012-07,הדרום,7100,אשקלון,5018,1982,3036,699,4319,2636,4907,341,8%
2012-07,הדרום,9000,באר שבע,8499,3739,4760,1030,7469,4765,8438,1275,8%
2012-07,הדרום,2200,דימונה,2391,999,1392,155,2236,1525,2366,106,13%
2012-07,הדרום,1303,חורה,749,312,437,1,748,692,749,12,21%
2012-07,הדרום,831,ירוחם,571,259,312,26,545,295,565,78,13%
2012-07,הדרום,1059,כסיפה,1014,433,581,6,1008,882,1010,31,24%
2012-07,הדרום,1271,להבים,78,37,41,24,54,3,78,32,2%
2012-07,הדרום,1060,לקיה,985,418,567,5,980,896,983,12,27%
2012-07,הדרום,1268,מיתר,114,64,50,28,86,8,114,52,3%
2012-07,הדרום,99,מצפה רמון,292,121,171,20,272,137,276,55,11%
2012-07,הדרום,246,נתיבות,1269,532,737,65,1204,559,1258,72,10%
2012-07,הדרום,666,עומר,95,40,55,25,70,5,95,31,2%
2012-07,הדרום,2560,ערד,933,401,532,164,769,461,914,140,7%
2012-07,הדרום,1192,ערערה-בנגב,996,410,586,4,992,929,994,10,26%
2012-07,הדרום,2630,קריית גת,2660,1105,1555,209,2451,1547,2656,43,10%
2012-07,הדרום,1034,קריית מלאכי,1393,636,757,35,1358,798,1378,178,12%
2012-07,הדרום,1161,רהט,3225,1279,1946,10,3215,2725,3222,52,19%
2012-07,הדרום,1286,שגב-שלום,511,189,322,1,510,460,509,19,21%
2012-07,הדרום,1031,שדרות,1266,521,745,72,1194,692,1260,46,10%
2012-07,הדרום,1054,תל שבע,1159,534,625,3,1156,1087,1159,21,26%
2012-07,המרכז,182,אבן יהודה,173,78,95,51,122,19,172,4,3%
2012-07,המרכז,41,אליכין,81,33,48,8,73,18,80,5,5%
2012-07,המרכז,1309,אלעד,496,206,290,20,476,119,494,24,4%
2012-07,המרכז,2530,באר יעקב,310,123,187,46,264,75,305,13,4%
2012-07,המרכז,466,בית דגן,138,65,73,25,113,37,138,10,4%
2012-07,המרכז,1066,"בני עי""ש",218,99,119,33,185,72,217,0,5%
2012-07,המרכז,681,גבעת שמואל,320,160,160,120,200,55,319,6,3%
2012-07,המרכז,2550,גדרה,507,217,290,80,427,102,502,4,5%
2012-07,המרכז,627,ג'לג'וליה,92,46,46,0,92,46,92,1,3%
2012-07,המרכז,166,גן יבנה,414,147,267,48,366,89,412,10,4%
2012-07,המרכז,229,גני תקווה,215,118,97,53,162,26,214,5,3%
2012-07,המרכז,9700,הוד השרון,829,395,434,261,568,67,826,46,3%
2012-07,המרכז,1290,זמר,161,52,109,5,156,123,161,5,6%
2012-07,המרכז,2730,טייבה,2267,957,1310,5,2262,1880,2260,27,14%
2012-07,המרכז,2720,טירה,372,188,184,17,355,188,372,18,4%
2012-07,המרכז,2660,יבנה,1018,509,509,87,931,387,1013,70,5%
2012-07,המרכז,9400,יהוד,658,282,376,88,570,65,634,22,4%
2012-07,המרכז,1224,כוכב יאיר,139,69,70,24,115,3,139,11,3%
2012-07,המרכז,633,כפר ברא,31,17,14,1,30,13,31,0,3%
2012-07,המרכז,168,כפר יונה,410,181,229,70,340,67,410,20,4%
2012-07,המרכז,6900,כפר סבא,1569,729,840,405,1164,189,1558,84,3%
2012-07,המרכז,634,כפר קאסם,270,116,154,7,263,119,270,5,3%
2012-07,המרכז,7000,לוד,2680,1189,1491,187,2493,1372,2668,146,8%
2012-07,המרכז,1200,מודיעין-מכבים-רעות*,1314,564,750,399,915,65,1307,57,3%
2012-07,המרכז,28,מזכרת בתיה,258,114,144,44,214,38,256,1,4%
2012-07,המרכז,7200,נס ציונה,832,373,459,144,688,190,826,3,4%
2012-07,המרכז,7400,נתניה,5086,2228,2858,674,4412,1683,5052,276,5%
2012-07,המרכז,587,סביון*,27,14,13,9,18,0,27,0,2%
2012-07,המרכז,171,פרדסייה,85,41,44,21,64,5,85,0,2%
2012-07,המרכז,7900,פתח תקווה,4869,2166,2703,898,3971,1124,4838,189,4%
2012-07,המרכז,195,קדימה-צורן,320,137,183,80,240,30,319,11,3%
2012-07,המרכז,638,קלנסווה,948,354,594,3,945,775,943,17,12%
2012-07,המרכז,469,קריית עקרון,368,172,196,21,347,131,359,3,6%
2012-07,המרכז,2640,ראש העין,945,460,485,105,840,168,930,58,4%
2012-07,המרכז,8300,ראשון לציון,5358,2412,2946,1036,4322,1547,5346,278,4%
2012-07,המרכז,8400,רחובות,3165,1358,1807,544,2621,1041,3112,20,5%
2012-07,המרכז,8500,רמלה,2075,976,1099,112,1963,845,2039,127,6%
2012-07,המרכז,8700,רעננה,1118,548,570,341,777,90,1113,56,3%
2012-07,המרכז,1304,שוהם,258,120,138,81,177,6,258,12,3%
2012-07,המרכז,154,תל מונד,194,83,111,61,133,23,194,7,3%
2012-07,הצפון,473,אבו סנאן,782,323,459,6,776,638,778,18,15%
2012-07,הצפון,478,אכסאל,538,223,315,15,523,462,536,7,11%
2012-07,הצפון,529,אעבלין,637,250,387,10,627,519,637,13,12%
2012-07,הצפון,482,בועיינה-נוג'ידאת,470,191,279,8,462,381,465,22,13%
2012-07,הצפון,4001,בוקעאתא,399,153,246,10,389,336,393,7,15%
2012-07,הצפון,998,ביר אל-מכסור,424,163,261,5,419,329,424,6,13%
2012-07,הצפון,480,בית ג'ן,362,113,249,5,357,260,358,6,7%
2012-07,הצפון,9200,בית שאן,874,393,481,30,844,450,872,51,9%
2012-07,הצפון,944,בסמת טבעון,207,86,121,3,204,165,206,9,7%
2012-07,הצפון,483,בענה,430,164,266,6,424,359,430,14,14%
2012-07,הצפון,1292,ג'דיידה-מכר,1553,632,921,7,1546,1304,1550,49,18%
2012-07,הצפון,485,ג'ולס,235,57,178,2,233,156,235,4,9%
2012-07,הצפון,487,ג'ש (גוש חלב),71,32,39,5,66,30,70,6,5%
2012-07,הצפון,489,דבורייה,428,183,245,23,405,317,428,5,11%
2012-07,הצפון,490,דייר אל-אסד,448,182,266,11,437,320,448,7,10%
2012-07,הצפון,492,דייר חנא,647,260,387,11,636,502,647,27,15%
2012-07,הצפון,975,זרזיר,327,151,176,5,322,210,320,12,12%
2012-07,הצפון,496,חורפיש,144,58,86,5,139,79,144,8,6%
2012-07,הצפון,2034,חצור הגלילית,335,151,184,15,320,134,331,24,7%
2012-07,הצפון,6700,טבריה,2093,895,1198,124,1969,1240,1953,107,9%
2012-07,הצפון,962,טובא-זנגרייה,397,181,216,6,391,267,392,5,14%
2012-07,הצפון,498,טורעאן,620,221,399,12,608,493,617,30,12%
2012-07,הצפון,8900,טמרה,2019,778,1241,18,2001,1735,2015,39,16%
2012-07,הצפון,1295,יאנוח-ג'ת,184,69,115,5,179,118,184,7,7%
2012-07,הצפון,46,יבנאל,155,96,59,8,147,110,145,2,10%
2012-07,הצפון,499,יפיע,652,290,362,13,639,492,647,19,9%
2012-07,הצפון,240,יקנעם עילית,563,234,329,89,474,177,563,41,5%
2012-07,הצפון,502,ירכא,551,227,324,2,549,431,551,13,10%
2012-07,הצפון,504,כאבול,709,278,431,12,697,602,707,12,16%
2012-07,הצפון,505,כאוכב אבו אל-היג'א,220,97,123,7,213,181,220,7,14%
2012-07,הצפון,1296,כסרא-סמיע,241,88,153,3,238,183,239,18,8%
2012-07,הצפון,978,כעביה-טבאש-חג'אג'רה,192,77,115,3,189,144,190,1,10%
2012-07,הצפון,1263,כפר ורדים,121,46,75,30,91,9,121,2,4%
2012-07,הצפון,507,כפר יאסיף,551,233,318,6,545,411,551,23,11%
2012-07,הצפון,508,כפר כמא,72,26,46,1,71,36,71,2,5%
2012-07,הצפון,509,כפר כנא,1291,521,770,35,1256,1096,1280,75,16%
2012-07,הצפון,510,כפר מנדא,963,428,535,11,952,731,949,21,14%
2012-07,הצפון,47,כפר תבור,62,19,43,11,51,1,62,0,3%
2012-07,הצפון,1139,כרמיאל,1897,772,1125,360,1537,897,1837,115,7%
2012-07,הצפון,481,מגאר,1508,582,926,28,1480,1306,1504,65,18%
2012-07,הצפון,516,מג'ד אל-כרום,579,252,327,4,575,441,579,10,10%
2012-07,הצפון,874,מגדל העמק,1142,449,693,102,1040,492,1102,116,8%
2012-07,הצפון,4201,מג'דל שמס,476,173,303,15,461,415,468,8,11%
2012-07,הצפון,517,מזרעה,184,72,112,4,180,147,183,7,10%
2012-07,הצפון,4203,מסעדה,188,65,123,4,184,154,187,14,12%
2012-07,הצפון,518,מעיליא,57,31,26,5,52,21,57,3,4%
2012-07,הצפון,1063,מעלות-תרשיחא,1037,465,572,124,913,550,1034,56,9%
2012-07,הצפון,520,משהד,317,118,199,4,313,263,314,11,11%
2012-07,הצפון,9100,נהרייה,2236,1020,1216,242,1994,1276,2227,134,8%
2012-07,הצפון,522,נחף,428,197,231,12,416,328,428,10,9%
2012-07,הצפון,7300,נצרת,3166,1365,1801,103,3063,2346,3153,63,10%
2012-07,הצפון,1061,נצרת עילית,2147,921,1226,276,1871,1092,2050,161,9%
2012-07,הצפון,525,סאג'ור,149,62,87,1,148,85,148,7,9%
2012-07,הצפון,7500,סח'נין,2047,883,1164,43,2004,1727,2047,70,16%
2012-07,הצפון,4501,ע'ג'ר,71,28,43,1,70,54,71,2,8%
2012-07,הצפון,530,עיילבון,211,87,124,6,205,143,210,8,8%
2012-07,הצפון,511,עילוט,317,127,190,3,314,246,316,6,12%
2012-07,הצפון,532,עין מאהל,594,265,329,6,588,517,587,2,13%
2012-07,הצפון,7600,עכו,3437,1514,1923,165,3272,2558,3405,128,13%
2012-07,הצפון,7700,עפולה,1918,824,1094,197,1721,831,1861,108,8%
2012-07,הצפון,531,עראבה,1432,589,843,31,1401,1253,1429,31,16%
2012-07,הצפון,535,פסוטה,131,51,80,9,122,87,131,5,8%
2012-07,הצפון,536,פקיעין (בוקייעה),128,70,58,5,123,78,127,1,5%
2012-07,הצפון,8000,צפת,1471,748,723,77,1394,975,1457,132,11%
2012-07,הצפון,4100,קצרין,212,96,116,29,183,90,211,27,6%
2012-07,הצפון,2800,קריית שמונה,846,391,455,56,790,280,823,82,6%
2012-07,הצפון,543,ראמה,318,122,196,7,311,243,317,6,9%
2012-07,הצפון,26,ראש פינה,78,28,50,10,68,22,76,6,5%
2012-07,הצפון,542,ריינה,684,280,404,18,666,535,678,21,11%
2012-07,הצפון,122,רמת ישי,130,50,80,31,99,15,130,3,3%
2012-07,הצפון,913,שבלי - אום אל-גנם,254,117,137,8,246,168,252,6,11%
2012-07,הצפון,812,שלומי,286,123,163,17,269,140,285,26,8%
2012-07,הצפון,538,שעב,478,189,289,3,475,430,478,7,17%
2012-07,הצפון,8800,שפרעם,2085,816,1269,44,2041,1669,2079,62,13%
2012-07,חיפה,2710,אום אל-פחם,3848,1565,2283,15,3833,3244,3843,45,20%
2012-07,חיפה,1020,אור עקיבא,659,302,357,49,610,231,647,78,7%
2012-07,חיפה,6000,באקה אל-גרביה,691,325,366,13,678,458,690,21,7%
2012-07,חיפה,9800,בנימינה-גבעת עדה*,227,99,128,42,185,51,225,8,3%
2012-07,חיפה,1326,"בסמ""ה",445,210,235,2,443,341,445,9,13%
2012-07,חיפה,541,ג'סר א-זרקא,453,241,212,1,452,274,450,12,8%
2012-07,חיפה,628,ג'ת,201,93,108,10,191,124,200,6,4%
2012-07,חיפה,494,דאלית אל-כרמל,526,211,315,8,518,300,521,19,7%
2012-07,חיפה,9300,זכרון יעקב,320,157,163,88,232,48,318,16,3%
2012-07,חיפה,6500,חדרה,2778,1153,1625,320,2458,993,2746,122,6%
2012-07,חיפה,4000,חיפה,7379,3510,3869,1286,6093,4159,7347,515,5%
2012-07,חיפה,1247,חריש,32,16,16,6,26,9,31,1,2%
2012-07,חיפה,2100,טירת כרמל,791,367,424,29,762,464,783,57,8%
2012-07,חיפה,654,כפר קרע,384,162,222,9,375,230,382,20,5%
2012-07,חיפה,1327,מעלה עירון,962,381,581,2,960,784,962,15,18%
2012-07,חיפה,2500,נשר,554,250,304,91,463,229,553,55,4%
2012-07,חיפה,534,עספיא,403,168,235,9,394,187,401,43,8%
2012-07,חיפה,637,ערערה,611,254,357,11,600,402,611,30,8%
2012-07,חיפה,537,פוריידיס,421,192,229,3,418,263,420,15,8%
2012-07,חיפה,7800,פרדס חנה-כרכור,968,403,565,150,818,304,959,80,5%
2012-07,חיפה,6800,קריית אתא,1997,814,1183,169,1828,1057,1991,112,7%
2012-07,חיפה,9500,קריית ביאליק,1305,551,754,151,1154,655,1300,75,6%
2012-07,חיפה,2300,קריית טבעון,211,109,102,58,153,44,209,8,3%
2012-07,חיפה,9600,קריית ים,1739,806,933,167,1572,1043,1733,96,8%
2012-07,חיפה,8200,קריית מוצקין,1215,514,701,165,1050,575,1209,80,6%
2012-07,חיפה,922,רכסים,140,61,79,5,135,72,139,5,5%
2012-07,ירושלים,472,אבו גוש,289,151,138,10,279,193,289,3,10%
2012-07,ירושלים,2610,בית שמש,1600,662,938,122,1478,598,1594,85,6%
2012-07,ירושלים,3000,ירושלים,12336,5395,6941,1261,11075,6456,12274,421,5%
2012-07,ירושלים,1015,מבשרת ציון,527,242,285,75,452,166,526,13,4%
2012-07,ירושלים,1137,קריית יערים,46,18,28,5,41,20,45,1,4%
2012-07,תל אביב,2400,אור יהודה,972,442,530,43,929,287,955,71,5%
2012-07,תל אביב,565,אזור,198,90,108,20,178,36,197,11,3%
2012-07,תל אביב,6100,בני ברק,2806,1195,1611,119,2687,1346,2798,68,5%
2012-07,תל אביב,6200,בת ים,3752,1778,1974,512,3240,1345,3687,327,5%
2012-07,תל אביב,6300,גבעתיים,796,343,453,297,499,101,785,46,3%
2012-07,תל אביב,6400,הרצלייה,1326,624,702,326,1000,63,1312,306,3%
2012-07,תל אביב,6600,חולון,3498,1586,1912,509,2989,928,3457,208,4%
2012-07,תל אביב,2620,קריית אונו,445,191,254,142,303,45,443,12,3%
2012-07,תל אביב,8600,רמת גן,2392,1086,1306,669,1723,477,2378,141,3%
2012-07,תל אביב,2650,רמת השרון,518,230,288,186,332,7,515,90,2%
2012-07,תל אביב,5000,תל אביב -יפו,8696,4323,4373,2629,6067,2681,8646,420,4%
2012-08,אזור יהודה והשומרון,3760,אורנית,105,43,62,33,72,6,105,4,3%
2012-08,אזור יהודה והשומרון,3750,אלפי מנשה,107,60,47,23,84,2,107,8,3%
2012-08,אזור יהודה והשומרון,3560,אלקנה,38,23,15,17,21,2,37,0,2%
2012-08,אזור יהודה והשומרון,3650,אפרת,58,25,33,27,31,8,57,5,2%
2012-08,אזור יהודה והשומרון,3570,אריאל,471,242,229,118,353,102,471,20,5%
2012-08,אזור יהודה והשומרון,3574,בית אל,71,40,31,16,55,21,70,4,3%
2012-08,אזור יהודה והשומרון,3652,בית אריה,60,24,36,9,51,4,60,1,3%
2012-08,אזור יהודה והשומרון,3780,ביתר עילית,590,241,349,18,572,212,587,3,6%
2012-08,אזור יהודה והשומרון,3730,גבעת זאב,191,88,103,29,162,33,191,11,3%
2012-08,אזור יהודה והשומרון,3769,הר אדר,30,15,15,14,16,2,30,1,2%
2012-08,אזור יהודה והשומרון,3797,מודיעין עילית,732,168,564,28,704,124,729,40,6%
2012-08,אזור יהודה והשומרון,3616,מעלה אדומים,663,246,417,95,568,183,654,65,3%
2012-08,אזור יהודה והשומרון,3660,עמנואל,104,48,56,3,101,61,104,2,10%
2012-08,אזור יהודה והשומרון,3557,קדומים,43,19,24,15,28,8,42,3,2%
2012-08,אזור יהודה והשומרון,3611,קריית ארבע,136,68,68,18,118,59,136,24,5%
2012-08,אזור יהודה והשומרון,3640,קרני שומרון,108,55,53,32,76,18,108,4,3%
2012-08,הדרום,31,אופקים,1590,631,959,119,1471,995,1577,38,13%
2012-08,הדרום,2600,אילת,1405,607,798,70,1335,585,1387,89,4%
2012-08,הדרום,70,אשדוד,8133,3203,4930,927,7206,3813,8084,422,8%
2012-08,הדרום,7100,אשקלון,4789,1862,2927,727,4062,2610,4680,188,7%
2012-08,הדרום,9000,באר שבע,7866,3362,4504,1033,6833,4785,7812,631,8%
2012-08,הדרום,2200,דימונה,2264,893,1371,153,2111,1520,2240,71,13%
2012-08,הדרום,1303,חורה,744,310,434,1,743,689,744,11,21%
2012-08,הדרום,831,ירוחם,510,235,275,24,486,296,508,37,12%
2012-08,הדרום,1059,כסיפה,1013,429,584,5,1008,875,1012,40,24%
2012-08,הדרום,1271,להבים,47,20,27,20,27,3,47,8,1%
2012-08,הדרום,1060,לקיה,986,411,575,7,979,889,984,25,27%
2012-08,הדרום,1268,מיתר,79,36,43,34,45,9,79,19,2%
2012-08,הדרום,99,מצפה רמון,255,102,153,17,238,136,239,31,10%
2012-08,הדרום,246,נתיבות,1208,477,731,67,1141,572,1201,98,9%
2012-08,הדרום,666,עומר,65,19,46,24,41,5,65,10,2%
2012-08,הדרום,2560,ערד,888,385,503,166,722,461,863,115,7%
2012-08,הדרום,1192,ערערה-בנגב,999,424,575,3,996,920,997,5,26%
2012-08,הדרום,2630,קריית גת,2544,1023,1521,215,2329,1585,2539,57,10%
2012-08,הדרום,1034,קריית מלאכי,1318,581,737,40,1278,805,1299,123,11%
2012-08,הדרום,1161,רהט,3167,1279,1888,10,3157,2720,3165,32,19%
2012-08,הדרום,1286,שגב-שלום,500,180,320,0,500,457,499,15,21%
2012-08,הדרום,1031,שדרות,1213,477,736,73,1140,704,1208,43,10%
2012-08,הדרום,1054,תל שבע,1153,534,619,2,1151,1079,1153,27,26%
2012-08,המרכז,182,אבן יהודה,153,73,80,49,104,17,153,5,2%
2012-08,המרכז,41,אליכין,79,36,43,10,69,18,79,3,4%
2012-08,המרכז,1309,אלעד,572,199,373,18,554,119,569,72,5%
2012-08,המרכז,2530,באר יעקב,256,92,164,50,206,69,251,17,3%
2012-08,המרכז,466,בית דגן,101,60,41,23,78,36,101,5,3%
2012-08,המרכז,1066,"בני עי""ש",214,94,120,30,184,68,212,1,5%
2012-08,המרכז,681,גבעת שמואל,306,157,149,123,183,56,304,11,3%
2012-08,המרכז,2550,גדרה,420,190,230,82,338,102,413,2,4%
2012-08,המרכז,627,ג'לג'וליה,93,45,48,2,91,50,93,4,3%
2012-08,המרכז,166,גן יבנה,477,170,307,47,430,96,474,21,5%
2012-08,המרכז,229,גני תקווה,191,92,99,55,136,24,191,12,3%
2012-08,המרכז,9700,הוד השרון,703,333,370,267,436,72,702,33,3%
2012-08,המרכז,1290,זמר,151,47,104,7,144,116,151,2,6%
2012-08,המרכז,2730,טייבה,2193,906,1287,4,2189,1867,2188,19,14%
2012-08,המרכז,2720,טירה,331,161,170,12,319,180,330,5,3%
2012-08,המרכז,2660,יבנה,959,462,497,88,871,374,957,63,5%
2012-08,המרכז,9400,יהוד,550,216,334,87,463,65,539,17,4%
2012-08,המרכז,1224,כוכב יאיר,85,31,54,30,55,3,85,3,2%
2012-08,המרכז,633,כפר ברא,27,14,13,1,26,13,27,2,2%
2012-08,המרכז,168,כפר יונה,364,155,209,72,292,60,363,15,4%
2012-08,המרכז,6900,כפר סבא,1337,553,784,416,921,198,1332,60,3%
2012-08,המרכז,634,כפר קאסם,256,97,159,6,250,123,256,38,3%
2012-08,המרכז,7000,לוד,2457,1080,1377,201,2256,1287,2441,182,7%
2012-08,המרכז,1200,מודיעין-מכבים-רעות*,1087,429,658,378,709,68,1081,99,3%
2012-08,המרכז,28,מזכרת בתיה,196,87,109,43,153,37,192,1,3%
2012-08,המרכז,7200,נס ציונה,761,322,439,152,609,196,755,5,4%
2012-08,המרכז,7400,נתניה,4796,2022,2774,680,4116,1637,4767,185,5%
2012-08,המרכז,587,סביון*,20,8,12,12,8,0,20,0,1%
2012-08,המרכז,171,פרדסייה,77,36,41,22,55,6,77,5,2%
2012-08,המרכז,7900,פתח תקווה,4528,1939,2589,914,3614,1133,4500,256,4%
2012-08,המרכז,195,קדימה-צורן,252,96,156,83,169,34,252,11,3%
2012-08,המרכז,638,קלנסווה,903,330,573,3,900,762,899,12,11%
2012-08,המרכז,469,קריית עקרון,333,160,173,20,313,119,329,3,6%
2012-08,המרכז,2640,ראש העין,914,398,516,115,799,170,903,38,4%
2012-08,המרכז,8300,ראשון לציון,4799,2088,2711,1034,3765,1562,4791,244,4%
2012-08,המרכז,8400,רחובות,2944,1200,1744,555,2389,1051,2887,24,5%
2012-08,המרכז,8500,רמלה,1970,928,1042,117,1853,844,1935,142,6%
2012-08,המרכז,8700,רעננה,878,416,462,349,529,86,878,31,2%
2012-08,המרכז,1304,שוהם,224,93,131,87,137,8,224,17,2%
2012-08,המרכז,154,תל מונד,151,65,86,60,91,22,151,4,3%
2012-08,הצפון,473,אבו סנאן,745,295,450,6,739,630,741,16,14%
2012-08,הצפון,478,אכסאל,543,230,313,18,525,459,542,3,11%
2012-08,הצפון,529,אעבלין,627,242,385,9,618,520,627,11,12%
2012-08,הצפון,482,בועיינה-נוג'ידאת,439,173,266,9,430,380,435,9,13%
2012-08,הצפון,4001,בוקעאתא,387,139,248,8,379,336,380,0,15%
2012-08,הצפון,998,ביר אל-מכסור,409,150,259,5,404,332,409,12,13%
2012-08,הצפון,480,בית ג'ן,361,124,237,6,355,259,354,2,7%
2012-08,הצפון,9200,בית שאן,968,409,559,25,943,470,965,83,10%
2012-08,הצפון,944,בסמת טבעון,203,76,127,3,200,171,202,10,7%
2012-08,הצפון,483,בענה,420,153,267,4,416,354,420,4,14%
2012-08,הצפון,1292,ג'דיידה-מכר,1511,609,902,6,1505,1318,1508,33,18%
2012-08,הצפון,485,ג'ולס,239,56,183,2,237,155,239,17,9%
2012-08,הצפון,487,ג'ש (גוש חלב),59,21,38,5,54,27,58,3,4%
2012-08,הצפון,489,דבורייה,413,176,237,20,393,314,413,4,11%
2012-08,הצפון,490,דייר אל-אסד,425,170,255,10,415,315,425,9,9%
2012-08,הצפון,492,דייר חנא,635,258,377,13,622,506,635,16,15%
2012-08,הצפון,975,זרזיר,302,142,160,6,296,199,299,8,11%
2012-08,הצפון,496,חורפיש,117,46,71,7,110,70,116,4,5%
2012-08,הצפון,2034,חצור הגלילית,286,128,158,14,272,131,281,9,6%
2012-08,הצפון,6700,טבריה,2035,850,1185,124,1911,1258,1892,68,9%
2012-08,הצפון,962,טובא-זנגרייה,388,179,209,8,380,272,384,1,13%
2012-08,הצפון,498,טורעאן,597,215,382,9,588,483,588,24,12%
2012-08,הצפון,8900,טמרה,2006,770,1236,17,1989,1753,2004,42,16%
2012-08,הצפון,1295,יאנוח-ג'ת,157,57,100,6,151,104,157,6,6%
2012-08,הצפון,46,יבנאל,163,98,65,7,156,111,152,1,10%
2012-08,הצפון,499,יפיע,636,263,373,12,624,489,631,9,9%
2012-08,הצפון,240,יקנעם עילית,578,242,336,95,483,179,577,42,5%
2012-08,הצפון,502,ירכא,547,211,336,2,545,440,547,11,10%
2012-08,הצפון,504,כאבול,703,263,440,11,692,611,700,10,15%
2012-08,הצפון,505,כאוכב אבו אל-היג'א,223,100,123,6,217,183,223,7,14%
2012-08,הצפון,1296,כסרא-סמיע,205,87,118,1,204,152,204,12,7%
2012-08,הצפון,978,כעביה-טבאש-חג'אג'רה,192,80,112,1,191,149,192,2,10%
2012-08,הצפון,1263,כפר ורדים,99,36,63,31,68,9,99,0,3%
2012-08,הצפון,507,כפר יאסיף,521,205,316,6,515,417,521,17,11%
2012-08,הצפון,508,כפר כמא,66,26,40,1,65,36,65,2,4%
2012-08,הצפון,509,כפר כנא,1215,458,757,34,1181,1058,1201,39,15%
2012-08,הצפון,510,כפר מנדא,939,399,540,12,927,726,931,17,14%
2012-08,הצפון,47,כפר תבור,50,17,33,16,34,7,50,1,3%
2012-08,הצפון,1139,כרמיאל,1839,749,1090,376,1463,893,1782,71,7%
2012-08,הצפון,481,מגאר,1518,602,916,23,1495,1316,1515,23,18%
2012-08,הצפון,516,מג'ד אל-כרום,565,237,328,5,560,441,565,7,10%
2012-08,הצפון,874,מגדל העמק,1103,431,672,99,1004,492,1066,79,8%
2012-08,הצפון,4201,מג'דל שמס,460,167,293,14,446,399,452,1,10%
2012-08,הצפון,517,מזרעה,176,62,114,4,172,148,175,2,10%
2012-08,הצפון,4203,מסעדה,176,60,116,5,171,149,175,0,11%
2012-08,הצפון,518,מעיליא,46,22,24,4,42,19,46,2,3%
2012-08,הצפון,1063,מעלות-תרשיחא,989,446,543,135,854,546,986,54,8%
2012-08,הצפון,520,משהד,310,117,193,3,307,257,306,5,10%
2012-08,הצפון,9100,נהרייה,2084,931,1153,251,1833,1257,2077,79,7%
2012-08,הצפון,522,נחף,409,181,228,8,401,321,409,8,9%
2012-08,הצפון,7300,נצרת,3098,1284,1814,111,2987,2360,3081,41,10%
2012-08,הצפון,1061,נצרת עילית,2054,861,1193,294,1760,1058,1961,109,8%
2012-08,הצפון,525,סאג'ור,130,49,81,1,129,85,129,1,8%
2012-08,הצפון,7500,סח'נין,2036,880,1156,39,1997,1737,2032,44,16%
2012-08,הצפון,4501,ע'ג'ר,65,24,41,1,64,53,65,3,7%
2012-08,הצפון,530,עיילבון,205,80,125,4,201,139,204,2,8%
2012-08,הצפון,511,עילוט,317,122,195,3,314,253,316,2,12%
2012-08,הצפון,532,עין מאהל,584,258,326,4,580,512,577,0,13%
2012-08,הצפון,7600,עכו,3341,1483,1858,169,3172,2503,3315,125,13%
2012-08,הצפון,7700,עפולה,1853,775,1078,204,1649,839,1803,88,8%
2012-08,הצפון,531,עראבה,1404,571,833,26,1378,1249,1403,23,15%
2012-08,הצפון,535,פסוטה,124,52,72,8,116,79,124,3,8%
2012-08,הצפון,536,פקיעין (בוקייעה),122,68,54,6,116,72,121,3,5%
2012-08,הצפון,8000,צפת,1357,679,678,80,1277,988,1344,52,11%
2012-08,הצפון,4100,קצרין,188,87,101,30,158,80,186,13,5%
2012-08,הצפון,2800,קריית שמונה,720,311,409,64,656,259,702,57,6%
2012-08,הצפון,543,ראמה,309,116,193,8,301,237,309,1,9%
2012-08,הצפון,26,ראש פינה,57,18,39,12,45,19,56,1,4%
2012-08,הצפון,542,ריינה,648,253,395,16,632,529,645,9,10%
2012-08,הצפון,122,רמת ישי,105,32,73,35,70,14,105,3,3%
2012-08,הצפון,913,שבלי - אום אל-גנם,239,108,131,10,229,166,237,2,10%
2012-08,הצפון,812,שלומי,262,101,161,21,241,147,261,9,7%
2012-08,הצפון,538,שעב,477,187,290,4,473,432,477,10,17%
2012-08,הצפון,8800,שפרעם,2019,757,1262,44,1975,1693,2011,62,12%
2012-08,חיפה,2710,אום אל-פחם,3782,1527,2255,14,3768,3225,3776,45,20%
2012-08,חיפה,1020,אור עקיבא,639,273,366,56,583,232,632,53,7%
2012-08,חיפה,6000,באקה אל-גרביה,666,306,360,16,650,455,664,19,7%
2012-08,חיפה,9800,בנימינה-גבעת עדה*,193,75,118,45,148,56,191,8,3%
2012-08,חיפה,1326,"בסמ""ה",425,193,232,2,423,340,425,6,12%
2012-08,חיפה,541,ג'סר א-זרקא,432,226,206,1,431,278,430,7,8%
2012-08,חיפה,628,ג'ת,200,93,107,10,190,123,199,9,4%
2012-08,חיפה,494,דאלית אל-כרמל,530,201,329,10,520,307,525,15,7%
2012-08,חיפה,9300,זכרון יעקב,268,124,144,88,180,52,264,8,3%
2012-08,חיפה,6500,חדרה,2632,1027,1605,334,2298,1002,2602,78,6%
2012-08,חיפה,4000,חיפה,6980,3246,3734,1274,5706,4156,6951,421,5%
2012-08,חיפה,1247,חריש,34,16,18,4,30,6,33,0,2%
2012-08,חיפה,2100,טירת כרמל,760,344,416,34,726,469,753,55,7%
2012-08,חיפה,654,כפר קרע,345,143,202,8,337,225,343,8,5%
2012-08,חיפה,1327,מעלה עירון,958,375,583,2,956,790,958,15,18%
2012-08,חיפה,2500,נשר,501,220,281,101,400,233,498,34,4%
2012-08,חיפה,534,עספיא,350,134,216,10,340,188,349,9,7%
2012-08,חיפה,637,ערערה,588,228,360,10,578,392,588,18,8%
2012-08,חיפה,537,פוריידיס,374,157,217,4,370,258,373,7,7%
2012-08,חיפה,7800,פרדס חנה-כרכור,913,390,523,154,759,295,909,61,5%
2012-08,חיפה,6800,קריית אתא,1838,741,1097,166,1672,1012,1834,52,6%
2012-08,חיפה,9500,קריית ביאליק,1181,479,702,153,1028,653,1177,40,6%
2012-08,חיפה,2300,קריית טבעון,189,91,98,61,128,51,187,5,2%
2012-08,חיפה,9600,קריית ים,1661,737,924,183,1478,1048,1655,56,8%
2012-08,חיפה,8200,קריית מוצקין,1125,484,641,171,954,559,1116,55,5%
2012-08,חיפה,922,רכסים,168,67,101,4,164,74,167,5,5%
2012-08,ירושלים,472,אבו גוש,270,133,137,9,261,188,270,1,10%
2012-08,ירושלים,2610,בית שמש,1449,573,876,130,1319,613,1442,92,5%
2012-08,ירושלים,3000,ירושלים,11400,4905,6495,1285,10115,6463,11337,355,4%
2012-08,ירושלים,1015,מבשרת ציון,420,190,230,70,350,171,419,19,3%
2012-08,ירושלים,1137,קריית יערים,42,18,24,4,38,20,42,1,4%
2012-08,תל אביב,2400,אור יהודה,971,386,585,41,930,297,955,42,5%
2012-08,תל אביב,565,אזור,180,79,101,26,154,33,180,12,3%
2012-08,תל אביב,6100,בני ברק,2969,1195,1774,118,2851,1374,2956,199,6%
2012-08,תל אביב,6200,בת ים,3385,1587,1798,500,2885,1340,3338,301,5%
2012-08,תל אביב,6300,גבעתיים,771,330,441,311,460,103,759,47,3%
2012-08,תל אביב,6400,הרצלייה,1119,466,653,336,783,59,1105,161,2%
2012-08,תל אביב,6600,חולון,3220,1454,1766,516,2704,931,3162,232,3%
2012-08,תל אביב,2620,קריית אונו,415,185,230,147,268,47,411,10,2%
2012-08,תל אביב,8600,רמת גן,2177,968,1209,670,1507,467,2158,147,3%
2012-08,תל אביב,2650,רמת השרון,452,193,259,201,251,11,446,44,2%
2012-08,תל אביב,5000,תל אביב -יפו,8305,4079,4226,2629,5676,2656,8255,446,3%
2012-09,אזור יהודה והשומרון,3760,אורנית,104,45,59,35,69,4,104,5,3%
2012-09,אזור יהודה והשומרון,3750,אלפי מנשה,99,47,52,28,71,1,99,1,2%
2012-09,אזור יהודה והשומרון,3560,אלקנה,30,18,12,14,16,2,29,0,2%
2012-09,אזור יהודה והשומרון,3650,אפרת,49,25,24,22,27,8,49,2,1%
2012-09,אזור יהודה והשומרון,3570,אריאל,432,219,213,108,324,100,431,11,4%
2012-09,אזור יהודה והשומרון,3574,בית אל,56,24,32,14,42,21,55,4,2%
2012-09,אזור יהודה והשומרון,3652,בית אריה,55,20,35,5,50,4,55,1,2%
2012-09,אזור יהודה והשומרון,3780,ביתר עילית,458,207,251,18,440,207,456,2,4%
2012-09,אזור יהודה והשומרון,3730,גבעת זאב,169,76,93,23,146,38,168,13,3%
2012-09,אזור יהודה והשומרון,3769,הר אדר,36,16,20,15,21,7,35,2,2%
2012-09,אזור יהודה והשומרון,3797,מודיעין עילית,380,133,247,23,357,118,377,43,3%
2012-09,אזור יהודה והשומרון,3616,מעלה אדומים,600,231,369,93,507,186,595,32,3%
2012-09,אזור יהודה והשומרון,3660,עמנואל,74,35,39,5,69,60,74,0,7%
2012-09,אזור יהודה והשומרון,3557,קדומים,30,11,19,9,21,8,30,1,2%
2012-09,אזור יהודה והשומרון,3611,קריית ארבע,115,57,58,17,98,59,115,5,4%
2012-09,אזור יהודה והשומרון,3640,קרני שומרון,101,51,50,33,68,16,100,5,3%
2012-09,הדרום,31,אופקים,1465,609,856,113,1352,983,1455,20,12%
2012-09,הדרום,2600,אילת,1266,573,693,63,1203,576,1252,61,4%
2012-09,הדרום,70,אשדוד,6924,2727,4197,870,6054,3799,6872,210,7%
2012-09,הדרום,7100,אשקלון,4346,1710,2636,688,3658,2556,4254,87,7%
2012-09,הדרום,9000,באר שבע,7202,3089,4113,1003,6199,4591,7169,309,7%
2012-09,הדרום,2200,דימונה,2079,827,1252,139,1940,1476,2060,39,12%
2012-09,הדרום,1303,חורה,737,313,424,0,737,681,737,3,21%
2012-09,הדרום,831,ירוחם,461,211,250,20,441,290,459,23,11%
2012-09,הדרום,1059,כסיפה,984,424,560,5,979,873,981,33,24%
2012-09,הדרום,1271,להבים,48,23,25,21,27,3,48,5,1%
2012-09,הדרום,1060,לקיה,955,417,538,5,950,884,953,8,27%
2012-09,הדרום,1268,מיתר,60,29,31,28,32,6,60,7,2%
2012-09,הדרום,99,מצפה רמון,249,107,142,15,234,136,238,12,10%
2012-09,הדרום,246,נתיבות,1051,442,609,62,989,541,1049,48,8%
2012-09,הדרום,666,עומר,53,18,35,24,29,5,53,3,1%
2012-09,הדרום,2560,ערד,785,346,439,145,640,434,773,45,6%
2012-09,הדרום,1192,ערערה-בנגב,949,407,542,5,944,883,948,20,25%
2012-09,הדרום,2630,קריית גת,2336,933,1403,199,2137,1531,2326,27,9%
2012-09,הדרום,1034,קריית מלאכי,1242,525,717,39,1203,791,1224,58,11%
2012-09,הדרום,1161,רהט,3041,1241,1800,9,3032,2717,3038,37,18%
2012-09,הדרום,1286,שגב-שלום,517,191,326,0,517,463,516,19,21%
2012-09,הדרום,1031,שדרות,1132,443,689,63,1069,697,1126,27,9%
2012-09,הדרום,1054,תל שבע,1144,532,612,2,1142,1081,1144,15,26%
2012-09,המרכז,182,אבן יהודה,153,70,83,51,102,19,153,3,2%
2012-09,המרכז,41,אליכין,76,33,43,7,69,18,76,2,4%
2012-09,המרכז,1309,אלעד,415,164,251,19,396,117,414,12,4%
2012-09,המרכז,2530,באר יעקב,228,92,136,45,183,66,221,12,3%
2012-09,המרכז,466,בית דגן,106,56,50,23,83,37,106,1,3%
2012-09,המרכז,1066,"בני עי""ש",210,92,118,31,179,73,208,0,5%
2012-09,המרכז,681,גבעת שמואל,286,149,137,119,167,55,285,8,3%
2012-09,המרכז,2550,גדרה,375,169,206,76,299,103,366,1,3%
2012-09,המרכז,627,ג'לג'וליה,86,36,50,3,83,51,85,3,3%
2012-09,המרכז,166,גן יבנה,356,129,227,40,316,91,353,10,3%
2012-09,המרכז,229,גני תקווה,176,80,96,57,119,25,175,4,2%
2012-09,המרכז,9700,הוד השרון,638,291,347,256,382,64,636,7,2%
2012-09,המרכז,1290,זמר,152,44,108,7,145,118,152,1,6%
2012-09,המרכז,2730,טייבה,2146,892,1254,6,2140,1854,2133,6,13%
2012-09,המרכז,2720,טירה,337,168,169,9,328,176,337,10,3%
2012-09,המרכז,2660,יבנה,809,396,413,82,727,358,806,44,4%
2012-09,המרכז,9400,יהוד,515,200,315,87,428,69,508,18,3%
2012-09,המרכז,1224,כוכב יאיר,73,29,44,36,37,4,72,1,1%
2012-09,המרכז,633,כפר ברא,22,12,10,1,21,10,22,1,2%
2012-09,המרכז,168,כפר יונה,323,146,177,67,256,64,322,4,3%
2012-09,המרכז,6900,כפר סבא,1196,516,680,402,794,184,1191,24,2%
2012-09,המרכז,634,כפר קאסם,213,95,118,0,213,125,213,5,3%
2012-09,המרכז,7000,לוד,2213,977,1236,184,2029,1255,2203,175,6%
2012-09,המרכז,1200,מודיעין-מכבים-רעות*,923,380,543,357,566,66,918,33,2%
2012-09,המרכז,28,מזכרת בתיה,169,70,99,36,133,32,168,0,3%
2012-09,המרכז,7200,נס ציונה,667,280,387,158,509,192,660,2,3%
2012-09,המרכז,7400,נתניה,4232,1879,2353,654,3578,1598,4205,63,4%
2012-09,המרכז,587,סביון*,19,6,13,13,6,0,19,0,1%
2012-09,המרכז,171,פרדסייה,74,31,43,18,56,9,74,1,2%
2012-09,המרכז,7900,פתח תקווה,4017,1784,2233,843,3174,1094,3991,190,4%
2012-09,המרכז,195,קדימה-צורן,234,86,148,84,150,31,234,4,3%
2012-09,המרכז,638,קלנסווה,883,323,560,3,880,760,879,3,11%
2012-09,המרכז,469,קריית עקרון,311,155,156,22,289,126,310,3,5%
2012-09,המרכז,2640,ראש העין,715,331,384,104,611,156,707,12,3%
2012-09,המרכז,8300,ראשון לציון,4464,1956,2508,989,3475,1509,4459,172,3%
2012-09,המרכז,8400,רחובות,2626,1101,1525,551,2075,1043,2568,8,4%
2012-09,המרכז,8500,רמלה,1684,790,894,97,1587,795,1647,99,5%
2012-09,המרכז,8700,רעננה,765,384,381,311,454,78,765,6,2%
2012-09,המרכז,1304,שוהם,193,87,106,86,107,6,193,15,2%
2012-09,המרכז,154,תל מונד,125,59,66,50,75,23,125,1,2%
2012-09,הצפון,473,אבו סנאן,737,286,451,3,734,627,733,15,14%
2012-09,הצפון,478,אכסאל,519,213,306,13,506,452,518,6,10%
2012-09,הצפון,529,אעבלין,623,240,383,12,611,518,623,14,12%
2012-09,הצפון,482,בועיינה-נוג'ידאת,421,166,255,6,415,369,416,7,12%
2012-09,הצפון,4001,בוקעאתא,382,134,248,6,376,339,373,3,15%
2012-09,הצפון,998,ביר אל-מכסור,391,142,249,2,389,324,390,8,12%
2012-09,הצפון,480,בית ג'ן,331,107,224,10,321,247,328,2,7%
2012-09,הצפון,9200,בית שאן,855,357,498,19,836,454,854,45,9%
2012-09,הצפון,944,בסמת טבעון,207,78,129,3,204,171,206,9,7%
2012-09,הצפון,483,בענה,403,152,251,4,399,350,403,10,13%
2012-09,הצפון,1292,ג'דיידה-מכר,1485,599,886,6,1479,1301,1482,35,18%
2012-09,הצפון,485,ג'ולס,239,59,180,2,237,157,239,5,9%
2012-09,הצפון,487,ג'ש (גוש חלב),50,16,34,3,47,25,49,0,3%
2012-09,הצפון,489,דבורייה,388,158,230,20,368,309,388,3,10%
2012-09,הצפון,490,דייר אל-אסד,402,167,235,10,392,321,402,8,9%
2012-09,הצפון,492,דייר חנא,632,261,371,10,622,505,632,9,15%
2012-09,הצפון,975,זרזיר,310,145,165,3,307,213,307,11,11%
2012-09,הצפון,496,חורפיש,110,38,72,8,102,72,110,9,5%
2012-09,הצפון,2034,חצור הגלילית,258,110,148,15,243,133,252,4,6%
2012-09,הצפון,6700,טבריה,1885,777,1108,121,1764,1217,1737,65,8%
2012-09,הצפון,962,טובא-זנגרייה,396,178,218,7,389,274,392,5,14%
2012-09,הצפון,498,טורעאן,550,208,342,9,541,482,540,15,11%
2012-09,הצפון,8900,טמרה,1979,755,1224,16,1963,1730,1973,54,15%
2012-09,הצפון,1295,יאנוח-ג'ת,161,50,111,4,157,108,161,3,7%
2012-09,הצפון,46,יבנאל,130,82,48,6,124,98,120,2,8%
2012-09,הצפון,499,יפיע,643,265,378,9,634,507,638,8,9%
2012-09,הצפון,240,יקנעם עילית,504,206,298,86,418,175,503,25,5%
2012-09,הצפון,502,ירכא,535,200,335,1,534,442,535,12,10%
2012-09,הצפון,504,כאבול,699,262,437,10,689,608,695,15,15%
2012-09,הצפון,505,כאוכב אבו אל-היג'א,217,97,120,4,213,179,217,4,14%
2012-09,הצפון,1296,כסרא-סמיע,194,84,110,3,191,145,194,7,6%
2012-09,הצפון,978,כעביה-טבאש-חג'אג'רה,178,67,111,1,177,140,177,1,9%
2012-09,הצפון,1263,כפר ורדים,63,25,38,26,37,8,63,3,2%
2012-09,הצפון,507,כפר יאסיף,512,203,309,5,507,411,512,10,11%
2012-09,הצפון,508,כפר כמא,61,23,38,0,61,33,60,0,4%
2012-09,הצפון,509,כפר כנא,1170,448,722,31,1139,1039,1154,29,14%
2012-09,הצפון,510,כפר מנדא,929,394,535,12,917,738,917,20,14%
2012-09,הצפון,47,כפר תבור,55,16,39,20,35,8,55,3,3%
2012-09,הצפון,1139,כרמיאל,1706,681,1025,355,1351,892,1661,40,7%
2012-09,הצפון,481,מגאר,1455,578,877,22,1433,1298,1451,17,17%
2012-09,הצפון,516,מג'ד אל-כרום,539,230,309,6,533,441,539,10,9%
2012-09,הצפון,874,מגדל העמק,975,377,598,88,887,472,947,42,7%
2012-09,הצפון,4201,מג'דל שמס,461,168,293,13,448,405,451,3,10%
2012-09,הצפון,517,מזרעה,177,66,111,6,171,150,176,4,10%
2012-09,הצפון,4203,מסעדה,176,59,117,6,170,146,175,0,11%
2012-09,הצפון,518,מעיליא,43,23,20,3,40,16,43,5,3%
2012-09,הצפון,1063,מעלות-תרשיחא,894,409,485,127,767,526,892,35,8%
2012-09,הצפון,520,משהד,306,111,195,7,299,258,301,4,10%
2012-09,הצפון,9100,נהרייה,1990,878,1112,253,1737,1212,1980,53,7%
2012-09,הצפון,522,נחף,405,179,226,8,397,327,404,6,9%
2012-09,הצפון,7300,נצרת,3001,1242,1759,105,2896,2373,2986,40,10%
2012-09,הצפון,1061,נצרת עילית,1870,768,1102,261,1609,1068,1778,73,8%
2012-09,הצפון,525,סאג'ור,113,41,72,2,111,80,113,2,7%
2012-09,הצפון,7500,סח'נין,2032,877,1155,38,1994,1753,2031,28,16%
2012-09,הצפון,4501,ע'ג'ר,64,24,40,0,64,53,63,2,7%
2012-09,הצפון,530,עיילבון,196,72,124,4,192,138,196,2,8%
2012-09,הצפון,511,עילוט,300,121,179,3,297,250,299,4,12%
2012-09,הצפון,532,עין מאהל,579,248,331,4,575,511,572,2,13%
2012-09,הצפון,7600,עכו,3201,1436,1765,165,3036,2497,3165,77,12%
2012-09,הצפון,7700,עפולה,1591,642,949,183,1408,813,1552,73,7%
2012-09,הצפון,531,עראבה,1389,571,818,25,1364,1242,1388,14,15%
2012-09,הצפון,535,פסוטה,122,55,67,6,116,80,122,0,8%
2012-09,הצפון,536,פקיעין (בוקייעה),122,65,57,9,113,72,121,3,5%
2012-09,הצפון,8000,צפת,1247,639,608,82,1165,973,1235,14,10%
2012-09,הצפון,4100,קצרין,187,79,108,36,151,84,187,6,5%
2012-09,הצפון,2800,קריית שמונה,658,285,373,65,593,251,643,49,5%
2012-09,הצפון,543,ראמה,288,102,186,9,279,238,285,1,8%
2012-09,הצפון,26,ראש פינה,43,14,29,7,36,18,43,0,3%
2012-09,הצפון,542,ריינה,626,244,382,19,607,518,622,10,10%
2012-09,הצפון,122,רמת ישי,104,36,68,33,71,15,104,1,3%
2012-09,הצפון,913,שבלי - אום אל-גנם,222,93,129,8,214,161,221,5,9%
2012-09,הצפון,812,שלומי,250,102,148,20,230,140,249,5,7%
2012-09,הצפון,538,שעב,485,194,291,7,478,439,485,4,17%
2012-09,הצפון,8800,שפרעם,1979,741,1238,37,1942,1676,1972,48,12%
2012-09,חיפה,2710,אום אל-פחם,3741,1517,2224,15,3726,3226,3738,18,20%
2012-09,חיפה,1020,אור עקיבא,539,242,297,47,492,215,534,16,6%
2012-09,חיפה,6000,באקה אל-גרביה,655,293,362,19,636,445,653,17,6%
2012-09,חיפה,9800,בנימינה-גבעת עדה*,191,71,120,54,137,53,190,0,3%
2012-09,חיפה,1326,"בסמ""ה",421,186,235,3,418,338,421,1,12%
2012-09,חיפה,541,ג'סר א-זרקא,431,223,208,1,430,273,428,2,8%
2012-09,חיפה,628,ג'ת,195,83,112,12,183,119,194,6,4%
2012-09,חיפה,494,דאלית אל-כרמל,509,195,314,12,497,298,505,3,7%
2012-09,חיפה,9300,זכרון יעקב,246,109,137,93,153,45,243,4,2%
2012-09,חיפה,6500,חדרה,2393,934,1459,317,2076,984,2366,36,5%
2012-09,חיפה,4000,חיפה,6613,3052,3561,1208,5405,3987,6586,218,5%
2012-09,חיפה,1247,חריש,32,13,19,4,28,5,31,1,2%
2012-09,חיפה,2100,טירת כרמל,721,319,402,35,686,460,716,38,7%
2012-09,חיפה,654,כפר קרע,350,147,203,5,345,235,348,4,5%
2012-09,חיפה,1327,מעלה עירון,953,364,589,1,952,793,953,1,18%
2012-09,חיפה,2500,נשר,492,211,281,89,403,235,490,19,4%
2012-09,חיפה,534,עספיא,297,123,174,8,289,179,296,3,6%
2012-09,חיפה,637,ערערה,569,226,343,6,563,395,568,20,8%
2012-09,חיפה,537,פוריידיס,378,168,210,7,371,264,375,2,7%
2012-09,חיפה,7800,פרדס חנה-כרכור,822,343,479,147,675,283,821,34,5%
2012-09,חיפה,6800,קריית אתא,1633,698,935,154,1479,995,1626,39,6%
2012-09,חיפה,9500,קריית ביאליק,1158,456,702,129,1029,644,1153,24,6%
2012-09,חיפה,2300,קריית טבעון,172,87,85,56,116,53,170,3,2%
2012-09,חיפה,9600,קריית ים,1539,710,829,172,1367,998,1535,41,7%
2012-09,חיפה,8200,קריית מוצקין,1053,434,619,165,888,548,1047,26,5%
2012-09,חיפה,922,רכסים,136,62,74,8,128,80,136,2,4%
2012-09,ירושלים,472,אבו גוש,246,119,127,5,241,187,246,11,9%
2012-09,ירושלים,2610,בית שמש,1222,515,707,117,1105,585,1216,134,4%
2012-09,ירושלים,3000,ירושלים,10466,4595,5871,1226,9240,6414,10413,640,4%
2012-09,ירושלים,1015,מבשרת ציון,374,165,209,69,305,169,372,20,3%
2012-09,ירושלים,1137,קריית יערים,43,16,27,5,38,20,42,6,4%
2012-09,תל אביב,2400,אור יהודה,797,325,472,40,757,290,785,46,4%
2012-09,תל אביב,565,אזור,164,83,81,25,139,31,164,10,3%
2012-09,תל אביב,6100,בני ברק,2441,1145,1296,122,2319,1338,2429,68,5%
2012-09,תל אביב,6200,בת ים,3131,1453,1678,471,2660,1337,3076,170,4%
2012-09,תל אביב,6300,גבעתיים,724,309,415,310,414,97,718,30,3%
2012-09,תל אביב,6400,הרצלייה,969,412,557,305,664,60,962,135,2%
2012-09,תל אביב,6600,חולון,2943,1353,1590,497,2446,905,2899,157,3%
2012-09,תל אביב,2620,קריית אונו,382,170,212,142,240,45,378,9,2%
2012-09,תל אביב,8600,רמת גן,2002,907,1095,641,1361,458,1987,109,3%
2012-09,תל אביב,2650,רמת השרון,391,172,219,181,210,8,385,37,2%
2012-09,תל אביב,5000,תל אביב -יפו,7774,3816,3958,2493,5281,2583,7731,268,3%
2012-10,אזור יהודה והשומרון,3760,אורנית,102,47,55,38,64,3,102,3,2%
2012-10,אזור יהודה והשומרון,3750,אלפי מנשה,102,50,52,33,69,2,102,2,2%
2012-10,אזור יהודה והשומרון,3560,אלקנה,29,16,13,15,14,1,28,0,2%
2012-10,אזור יהודה והשומרון,3650,אפרת,51,27,24,27,24,7,51,1,1%
2012-10,אזור יהודה והשומרון,3570,אריאל,446,225,221,107,339,97,445,13,4%
2012-10,אזור יהודה והשומרון,3574,בית אל,59,28,31,15,44,22,59,2,3%
2012-10,אזור יהודה והשומרון,3652,בית אריה,50,20,30,4,46,4,50,0,2%
2012-10,אזור יהודה והשומרון,3780,ביתר עילית,453,216,237,15,438,213,451,1,4%
2012-10,אזור יהודה והשומרון,3730,גבעת זאב,169,82,87,24,145,38,169,9,3%
2012-10,אזור יהודה והשומרון,3769,הר אדר,30,12,18,15,15,3,30,1,2%
2012-10,אזור יהודה והשומרון,3797,מודיעין עילית,378,141,237,24,354,121,376,12,3%
2012-10,אזור יהודה והשומרון,3616,מעלה אדומים,630,245,385,94,536,195,625,34,3%
2012-10,אזור יהודה והשומרון,3660,עמנואל,81,38,43,5,76,61,81,1,8%
2012-10,אזור יהודה והשומרון,3557,קדומים,34,15,19,9,25,7,33,0,2%
2012-10,אזור יהודה והשומרון,3611,קריית ארבע,109,50,59,23,86,56,109,1,4%
2012-10,אזור יהודה והשומרון,3640,קרני שומרון,91,45,46,29,62,15,91,2,3%
2012-10,הדרום,31,אופקים,1469,610,859,105,1364,984,1458,26,12%
2012-10,הדרום,2600,אילת,1300,580,720,64,1236,588,1285,35,4%
2012-10,הדרום,70,אשדוד,7137,2828,4309,842,6295,3800,7085,239,7%
2012-10,הדרום,7100,אשקלון,4504,1778,2726,700,3804,2599,4406,74,7%
2012-10,הדרום,9000,באר שבע,7368,3240,4128,1018,6350,4612,7320,265,7%
2012-10,הדרום,2200,דימונה,2159,876,1283,142,2017,1501,2135,45,12%
2012-10,הדרום,1303,חורה,734,306,428,0,734,683,734,5,21%
2012-10,הדרום,831,ירוחם,459,216,243,21,438,284,455,29,11%
2012-10,הדרום,1059,כסיפה,957,404,553,5,952,870,956,4,23%
2012-10,הדרום,1271,להבים,55,31,24,21,34,4,55,10,2%
2012-10,הדרום,1060,לקיה,935,410,525,4,931,881,934,7,26%
2012-10,הדרום,1268,מיתר,60,27,33,26,34,6,60,6,2%
2012-10,הדרום,99,מצפה רמון,261,106,155,18,243,137,246,16,10%
2012-10,הדרום,246,נתיבות,1099,470,629,61,1038,567,1094,40,9%
2012-10,הדרום,666,עומר,57,18,39,26,31,4,57,5,2%
2012-10,הדרום,2560,ערד,842,365,477,157,685,473,823,55,7%
2012-10,הדרום,1192,ערערה-בנגב,938,404,534,4,934,877,937,4,25%
2012-10,הדרום,2630,קריית גת,2431,1013,1418,201,2230,1545,2426,44,9%
2012-10,הדרום,1034,קריית מלאכי,1299,582,717,40,1259,814,1274,113,11%
2012-10,הדרום,1161,רהט,3056,1275,1781,10,3046,2739,3055,26,18%
2012-10,הדרום,1286,שגב-שלום,493,175,318,0,493,454,492,2,20%
2012-10,הדרום,1031,שדרות,1170,465,705,66,1104,708,1164,28,10%
2012-10,הדרום,1054,תל שבע,1129,509,620,2,1127,1073,1128,6,26%
2012-10,המרכז,182,אבן יהודה,164,67,97,57,107,26,163,2,3%
2012-10,המרכז,41,אליכין,63,26,37,7,56,20,63,0,4%
2012-10,המרכז,1309,אלעד,438,181,257,21,417,113,434,13,4%
2012-10,המרכז,2530,באר יעקב,248,106,142,50,198,67,243,8,3%
2012-10,המרכז,466,בית דגן,116,53,63,24,92,38,115,5,3%
2012-10,המרכז,1066,"בני עי""ש",231,108,123,30,201,75,229,4,6%
2012-10,המרכז,681,גבעת שמואל,306,158,148,125,181,58,303,9,3%
2012-10,המרכז,2550,גדרה,377,168,209,73,304,106,369,5,3%
2012-10,המרכז,627,ג'לג'וליה,87,38,49,2,85,52,86,2,3%
2012-10,המרכז,166,גן יבנה,369,140,229,47,322,94,367,19,4%
2012-10,המרכז,229,גני תקווה,181,86,95,58,123,27,180,6,2%
2012-10,המרכז,9700,הוד השרון,687,326,361,270,417,68,681,4,3%
2012-10,המרכז,1290,זמר,152,43,109,7,145,119,152,1,6%
2012-10,המרכז,2730,טייבה,2124,888,1236,9,2115,1838,2117,4,13%
2012-10,המרכז,2720,טירה,344,177,167,7,337,176,342,11,3%
2012-10,המרכז,2660,יבנה,889,418,471,78,811,370,887,55,4%
2012-10,המרכז,9400,יהוד,538,216,322,91,447,72,525,12,3%
2012-10,המרכז,1224,כוכב יאיר,79,31,48,36,43,3,79,1,1%
2012-10,המרכז,633,כפר ברא,21,11,10,0,21,11,21,0,2%
2012-10,המרכז,168,כפר יונה,334,146,188,71,263,61,333,3,3%
2012-10,המרכז,6900,כפר סבא,1247,538,709,390,857,190,1237,20,3%
2012-10,המרכז,634,כפר קאסם,218,98,120,0,218,131,218,4,3%
2012-10,המרכז,7000,לוד,2207,971,1236,171,2036,1253,2191,77,6%
2012-10,המרכז,1200,מודיעין-מכבים-רעות*,933,385,548,347,586,64,924,44,2%
2012-10,המרכז,28,מזכרת בתיה,176,67,109,34,142,43,174,1,3%
2012-10,המרכז,7200,נס ציונה,693,295,398,160,533,196,687,5,3%
2012-10,המרכז,7400,נתניה,4413,2001,2412,664,3749,1633,4390,78,4%
2012-10,המרכז,587,סביון*,18,6,12,13,5,0,18,0,1%
2012-10,המרכז,171,פרדסייה,84,32,52,21,63,6,84,0,2%
2012-10,המרכז,7900,פתח תקווה,4225,1876,2349,864,3361,1107,4201,221,4%
2012-10,המרכז,195,קדימה-צורן,248,94,154,75,173,37,248,0,3%
2012-10,המרכז,638,קלנסווה,869,317,552,4,865,760,866,0,11%
2012-10,המרכז,469,קריית עקרון,304,146,158,21,283,129,303,1,5%
2012-10,המרכז,2640,ראש העין,770,366,404,104,666,156,765,31,4%
2012-10,המרכז,8300,ראשון לציון,4649,2035,2614,1026,3623,1544,4637,200,4%
2012-10,המרכז,8400,רחובות,2674,1146,1528,540,2134,1062,2616,13,4%
2012-10,המרכז,8500,רמלה,1794,864,930,115,1679,810,1755,81,5%
2012-10,המרכז,8700,רעננה,840,401,439,346,494,90,839,6,2%
2012-10,המרכז,1304,שוהם,207,89,118,88,119,6,207,8,2%
2012-10,המרכז,154,תל מונד,120,59,61,44,76,24,120,0,2%
2012-10,הצפון,473,אבו סנאן,737,298,439,3,734,630,733,10,14%
2012-10,הצפון,478,אכסאל,515,212,303,8,507,449,515,4,10%
2012-10,הצפון,529,אעבלין,613,236,377,7,606,517,613,4,12%
2012-10,הצפון,482,בועיינה-נוג'ידאת,404,168,236,3,401,363,396,24,12%
2012-10,הצפון,4001,בוקעאתא,384,136,248,7,377,340,375,3,15%
2012-10,הצפון,998,ביר אל-מכסור,386,135,251,1,385,330,386,2,12%
2012-10,הצפון,480,בית ג'ן,331,105,226,9,322,238,329,6,7%
2012-10,הצפון,9200,בית שאן,886,387,499,19,867,465,885,62,9%
2012-10,הצפון,944,בסמת טבעון,202,78,124,0,202,173,201,3,7%
2012-10,הצפון,483,בענה,398,151,247,2,396,346,398,5,13%
2012-10,הצפון,1292,ג'דיידה-מכר,1472,599,873,6,1466,1296,1469,21,18%
2012-10,הצפון,485,ג'ולס,239,59,180,2,237,154,239,6,9%
2012-10,הצפון,487,ג'ש (גוש חלב),48,17,31,2,46,25,47,0,3%
2012-10,הצפון,489,דבורייה,372,152,220,21,351,300,372,0,10%
2012-10,הצפון,490,דייר אל-אסד,404,171,233,9,395,325,404,5,9%
2012-10,הצפון,492,דייר חנא,611,247,364,8,603,499,611,6,14%
2012-10,הצפון,975,זרזיר,307,137,170,3,304,216,305,4,11%
2012-10,הצפון,496,חורפיש,119,41,78,8,111,77,119,4,5%
2012-10,הצפון,2034,חצור הגלילית,297,130,167,17,280,143,292,2,6%
2012-10,הצפון,6700,טבריה,1945,823,1122,125,1820,1203,1794,80,9%
2012-10,הצפון,962,טובא-זנגרייה,369,170,199,7,362,273,365,2,13%
2012-10,הצפון,498,טורעאן,567,217,350,10,557,484,563,25,11%
2012-10,הצפון,8900,טמרה,1972,771,1201,15,1957,1738,1967,26,15%
2012-10,הצפון,1295,יאנוח-ג'ת,155,49,106,2,153,115,155,6,6%
2012-10,הצפון,46,יבנאל,142,93,49,8,134,99,129,0,9%
2012-10,הצפון,499,יפיע,636,265,371,7,629,504,633,8,9%
2012-10,הצפון,240,יקנעם עילית,537,224,313,90,447,184,536,21,5%
2012-10,הצפון,502,ירכא,522,189,333,0,522,438,522,11,10%
2012-10,הצפון,504,כאבול,671,256,415,6,665,598,669,3,15%
2012-10,הצפון,505,כאוכב אבו אל-היג'א,214,92,122,4,210,179,214,2,14%
2012-10,הצפון,1296,כסרא-סמיע,234,90,144,2,232,180,234,6,8%
2012-10,הצפון,978,כעביה-טבאש-חג'אג'רה,183,71,112,3,180,144,182,1,9%
2012-10,הצפון,1263,כפר ורדים,73,28,45,31,42,11,73,1,2%
2012-10,הצפון,507,כפר יאסיף,515,209,306,7,508,416,515,10,11%
2012-10,הצפון,508,כפר כמא,63,24,39,1,62,33,62,0,4%
2012-10,הצפון,509,כפר כנא,1194,463,731,29,1165,1065,1178,40,15%
2012-10,הצפון,510,כפר מנדא,910,392,518,10,900,734,903,13,14%
2012-10,הצפון,47,כפר תבור,47,16,31,17,30,7,46,1,2%
2012-10,הצפון,1139,כרמיאל,1748,691,1057,368,1380,890,1697,37,7%
2012-10,הצפון,481,מגאר,1426,555,871,19,1407,1278,1423,15,17%
2012-10,הצפון,516,מג'ד אל-כרום,528,225,303,8,520,431,528,2,9%
2012-10,הצפון,874,מגדל העמק,1076,417,659,85,991,511,1043,58,8%
2012-10,הצפון,4201,מג'דל שמס,452,165,287,12,440,394,446,3,10%
2012-10,הצפון,517,מזרעה,164,58,106,6,158,139,163,2,9%
2012-10,הצפון,4203,מסעדה,174,59,115,6,168,149,173,0,11%
2012-10,הצפון,518,מעיליא,38,21,17,1,37,16,38,1,3%
2012-10,הצפון,1063,מעלות-תרשיחא,903,414,489,128,775,534,896,32,8%
2012-10,הצפון,520,משהד,304,117,187,8,296,264,303,3,10%
2012-10,הצפון,9100,נהרייה,2097,919,1178,261,1836,1268,2084,67,7%
2012-10,הצפון,522,נחף,395,176,219,5,390,327,395,11,9%
2012-10,הצפון,7300,נצרת,2948,1217,1731,96,2852,2369,2938,34,10%
2012-10,הצפון,1061,נצרת עילית,1991,858,1133,262,1729,1085,1893,85,8%
2012-10,הצפון,525,סאג'ור,107,38,69,1,106,73,107,0,6%
2012-10,הצפון,7500,סח'נין,1991,850,1141,28,1963,1732,1991,17,16%
2012-10,הצפון,4501,ע'ג'ר,75,32,43,0,75,55,75,2,8%
2012-10,הצפון,530,עיילבון,193,72,121,2,191,137,193,2,8%
2012-10,הצפון,511,עילוט,299,116,183,2,297,249,299,3,12%
2012-10,הצפון,532,עין מאהל,588,254,334,9,579,520,582,3,13%
2012-10,הצפון,7600,עכו,3232,1474,1758,157,3075,2495,3205,83,13%
2012-10,הצפון,7700,עפולה,1767,700,1067,206,1561,859,1722,66,7%
2012-10,הצפון,531,עראבה,1363,555,808,28,1335,1236,1362,13,15%
2012-10,הצפון,535,פסוטה,110,47,63,3,107,80,110,8,7%
2012-10,הצפון,536,פקיעין (בוקייעה),124,62,62,5,119,83,122,2,5%
2012-10,הצפון,8000,צפת,1313,672,641,89,1224,991,1300,14,10%
2012-10,הצפון,4100,קצרין,194,86,108,38,156,79,193,5,5%
2012-10,הצפון,2800,קריית שמונה,683,293,390,62,621,273,652,64,5%
2012-10,הצפון,543,ראמה,295,110,185,10,285,237,295,0,8%
2012-10,הצפון,26,ראש פינה,47,17,30,8,39,17,47,0,3%
2012-10,הצפון,542,ריינה,661,271,390,14,647,548,657,9,11%
2012-10,הצפון,122,רמת ישי,97,31,66,36,61,14,97,1,2%
2012-10,הצפון,913,שבלי - אום אל-גנם,217,95,122,8,209,160,216,0,9%
2012-10,הצפון,812,שלומי,263,109,154,20,243,147,262,8,8%
2012-10,הצפון,538,שעב,484,195,289,4,480,440,484,2,17%
2012-10,הצפון,8800,שפרעם,1987,750,1237,30,1957,1687,1981,34,12%
2012-10,חיפה,2710,אום אל-פחם,3683,1484,2199,12,3671,3215,3679,9,20%
2012-10,חיפה,1020,אור עקיבא,614,268,346,50,564,226,600,15,6%
2012-10,חיפה,6000,באקה אל-גרביה,659,299,360,16,643,451,658,16,6%
2012-10,חיפה,9800,בנימינה-גבעת עדה*,212,79,133,65,147,53,211,3,3%
2012-10,חיפה,1326,"בסמ""ה",413,182,231,2,411,334,413,4,12%
2012-10,חיפה,541,ג'סר א-זרקא,426,225,201,1,425,279,424,0,8%
2012-10,חיפה,628,ג'ת,199,87,112,11,188,119,198,3,4%
2012-10,חיפה,494,דאלית אל-כרמל,490,190,300,9,481,293,486,9,7%
2012-10,חיפה,9300,זכרון יעקב,248,103,145,88,160,46,244,0,3%
2012-10,חיפה,6500,חדרה,2454,977,1477,328,2126,1002,2418,42,5%
2012-10,חיפה,4000,חיפה,6797,3182,3615,1194,5603,4002,6776,171,5%
2012-10,חיפה,1247,חריש,33,12,21,6,27,4,33,1,2%
2012-10,חיפה,2100,טירת כרמל,741,343,398,33,708,459,736,35,7%
2012-10,חיפה,654,כפר קרע,354,146,208,3,351,233,353,12,5%
2012-10,חיפה,1327,מעלה עירון,938,359,579,1,937,788,938,1,18%
2012-10,חיפה,2500,נשר,494,206,288,89,405,241,493,17,4%
2012-10,חיפה,534,עספיא,286,113,173,8,278,173,285,5,6%
2012-10,חיפה,637,ערערה,563,229,334,4,559,393,563,13,8%
2012-10,חיפה,537,פוריידיס,370,168,202,6,364,254,369,1,7%
2012-10,חיפה,7800,פרדס חנה-כרכור,862,377,485,144,718,290,856,29,5%
2012-10,חיפה,6800,קריית אתא,1682,721,961,173,1509,996,1676,46,6%
2012-10,חיפה,9500,קריית ביאליק,1193,482,711,132,1061,639,1184,23,6%
2012-10,חיפה,2300,קריית טבעון,182,92,90,56,126,52,180,6,2%
2012-10,חיפה,9600,קריית ים,1550,729,821,162,1388,983,1549,51,7%
2012-10,חיפה,8200,קריית מוצקין,1076,438,638,170,906,548,1072,31,5%
2012-10,חיפה,922,רכסים,141,66,75,6,135,81,141,3,5%
2012-10,ירושלים,472,אבו גוש,255,129,126,6,249,190,255,6,9%
2012-10,ירושלים,2610,בית שמש,1262,543,719,112,1150,585,1256,43,4%
2012-10,ירושלים,3000,ירושלים,10719,4698,6021,1264,9455,6534,10641,313,4%
2012-10,ירושלים,1015,מבשרת ציון,399,183,216,68,331,187,398,6,3%
2012-10,ירושלים,1137,קריית יערים,49,16,33,4,45,17,49,0,4%
2012-10,תל אביב,2400,אור יהודה,867,366,501,43,824,288,853,43,5%
2012-10,תל אביב,565,אזור,165,79,86,22,143,33,165,5,3%
2012-10,תל אביב,6100,בני ברק,2446,1176,1270,121,2325,1344,2434,61,5%
2012-10,תל אביב,6200,בת ים,3352,1565,1787,485,2867,1348,3288,171,5%
2012-10,תל אביב,6300,גבעתיים,781,339,442,325,456,104,773,24,3%
2012-10,תל אביב,6400,הרצלייה,1033,463,570,324,709,53,1022,105,2%
2012-10,תל אביב,6600,חולון,3186,1464,1722,505,2681,906,3145,91,3%
2012-10,תל אביב,2620,קריית אונו,400,176,224,136,264,49,394,4,2%
2012-10,תל אביב,8600,רמת גן,2067,928,1139,647,1420,439,2048,91,3%
2012-10,תל אביב,2650,רמת השרון,405,177,228,178,227,8,399,27,2%
2012-10,תל אביב,5000,תל אביב -יפו,8007,3927,4080,2519,5488,2634,7965,274,3%
2012-11,אזור יהודה והשומרון,3760,אורנית,102,48,54,37,65,3,102,3,2%
2012-11,אזור יהודה והשומרון,3750,אלפי מנשה,104,50,54,35,69,2,104,1,3%
2012-11,אזור יהודה והשומרון,3560,אלקנה,29,13,16,16,13,1,28,0,2%
2012-11,אזור יהודה והשומרון,3650,אפרת,50,25,25,25,25,8,50,2,1%
2012-11,אזור יהודה והשומרון,3570,אריאל,411,207,204,92,319,103,410,11,4%
2012-11,אזור יהודה והשומרון,3574,בית אל,58,27,31,14,44,22,57,4,2%
2012-11,אזור יהודה והשומרון,3652,בית אריה,61,24,37,5,56,4,60,0,3%
2012-11,אזור יהודה והשומרון,3780,ביתר עילית,452,219,233,14,438,205,449,18,4%
2012-11,אזור יהודה והשומרון,3730,גבעת זאב,159,78,81,20,139,37,159,6,2%
2012-11,אזור יהודה והשומרון,3769,הר אדר,29,14,15,14,15,4,29,1,2%
2012-11,אזור יהודה והשומרון,3797,מודיעין עילית,373,141,232,24,349,124,371,13,3%
2012-11,אזור יהודה והשומרון,3616,מעלה אדומים,625,250,375,100,525,202,617,43,3%
2012-11,אזור יהודה והשומרון,3660,עמנואל,79,40,39,4,75,56,79,0,8%
2012-11,אזור יהודה והשומרון,3557,קדומים,39,15,24,12,27,7,38,1,2%
2012-11,אזור יהודה והשומרון,3611,קריית ארבע,108,51,57,27,81,58,108,6,4%
2012-11,אזור יהודה והשומרון,3640,קרני שומרון,93,47,46,27,66,16,92,2,3%
2012-11,הדרום,31,אופקים,1385,570,815,100,1285,974,1380,9,11%
2012-11,הדרום,2600,אילת,1354,604,750,64,1290,605,1339,57,4%
2012-11,הדרום,70,אשדוד,6943,2813,4130,803,6140,3789,6891,160,7%
2012-11,הדרום,7100,אשקלון,4338,1747,2591,662,3676,2594,4245,103,7%
2012-11,הדרום,9000,באר שבע,7230,3140,4090,981,6249,4594,7186,155,7%
2012-11,הדרום,2200,דימונה,2148,897,1251,130,2018,1513,2126,46,12%
2012-11,הדרום,1303,חורה,748,317,431,1,747,696,748,2,21%
2012-11,הדרום,831,ירוחם,467,221,246,20,447,283,461,31,11%
2012-11,הדרום,1059,כסיפה,968,414,554,5,963,884,967,16,23%
2012-11,הדרום,1271,להבים,45,21,24,22,23,5,45,2,1%
2012-11,הדרום,1060,לקיה,969,433,536,3,966,909,967,9,27%
2012-11,הדרום,1268,מיתר,51,26,25,21,30,6,51,2,1%
2012-11,הדרום,99,מצפה רמון,242,93,149,13,229,144,230,9,10%
2012-11,הדרום,246,נתיבות,1060,461,599,55,1005,560,1050,38,8%
2012-11,הדרום,666,עומר,52,16,36,25,27,4,52,3,1%
2012-11,הדרום,2560,ערד,831,369,462,150,681,458,809,60,7%
2012-11,הדרום,1192,ערערה-בנגב,975,417,558,4,971,900,974,4,26%
2012-11,הדרום,2630,קריית גת,2410,1003,1407,187,2223,1541,2406,28,9%
2012-11,הדרום,1034,קריית מלאכי,1211,538,673,41,1170,815,1196,43,11%
2012-11,הדרום,1161,רהט,3117,1303,1814,9,3108,2762,3116,29,19%
2012-11,הדרום,1286,שגב-שלום,498,180,318,0,498,458,497,4,20%
2012-11,הדרום,1031,שדרות,1145,470,675,65,1080,708,1139,18,9%
2012-11,הדרום,1054,תל שבע,1146,528,618,2,1144,1077,1145,2,26%
2012-11,המרכז,182,אבן יהודה,157,67,90,55,102,26,156,2,2%
2012-11,המרכז,41,אליכין,55,24,31,4,51,19,55,1,3%
2012-11,המרכז,1309,אלעד,425,184,241,20,405,109,424,19,4%
2012-11,המרכז,2530,באר יעקב,236,98,138,44,192,72,230,13,3%
2012-11,המרכז,466,בית דגן,115,56,59,19,96,42,115,2,3%
2012-11,המרכז,1066,"בני עי""ש",201,88,113,26,175,72,201,0,5%
2012-11,המרכז,681,גבעת שמואל,297,151,146,118,179,56,294,6,3%
2012-11,המרכז,2550,גדרה,382,167,215,74,308,107,376,1,4%
2012-11,המרכז,627,ג'לג'וליה,89,35,54,5,84,55,88,0,3%
2012-11,המרכז,166,גן יבנה,360,141,219,47,313,91,358,7,3%
2012-11,המרכז,229,גני תקווה,186,88,98,59,127,27,184,8,2%
2012-11,המרכז,9700,הוד השרון,692,323,369,247,445,83,689,12,3%
2012-11,המרכז,1290,זמר,162,47,115,6,156,119,162,1,6%
2012-11,המרכז,2730,טייבה,2188,921,1267,13,2175,1880,2182,9,14%
2012-11,המרכז,2720,טירה,348,179,169,6,342,180,348,11,3%
2012-11,המרכז,2660,יבנה,876,409,467,87,789,378,872,51,4%
2012-11,המרכז,9400,יהוד,561,238,323,95,466,79,545,14,4%
2012-11,המרכז,1224,כוכב יאיר,88,38,50,45,43,2,88,0,2%
2012-11,המרכז,633,כפר ברא,29,16,13,0,29,16,29,0,2%
2012-11,המרכז,168,כפר יונה,333,148,185,66,267,65,332,8,3%
2012-11,המרכז,6900,כפר סבא,1265,556,709,397,868,202,1258,25,3%
2012-11,המרכז,634,כפר קאסם,251,127,124,1,250,139,251,8,3%
2012-11,המרכז,7000,לוד,2273,1009,1264,167,2106,1265,2254,123,7%
2012-11,המרכז,1200,מודיעין-מכבים-רעות*,946,403,543,363,583,70,940,48,2%
2012-11,המרכז,28,מזכרת בתיה,181,76,105,35,146,34,179,0,3%
2012-11,המרכז,7200,נס ציונה,679,295,384,147,532,205,672,1,3%
2012-11,המרכז,7400,נתניה,4416,2026,2390,680,3736,1616,4374,95,4%
2012-11,המרכז,587,סביון*,13,3,10,12,1,0,13,0,1%
2012-11,המרכז,171,פרדסייה,72,30,42,21,51,5,72,0,2%
2012-11,המרכז,7900,פתח תקווה,4271,1903,2368,880,3391,1131,4236,230,4%
2012-11,המרכז,195,קדימה-צורן,245,99,146,82,163,35,244,2,3%
2012-11,המרכז,638,קלנסווה,895,336,559,4,891,776,891,2,11%
2012-11,המרכז,469,קריית עקרון,323,148,175,19,304,133,320,3,6%
2012-11,המרכז,2640,ראש העין,759,372,387,99,660,157,749,26,4%
2012-11,המרכז,8300,ראשון לציון,4672,2057,2615,1034,3638,1557,4666,206,4%
2012-11,המרכז,8400,רחובות,2619,1122,1497,529,2090,1070,2564,13,4%
2012-11,המרכז,8500,רמלה,1862,883,979,116,1746,829,1826,65,5%
2012-11,המרכז,8700,רעננה,816,389,427,324,492,91,813,11,2%
2012-11,המרכז,1304,שוהם,205,86,119,80,125,6,205,15,2%
2012-11,המרכז,154,תל מונד,131,63,68,41,90,26,131,1,2%
2012-11,הצפון,473,אבו סנאן,760,310,450,4,756,648,756,15,14%
2012-11,הצפון,478,אכסאל,519,221,298,11,508,451,518,4,10%
2012-11,הצפון,529,אעבלין,629,250,379,8,621,530,629,9,12%
2012-11,הצפון,482,בועיינה-נוג'ידאת,385,159,226,3,382,345,381,12,11%
2012-11,הצפון,4001,בוקעאתא,402,145,257,6,396,353,393,5,15%
2012-11,הצפון,998,ביר אל-מכסור,400,139,261,1,399,342,400,3,12%
2012-11,הצפון,480,בית ג'ן,363,116,247,10,353,256,359,1,7%
2012-11,הצפון,9200,בית שאן,885,388,497,19,866,476,883,45,9%
2012-11,הצפון,944,בסמת טבעון,221,99,122,1,220,176,220,5,8%
2012-11,הצפון,483,בענה,416,169,247,2,414,348,416,8,14%
2012-11,הצפון,1292,ג'דיידה-מכר,1512,619,893,5,1507,1338,1511,17,18%
2012-11,הצפון,485,ג'ולס,259,70,189,2,257,167,259,13,10%
2012-11,הצפון,487,ג'ש (גוש חלב),52,20,32,1,51,26,51,1,3%
2012-11,הצפון,489,דבורייה,385,161,224,19,366,307,385,1,10%
2012-11,הצפון,490,דייר אל-אסד,416,173,243,7,409,334,416,5,9%
2012-11,הצפון,492,דייר חנא,639,274,365,8,631,512,639,9,15%
2012-11,הצפון,975,זרזיר,335,153,182,3,332,233,332,4,12%
2012-11,הצפון,496,חורפיש,121,37,84,7,114,71,121,1,5%
2012-11,הצפון,2034,חצור הגלילית,297,122,175,16,281,151,291,7,6%
2012-11,הצפון,6700,טבריה,1952,865,1087,120,1832,1203,1811,64,9%
2012-11,הצפון,962,טובא-זנגרייה,367,167,200,5,362,275,362,2,13%
2012-11,הצפון,498,טורעאן,577,222,355,11,566,479,573,32,11%
2012-11,הצפון,8900,טמרה,2023,793,1230,14,2009,1761,2018,19,16%
2012-11,הצפון,1295,יאנוח-ג'ת,143,51,92,3,140,106,143,3,6%
2012-11,הצפון,46,יבנאל,144,93,51,10,134,102,130,1,9%
2012-11,הצפון,499,יפיע,646,274,372,6,640,509,643,5,9%
2012-11,הצפון,240,יקנעם עילית,539,229,310,85,454,183,539,42,5%
2012-11,הצפון,502,ירכא,527,195,332,0,527,434,527,15,10%
2012-11,הצפון,504,כאבול,700,271,429,5,695,611,698,8,15%
2012-11,הצפון,505,כאוכב אבו אל-היג'א,227,102,125,4,223,189,227,9,14%
2012-11,הצפון,1296,כסרא-סמיע,210,91,119,3,207,157,208,5,7%
2012-11,הצפון,978,כעביה-טבאש-חג'אג'רה,205,82,123,2,203,148,205,1,10%
2012-11,הצפון,1263,כפר ורדים,67,24,43,28,39,12,67,0,2%
2012-11,הצפון,507,כפר יאסיף,529,217,312,7,522,429,529,9,11%
2012-11,הצפון,508,כפר כמא,69,30,39,2,67,34,67,1,4%
2012-11,הצפון,509,כפר כנא,1214,481,733,26,1188,1080,1207,34,15%
2012-11,הצפון,510,כפר מנדא,900,396,504,9,891,723,894,16,13%
2012-11,הצפון,47,כפר תבור,43,16,27,15,28,6,42,2,2%
2012-11,הצפון,1139,כרמיאל,1738,712,1026,347,1391,899,1683,43,7%
2012-11,הצפון,481,מגאר,1443,569,874,16,1427,1289,1439,20,17%
2012-11,הצפון,516,מג'ד אל-כרום,566,248,318,9,557,450,566,10,10%
2012-11,הצפון,874,מגדל העמק,1047,420,627,72,975,505,1019,52,8%
2012-11,הצפון,4201,מג'דל שמס,459,168,291,13,446,406,453,4,10%
2012-11,הצפון,517,מזרעה,172,63,109,4,168,137,171,4,9%
2012-11,הצפון,4203,מסעדה,179,62,117,7,172,148,178,0,11%
2012-11,הצפון,518,מעיליא,39,18,21,2,37,16,38,0,3%
2012-11,הצפון,1063,מעלות-תרשיחא,869,408,461,122,747,517,866,25,7%
2012-11,הצפון,520,משהד,320,124,196,7,313,267,318,6,11%
2012-11,הצפון,9100,נהרייה,2103,943,1160,254,1849,1275,2090,64,7%
2012-11,הצפון,522,נחף,404,178,226,6,398,327,404,6,9%
2012-11,הצפון,7300,נצרת,3050,1298,1752,103,2947,2403,3044,18,10%
2012-11,הצפון,1061,נצרת עילית,1918,833,1085,247,1671,1090,1826,102,8%
2012-11,הצפון,525,סאג'ור,115,43,72,1,114,77,113,0,7%
2012-11,הצפון,7500,סח'נין,2021,866,1155,31,1990,1743,2020,28,16%
2012-11,הצפון,4501,ע'ג'ר,84,37,47,2,82,60,83,3,9%
2012-11,הצפון,530,עיילבון,195,75,120,6,189,141,194,2,8%
2012-11,הצפון,511,עילוט,302,121,181,2,300,250,301,7,12%
2012-11,הצפון,532,עין מאהל,602,257,345,7,595,534,594,5,13%
2012-11,הצפון,7600,עכו,3259,1479,1780,155,3104,2540,3231,86,13%
2012-11,הצפון,7700,עפולה,1762,694,1068,209,1553,839,1715,89,7%
2012-11,הצפון,531,עראבה,1423,578,845,24,1399,1287,1422,24,16%
2012-11,הצפון,535,פסוטה,101,44,57,3,98,76,101,2,6%
2012-11,הצפון,536,פקיעין (בוקייעה),132,72,60,4,128,79,131,3,5%
2012-11,הצפון,8000,צפת,1337,707,630,97,1240,1019,1325,22,11%
2012-11,הצפון,4100,קצרין,199,85,114,38,161,80,197,7,5%
2012-11,הצפון,2800,קריית שמונה,689,307,382,57,632,276,661,72,5%
2012-11,הצפון,543,ראמה,304,119,185,9,295,239,304,0,9%
2012-11,הצפון,26,ראש פינה,46,17,29,6,40,17,46,0,3%
2012-11,הצפון,542,ריינה,671,273,398,12,659,551,669,19,11%
2012-11,הצפון,122,רמת ישי,98,36,62,37,61,11,98,0,3%
2012-11,הצפון,913,שבלי - אום אל-גנם,238,117,121,11,227,164,237,2,10%
2012-11,הצפון,812,שלומי,259,109,150,20,239,152,258,10,7%
2012-11,הצפון,538,שעב,504,212,292,5,499,454,504,9,18%
2012-11,הצפון,8800,שפרעם,1995,741,1254,29,1966,1685,1990,29,12%
2012-11,חיפה,2710,אום אל-פחם,3747,1541,2206,15,3732,3235,3743,13,20%
2012-11,חיפה,1020,אור עקיבא,623,277,346,49,574,228,617,25,6%
2012-11,חיפה,6000,באקה אל-גרביה,675,317,358,15,660,459,674,11,7%
2012-11,חיפה,9800,בנימינה-גבעת עדה*,220,82,138,67,153,59,219,4,3%
2012-11,חיפה,1326,"בסמ""ה",427,185,242,3,424,342,426,4,12%
2012-11,חיפה,541,ג'סר א-זרקא,424,235,189,2,422,283,421,2,8%
2012-11,חיפה,628,ג'ת,207,93,114,12,195,121,207,4,5%
2012-11,חיפה,494,דאלית אל-כרמל,521,205,316,10,511,296,516,4,7%
2012-11,חיפה,9300,זכרון יעקב,250,102,148,83,167,50,247,2,3%
2012-11,חיפה,6500,חדרה,2481,985,1496,332,2149,1013,2447,33,5%
2012-11,חיפה,4000,חיפה,6963,3258,3705,1184,5779,4076,6939,179,5%
2012-11,חיפה,1247,חריש,29,14,15,9,20,4,29,0,2%
2012-11,חיפה,2100,טירת כרמל,773,347,426,26,747,476,768,50,8%
2012-11,חיפה,654,כפר קרע,375,164,211,1,374,240,374,8,5%
2012-11,חיפה,1327,מעלה עירון,948,366,582,2,946,798,948,4,18%
2012-11,חיפה,2500,נשר,492,221,271,80,412,230,491,8,4%
2012-11,חיפה,534,עספיא,294,117,177,6,288,182,294,3,6%
2012-11,חיפה,637,ערערה,565,224,341,6,559,398,565,13,8%
2012-11,חיפה,537,פוריידיס,396,191,205,7,389,266,394,1,8%
2012-11,חיפה,7800,פרדס חנה-כרכור,879,376,503,142,737,290,871,27,5%
2012-11,חיפה,6800,קריית אתא,1766,774,992,173,1593,1016,1755,57,6%
2012-11,חיפה,9500,קריית ביאליק,1223,515,708,130,1093,643,1209,43,6%
2012-11,חיפה,2300,קריית טבעון,192,101,91,60,132,46,189,2,2%
2012-11,חיפה,9600,קריית ים,1578,733,845,165,1413,989,1572,49,8%
2012-11,חיפה,8200,קריית מוצקין,1113,464,649,165,948,554,1106,38,5%
2012-11,חיפה,922,רכסים,138,73,65,9,129,77,137,1,4%
2012-11,ירושלים,472,אבו גוש,264,133,131,5,259,197,264,4,10%
2012-11,ירושלים,2610,בית שמש,1303,585,718,111,1192,593,1296,64,5%
2012-11,ירושלים,3000,ירושלים,11063,4947,6116,1279,9784,6744,10993,347,4%
2012-11,ירושלים,1015,מבשרת ציון,409,179,230,73,336,191,409,12,3%
2012-11,ירושלים,1137,קריית יערים,42,12,30,4,38,17,42,1,4%
2012-11,תל אביב,2400,אור יהודה,894,401,493,34,860,292,878,34,5%
2012-11,תל אביב,565,אזור,185,92,93,27,158,38,185,8,3%
2012-11,תל אביב,6100,בני ברק,2380,1160,1220,111,2269,1313,2372,57,5%
2012-11,תל אביב,6200,בת ים,3422,1668,1754,485,2937,1342,3367,208,5%
2012-11,תל אביב,6300,גבעתיים,797,346,451,341,456,100,790,26,3%
2012-11,תל אביב,6400,הרצלייה,1076,471,605,329,747,51,1059,87,2%
2012-11,תל אביב,6600,חולון,3240,1529,1711,504,2736,916,3203,160,3%
2012-11,תל אביב,2620,קריית אונו,385,180,205,128,257,44,382,2,2%
2012-11,תל אביב,8600,רמת גן,2107,965,1142,657,1450,451,2091,71,3%
2012-11,תל אביב,2650,רמת השרון,413,180,233,178,235,15,410,38,2%
2012-11,תל אביב,5000,תל אביב -יפו,8335,4124,4211,2694,5641,2647,8271,302,3%
2012-12,אזור יהודה והשומרון,3760,אורנית,97,43,54,33,64,5,97,1,2%
2012-12,אזור יהודה והשומרון,3750,אלפי מנשה,121,55,66,39,82,3,119,1,3%
2012-12,אזור יהודה והשומרון,3560,אלקנה,33,16,17,15,18,2,32,0,2%
2012-12,אזור יהודה והשומרון,3650,אפרת,55,28,27,27,28,7,55,1,1%
2012-12,אזור יהודה והשומרון,3570,אריאל,394,183,211,81,313,103,394,7,4%
2012-12,אזור יהודה והשומרון,3574,בית אל,56,30,26,16,40,19,55,0,2%
2012-12,אזור יהודה והשומרון,3652,בית אריה,64,29,35,9,55,4,64,1,3%
2012-12,אזור יהודה והשומרון,3780,ביתר עילית,447,223,224,16,431,208,444,4,4%
2012-12,אזור יהודה והשומרון,3730,גבעת זאב,165,84,81,18,147,36,165,5,2%
2012-12,אזור יהודה והשומרון,3769,הר אדר,31,13,18,17,14,4,31,0,2%
2012-12,אזור יהודה והשומרון,3797,מודיעין עילית,383,141,242,22,361,117,377,7,3%
2012-12,אזור יהודה והשומרון,3616,מעלה אדומים,626,252,374,95,531,207,617,23,3%
2012-12,אזור יהודה והשומרון,3660,עמנואל,78,36,42,4,74,56,78,2,7%
2012-12,אזור יהודה והשומרון,3557,קדומים,38,16,22,12,26,9,37,0,2%
2012-12,אזור יהודה והשומרון,3611,קריית ארבע,107,52,55,24,83,59,107,3,4%
2012-12,אזור יהודה והשומרון,3640,קרני שומרון,87,44,43,24,63,18,87,2,3%
2012-12,הדרום,31,אופקים,1399,601,798,100,1299,990,1392,9,11%
2012-12,הדרום,2600,אילת,1418,646,772,65,1353,608,1395,31,4%
2012-12,הדרום,70,אשדוד,7053,2871,4182,804,6249,3812,6998,158,7%
2012-12,הדרום,7100,אשקלון,4438,1802,2636,673,3765,2638,4339,91,7%
2012-12,הדרום,9000,באר שבע,7442,3285,4157,981,6461,4637,7390,181,7%
2012-12,הדרום,2200,דימונה,2193,930,1263,136,2057,1504,2149,62,12%
2012-12,הדרום,1303,חורה,779,322,457,1,778,713,779,1,22%
2012-12,הדרום,831,ירוחם,468,227,241,20,448,283,462,20,11%
2012-12,הדרום,1059,כסיפה,977,423,554,2,975,886,975,2,24%
2012-12,הדרום,1271,להבים,43,21,22,21,22,4,43,0,1%
2012-12,הדרום,1060,לקיה,982,434,548,3,979,920,981,1,27%
2012-12,הדרום,1268,מיתר,59,28,31,19,40,6,58,4,1%
2012-12,הדרום,99,מצפה רמון,246,95,151,16,230,154,236,8,10%
2012-12,הדרום,246,נתיבות,1079,469,610,59,1020,569,1077,27,8%
2012-12,הדרום,666,עומר,57,21,36,26,31,6,57,2,2%
2012-12,הדרום,2560,ערד,782,364,418,149,633,440,761,58,6%
2012-12,הדרום,1192,ערערה-בנגב,990,401,589,2,988,907,989,0,26%
2012-12,הדרום,2630,קריית גת,2480,1020,1460,179,2301,1523,2475,34,9%
2012-12,הדרום,1034,קריית מלאכי,1276,571,705,37,1239,816,1257,84,11%
2012-12,הדרום,1161,רהט,3214,1370,1844,9,3205,2838,3213,26,19%
2012-12,הדרום,1286,שגב-שלום,512,195,317,0,512,463,511,2,21%
2012-12,הדרום,1031,שדרות,1190,498,692,62,1128,725,1184,25,10%
2012-12,הדרום,1054,תל שבע,1171,532,639,2,1169,1088,1170,2,27%
2012-12,המרכז,182,אבן יהודה,170,77,93,61,109,28,169,3,3%
2012-12,המרכז,41,אליכין,53,25,28,4,49,18,51,1,3%
2012-12,המרכז,1309,אלעד,433,189,244,19,414,112,431,4,4%
2012-12,המרכז,2530,באר יעקב,251,112,139,49,202,65,246,5,3%
2012-12,המרכז,466,בית דגן,112,58,54,19,93,37,112,0,3%
2012-12,המרכז,1066,"בני עי""ש",197,86,111,26,171,72,195,1,5%
2012-12,המרכז,681,גבעת שמואל,329,168,161,136,193,61,327,5,3%
2012-12,המרכז,2550,גדרה,368,159,209,68,300,111,361,4,3%
2012-12,המרכז,627,ג'לג'וליה,89,38,51,3,86,49,88,3,3%
2012-12,המרכז,166,גן יבנה,385,140,245,50,335,95,383,8,4%
2012-12,המרכז,229,גני תקווה,194,88,106,64,130,31,193,1,3%
2012-12,המרכז,9700,הוד השרון,670,339,331,222,448,68,665,11,3%
2012-12,המרכז,1290,זמר,175,55,120,8,167,127,175,4,6%
2012-12,המרכז,2730,טייבה,2214,927,1287,13,2201,1878,2209,10,14%
2012-12,המרכז,2720,טירה,376,196,180,9,367,185,376,8,4%
2012-12,המרכז,2660,יבנה,911,435,476,97,814,390,907,29,5%
2012-12,המרכז,9400,יהוד,570,240,330,91,479,67,557,27,4%
2012-12,המרכז,1224,כוכב יאיר,91,39,52,45,46,2,91,0,2%
2012-12,המרכז,633,כפר ברא,31,18,13,0,31,15,31,1,3%
2012-12,המרכז,168,כפר יונה,360,161,199,72,288,66,359,10,4%
2012-12,המרכז,6900,כפר סבא,1284,536,748,394,890,206,1279,31,3%
2012-12,המרכז,634,כפר קאסם,242,119,123,0,242,144,242,1,3%
2012-12,המרכז,7000,לוד,2273,1037,1236,168,2105,1239,2262,52,7%
2012-12,המרכז,1200,מודיעין-מכבים-רעות*,943,402,541,364,579,63,934,32,2%
2012-12,המרכז,28,מזכרת בתיה,175,76,99,32,143,39,173,2,3%
2012-12,המרכז,7200,נס ציונה,682,315,367,135,547,210,674,7,3%
2012-12,המרכז,7400,נתניה,4415,2063,2352,663,3752,1638,4379,88,4%
2012-12,המרכז,587,סביון*,13,4,9,10,3,0,13,0,1%
2012-12,המרכז,171,פרדסייה,72,31,41,18,54,6,72,0,2%
2012-12,המרכז,7900,פתח תקווה,4233,1918,2315,839,3394,1104,4199,69,4%
2012-12,המרכז,195,קדימה-צורן,250,106,144,83,167,35,250,1,3%
2012-12,המרכז,638,קלנסווה,912,351,561,4,908,786,908,1,12%
2012-12,המרכז,469,קריית עקרון,309,137,172,20,289,138,305,4,5%
2012-12,המרכז,2640,ראש העין,793,406,387,106,687,157,782,18,4%
2012-12,המרכז,8300,ראשון לציון,4707,2096,2611,1040,3667,1570,4699,52,4%
2012-12,המרכז,8400,רחובות,2569,1136,1433,509,2060,1072,2516,9,4%
2012-12,המרכז,8500,רמלה,1882,901,981,120,1762,848,1849,56,5%
2012-12,המרכז,8700,רעננה,777,370,407,290,487,85,776,13,2%
2012-12,המרכז,1304,שוהם,183,81,102,75,108,4,182,4,2%
2012-12,המרכז,154,תל מונד,141,70,71,39,102,26,140,2,2%
2012-12,הצפון,473,אבו סנאן,758,308,450,4,754,645,754,12,14%
2012-12,הצפון,478,אכסאל,533,227,306,11,522,463,533,3,11%
2012-12,הצפון,529,אעבלין,641,252,389,8,633,531,641,7,12%
2012-12,הצפון,482,בועיינה-נוג'ידאת,404,163,241,4,400,344,399,5,12%
2012-12,הצפון,4001,בוקעאתא,401,152,249,4,397,354,389,7,15%
2012-12,הצפון,998,ביר אל-מכסור,413,145,268,4,409,345,413,6,13%
2012-12,הצפון,480,בית ג'ן,347,114,233,5,342,258,342,2,7%
2012-12,הצפון,9200,בית שאן,847,372,475,19,828,468,845,70,9%
2012-12,הצפון,944,בסמת טבעון,214,96,118,1,213,173,213,2,8%
2012-12,הצפון,483,בענה,420,173,247,1,419,353,420,4,14%
2012-12,הצפון,1292,ג'דיידה-מכר,1538,644,894,5,1533,1352,1536,21,18%
2012-12,הצפון,485,ג'ולס,252,63,189,2,250,166,252,7,10%
2012-12,הצפון,487,ג'ש (גוש חלב),61,26,35,2,59,29,60,0,4%
2012-12,הצפון,489,דבורייה,399,171,228,14,385,311,398,4,10%
2012-12,הצפון,490,דייר אל-אסד,418,176,242,7,411,337,418,0,9%
2012-12,הצפון,492,דייר חנא,659,288,371,8,651,515,659,12,15%
2012-12,הצפון,975,זרזיר,345,162,183,2,343,236,339,13,12%
2012-12,הצפון,496,חורפיש,131,42,89,8,123,73,130,3,5%
2012-12,הצפון,2034,חצור הגלילית,294,126,168,19,275,140,290,8,6%
2012-12,הצפון,6700,טבריה,1980,877,1103,116,1864,1208,1830,74,9%
2012-12,הצפון,962,טובא-זנגרייה,374,170,204,4,370,265,368,2,13%
2012-12,הצפון,498,טורעאן,557,228,329,11,546,478,554,14,11%
2012-12,הצפון,8900,טמרה,2028,802,1226,12,2016,1775,2022,19,16%
2012-12,הצפון,1295,יאנוח-ג'ת,165,59,106,5,160,117,165,4,7%
2012-12,הצפון,46,יבנאל,149,98,51,7,142,109,134,2,9%
2012-12,הצפון,499,יפיע,663,293,370,6,657,515,660,4,9%
2012-12,הצפון,240,יקנעם עילית,505,215,290,75,430,176,504,26,5%
2012-12,הצפון,502,ירכא,533,201,332,0,533,440,533,13,10%
2012-12,הצפון,504,כאבול,693,267,426,5,688,603,691,7,15%
2012-12,הצפון,505,כאוכב אבו אל-היג'א,217,102,115,3,214,182,217,5,14%
2012-12,הצפון,1296,כסרא-סמיע,214,95,119,2,212,162,213,15,7%
2012-12,הצפון,978,כעביה-טבאש-חג'אג'רה,221,90,131,3,218,152,219,2,11%
2012-12,הצפון,1263,כפר ורדים,65,29,36,29,36,9,65,0,2%
2012-12,הצפון,507,כפר יאסיף,544,223,321,6,538,430,544,12,11%
2012-12,הצפון,508,כפר כמא,62,29,33,2,60,33,62,0,4%
2012-12,הצפון,509,כפר כנא,1199,459,740,25,1174,1071,1193,34,15%
2012-12,הצפון,510,כפר מנדא,919,413,506,9,910,722,913,2,14%
2012-12,הצפון,47,כפר תבור,43,15,28,15,28,6,43,0,2%
2012-12,הצפון,1139,כרמיאל,1780,730,1050,337,1443,919,1728,47,7%
2012-12,הצפון,481,מגאר,1475,581,894,16,1459,1305,1472,6,17%
2012-12,הצפון,516,מג'ד אל-כרום,576,249,327,7,569,459,576,10,10%
2012-12,הצפון,874,מגדל העמק,1079,444,635,84,995,502,1040,68,8%
2012-12,הצפון,4201,מג'דל שמס,490,189,301,12,478,414,480,1,11%
2012-12,הצפון,517,מזרעה,190,73,117,4,186,145,189,3,10%
2012-12,הצפון,4203,מסעדה,191,72,119,7,184,156,190,1,12%
2012-12,הצפון,518,מעיליא,44,23,21,5,39,17,43,1,3%
2012-12,הצפון,1063,מעלות-תרשיחא,864,416,448,119,745,519,860,14,7%
2012-12,הצפון,520,משהד,322,115,207,8,314,263,322,5,11%
2012-12,הצפון,9100,נהרייה,2106,963,1143,244,1862,1255,2089,47,7%
2012-12,הצפון,522,נחף,427,184,243,4,423,346,427,8,9%
2012-12,הצפון,7300,נצרת,3125,1351,1774,112,3013,2447,3122,15,10%
2012-12,הצפון,1061,נצרת עילית,1999,894,1105,236,1763,1092,1908,107,8%
2012-12,הצפון,525,סאג'ור,120,39,81,1,119,83,119,1,7%
2012-12,הצפון,7500,סח'נין,2061,897,1164,32,2029,1776,2060,22,16%
2012-12,הצפון,4501,ע'ג'ר,80,35,45,2,78,57,79,3,8%
2012-12,הצפון,530,עיילבון,198,74,124,6,192,147,198,0,8%
2012-12,הצפון,511,עילוט,307,123,184,3,304,247,307,1,12%
2012-12,הצפון,532,עין מאהל,623,276,347,11,612,535,613,2,14%
2012-12,הצפון,7600,עכו,3314,1525,1789,145,3169,2580,3290,61,13%
2012-12,הצפון,7700,עפולה,1770,732,1038,203,1567,854,1716,98,7%
2012-12,הצפון,531,עראבה,1487,603,884,39,1448,1310,1481,17,16%
2012-12,הצפון,535,פסוטה,109,50,59,2,107,78,109,0,7%
2012-12,הצפון,536,פקיעין (בוקייעה),133,74,59,6,127,79,132,4,5%
2012-12,הצפון,8000,צפת,1329,710,619,89,1240,1024,1316,26,10%
2012-12,הצפון,4100,קצרין,200,85,115,40,160,82,200,5,5%
2012-12,הצפון,2800,קריית שמונה,695,334,361,57,638,271,671,45,5%
2012-12,הצפון,543,ראמה,296,111,185,8,288,238,294,0,8%
2012-12,הצפון,26,ראש פינה,53,19,34,5,48,17,53,0,4%
2012-12,הצפון,542,ריינה,668,267,401,9,659,551,665,6,11%
2012-12,הצפון,122,רמת ישי,95,34,61,33,62,14,94,1,2%
2012-12,הצפון,913,שבלי - אום אל-גנם,232,114,118,8,224,159,231,1,10%
2012-12,הצפון,812,שלומי,264,115,149,21,243,151,263,5,8%
2012-12,הצפון,538,שעב,512,212,300,6,506,451,512,1,18%
2012-12,הצפון,8800,שפרעם,2011,757,1254,30,1981,1687,2006,30,12%
2012-12,חיפה,2710,אום אל-פחם,3834,1581,2253,19,3815,3294,3829,9,20%
2012-12,חיפה,1020,אור עקיבא,627,279,348,48,579,233,619,29,6%
2012-12,חיפה,6000,באקה אל-גרביה,699,328,371,15,684,462,697,17,7%
2012-12,חיפה,9800,בנימינה-גבעת עדה*,216,81,135,59,157,61,214,2,3%
2012-12,חיפה,1326,"בסמ""ה",450,201,249,2,448,348,450,6,13%
2012-12,חיפה,541,ג'סר א-זרקא,411,238,173,0,411,290,407,3,7%
2012-12,חיפה,628,ג'ת,225,106,119,11,214,135,225,1,5%
2012-12,חיפה,494,דאלית אל-כרמל,564,231,333,10,554,311,560,10,8%
2012-12,חיפה,9300,זכרון יעקב,249,97,152,84,165,48,246,3,3%
2012-12,חיפה,6500,חדרה,2552,1027,1525,325,2227,1012,2509,43,5%
2012-12,חיפה,4000,חיפה,6960,3317,3643,1220,5740,4054,6937,229,5%
2012-12,חיפה,1247,חריש,23,12,11,6,17,6,22,0,1%
2012-12,חיפה,2100,טירת כרמל,772,344,428,29,743,467,769,23,8%
2012-12,חיפה,654,כפר קרע,361,154,207,3,358,238,360,6,5%
2012-12,חיפה,1327,מעלה עירון,955,373,582,2,953,805,955,3,18%
2012-12,חיפה,2500,נשר,512,233,279,85,427,230,511,14,4%
2012-12,חיפה,534,עספיא,314,132,182,4,310,183,314,3,6%
2012-12,חיפה,637,ערערה,598,237,361,8,590,409,598,15,8%
2012-12,חיפה,537,פוריידיס,394,194,200,6,388,270,392,1,8%
2012-12,חיפה,7800,פרדס חנה-כרכור,880,395,485,135,745,295,877,25,5%
2012-12,חיפה,6800,קריית אתא,1698,755,943,159,1539,994,1686,47,6%
2012-12,חיפה,9500,קריית ביאליק,1177,487,690,134,1043,625,1169,37,6%
2012-12,חיפה,2300,קריית טבעון,180,98,82,54,126,46,178,2,2%
2012-12,חיפה,9600,קריית ים,1570,739,831,157,1413,1002,1566,35,8%
2012-12,חיפה,8200,קריית מוצקין,1095,462,633,170,925,547,1090,30,5%
2012-12,חיפה,922,רכסים,143,76,67,10,133,82,142,1,5%
2012-12,ירושלים,472,אבו גוש,268,139,129,6,262,198,268,7,10%
2012-12,ירושלים,2610,בית שמש,1334,601,733,102,1232,609,1325,46,5%
2012-12,ירושלים,3000,ירושלים,11257,5114,6143,1289,9968,6840,11187,180,4%
2012-12,ירושלים,1015,מבשרת ציון,408,186,222,65,343,189,404,4,3%
2012-12,ירושלים,1137,קריית יערים,44,13,31,5,39,18,44,1,4%
2012-12,תל אביב,2400,אור יהודה,902,402,500,40,862,289,891,32,5%
2012-12,תל אביב,565,אזור,201,99,102,31,170,37,200,5,3%
2012-12,תל אביב,6100,בני ברק,2430,1180,1250,114,2316,1349,2419,43,5%
2012-12,תל אביב,6200,בת ים,3510,1725,1785,476,3034,1371,3446,101,5%
2012-12,תל אביב,6300,גבעתיים,818,367,451,356,462,102,812,8,3%
2012-12,תל אביב,6400,הרצלייה,1080,482,598,315,765,57,1064,61,2%
2012-12,תל אביב,6600,חולון,3314,1571,1743,507,2807,914,3275,88,3%
2012-12,תל אביב,2620,קריית אונו,400,175,225,126,274,49,397,7,2%
2012-12,תל אביב,8600,רמת גן,2117,979,1138,654,1463,448,2097,29,3%
2012-12,תל אביב,2650,רמת השרון,402,179,223,174,228,8,400,10,2%
2012-12,תל אביב,5000,תל אביב -יפו,8296,4124,4172,2645,5651,2623,8236,113,3%
2013-01,אזור יהודה והשומרון,3760,אורנית,109,49,60,37,72,4,109,2,2%
2013-01,אזור יהודה והשומרון,3750,אלפי מנשה,114,50,64,35,79,0,113,5,3%
2013-01,אזור יהודה והשומרון,3560,אלקנה,29,11,18,16,13,1,29,0,2%
2013-01,אזור יהודה והשומרון,3650,אפרת,52,24,28,27,25,7,52,2,1%
2013-01,אזור יהודה והשומרון,3570,אריאל,406,189,217,73,333,101,406,10,4%
2013-01,אזור יהודה והשומרון,3574,בית אל,48,25,23,17,31,19,47,1,2%
2013-01,אזור יהודה והשומרון,3652,בית אריה,56,22,34,8,48,2,56,2,2%
2013-01,אזור יהודה והשומרון,3780,ביתר עילית,403,207,196,13,390,196,402,5,4%
2013-01,אזור יהודה והשומרון,3730,גבעת זאב,157,71,86,25,132,39,157,2,2%
2013-01,אזור יהודה והשומרון,3769,הר אדר,25,10,15,15,10,3,25,1,1%
2013-01,אזור יהודה והשומרון,3797,מודיעין עילית,354,137,217,19,335,108,350,9,3%
2013-01,אזור יהודה והשומרון,3616,מעלה אדומים,555,216,339,95,460,189,553,34,3%
2013-01,אזור יהודה והשומרון,3660,עמנואל,77,35,42,5,72,54,77,1,7%
2013-01,אזור יהודה והשומרון,3557,קדומים,41,20,21,11,30,10,41,1,2%
2013-01,אזור יהודה והשומרון,3611,קריית ארבע,103,49,54,21,82,56,103,1,3%
2013-01,אזור יהודה והשומרון,3640,קרני שומרון,88,39,49,24,64,17,88,2,2%
2013-01,הדרום,31,אופקים,1379,616,763,99,1280,990,1371,13,11%
2013-01,הדרום,2600,אילת,1663,731,932,77,1586,628,1635,46,5%
2013-01,הדרום,70,אשדוד,7120,2936,4184,783,6337,3871,7073,192,7%
2013-01,הדרום,7100,אשקלון,4509,1850,2659,673,3836,2665,4404,110,7%
2013-01,הדרום,9000,באר שבע,7531,3406,4125,987,6544,4632,7475,277,7%
2013-01,הדרום,2200,דימונה,2242,952,1290,136,2106,1517,2202,65,12%
2013-01,הדרום,1303,חורה,788,341,447,2,786,721,787,2,20%
2013-01,הדרום,831,ירוחם,453,214,239,21,432,287,448,33,10%
2013-01,הדרום,1059,כסיפה,976,421,555,3,973,885,973,18,22%
2013-01,הדרום,1271,להבים,40,17,23,21,19,4,40,1,1%
2013-01,הדרום,1060,לקיה,1006,457,549,2,1004,942,1006,6,25%
2013-01,הדרום,1268,מיתר,54,25,29,18,36,5,54,2,1%
2013-01,הדרום,99,מצפה רמון,245,97,148,13,232,148,234,7,10%
2013-01,הדרום,246,נתיבות,1053,465,588,65,988,573,1047,31,8%
2013-01,הדרום,666,עומר,48,23,25,22,26,5,48,2,1%
2013-01,הדרום,2560,ערד,818,375,443,143,675,455,796,40,6%
2013-01,הדרום,1192,ערערה-בנגב,970,399,571,3,967,892,968,0,24%
2013-01,הדרום,2630,קריית גת,2490,1040,1450,188,2302,1493,2485,65,9%
2013-01,הדרום,1034,קריית מלאכי,1274,580,694,37,1237,817,1254,85,11%
2013-01,הדרום,1161,רהט,3179,1362,1817,9,3170,2850,3178,53,18%
2013-01,הדרום,1286,שגב-שלום,508,195,313,0,508,463,507,2,20%
2013-01,הדרום,1031,שדרות,1134,498,636,60,1074,731,1128,14,9%
2013-01,הדרום,1054,תל שבע,1182,556,626,4,1178,1108,1181,3,25%
2013-01,המרכז,182,אבן יהודה,176,81,95,70,106,22,175,4,3%
2013-01,המרכז,41,אליכין,54,31,23,4,50,17,54,0,3%
2013-01,המרכז,1309,אלעד,416,186,230,20,396,114,414,0,3%
2013-01,המרכז,2530,באר יעקב,221,102,119,43,178,62,218,3,3%
2013-01,המרכז,466,בית דגן,128,60,68,25,103,40,128,0,4%
2013-01,המרכז,1066,"בני עי""ש",201,87,114,23,178,70,198,2,5%
2013-01,המרכז,681,גבעת שמואל,315,167,148,138,177,60,314,0,3%
2013-01,המרכז,2550,גדרה,402,171,231,67,335,105,398,0,3%
2013-01,המרכז,627,ג'לג'וליה,97,44,53,2,95,50,95,1,3%
2013-01,המרכז,166,גן יבנה,376,147,229,45,331,95,374,4,3%
2013-01,המרכז,229,גני תקווה,194,86,108,62,132,28,193,4,2%
2013-01,המרכז,9700,הוד השרון,701,343,358,245,456,70,693,18,2%
2013-01,המרכז,1290,זמר,171,53,118,8,163,123,171,2,6%
2013-01,המרכז,2730,טייבה,2228,937,1291,13,2215,1891,2222,16,13%
2013-01,המרכז,2720,טירה,354,172,182,12,342,195,353,17,3%
2013-01,המרכז,2660,יבנה,889,426,463,91,798,393,881,16,4%
2013-01,המרכז,9400,יהוד,539,224,315,88,451,73,530,29,3%
2013-01,המרכז,1224,כוכב יאיר,112,49,63,52,60,2,112,0,2%
2013-01,המרכז,633,כפר ברא,30,17,13,1,29,15,30,1,2%
2013-01,המרכז,168,כפר יונה,328,146,182,62,266,65,325,6,3%
2013-01,המרכז,6900,כפר סבא,1332,589,743,417,915,207,1321,37,3%
2013-01,המרכז,634,כפר קאסם,240,111,129,0,240,145,240,1,3%
2013-01,המרכז,7000,לוד,2198,988,1210,163,2035,1239,2186,39,6%
2013-01,המרכז,1200,מודיעין-מכבים-רעות*,909,388,521,339,570,59,902,77,2%
2013-01,המרכז,28,מזכרת בתיה,158,68,90,25,133,36,156,0,2%
2013-01,המרכז,7200,נס ציונה,694,321,373,146,548,211,686,2,3%
2013-01,המרכז,7400,נתניה,4566,2153,2413,662,3904,1692,4531,119,4%
2013-01,המרכז,587,סביון*,11,5,6,7,4,0,11,0,1%
2013-01,המרכז,171,פרדסייה,81,33,48,17,64,8,81,3,2%
2013-01,המרכז,7900,פתח תקווה,4111,1874,2237,823,3288,1113,4079,46,3%
2013-01,המרכז,195,קדימה-צורן,285,122,163,83,202,34,285,0,3%
2013-01,המרכז,638,קלנסווה,927,366,561,4,923,798,923,4,11%
2013-01,המרכז,469,קריית עקרון,304,137,167,21,283,139,301,3,5%
2013-01,המרכז,2640,ראש העין,750,394,356,97,653,151,744,31,3%
2013-01,המרכז,8300,ראשון לציון,4562,2035,2527,987,3575,1531,4536,37,3%
2013-01,המרכז,8400,רחובות,2640,1148,1492,561,2079,1076,2594,14,4%
2013-01,המרכז,8500,רמלה,1779,840,939,115,1664,831,1745,56,5%
2013-01,המרכז,8700,רעננה,807,389,418,302,505,85,807,13,2%
2013-01,המרכז,1304,שוהם,190,87,103,82,108,7,190,4,2%
2013-01,המרכז,154,תל מונד,139,69,70,42,97,25,139,0,2%
2013-01,הצפון,473,אבו סנאן,759,307,452,4,755,651,755,4,13%
2013-01,הצפון,478,אכסאל,538,235,303,14,524,461,538,8,10%
2013-01,הצפון,529,אעבלין,638,253,385,9,629,530,638,5,12%
2013-01,הצפון,482,בועיינה-נוג'ידאת,403,172,231,4,399,345,399,5,11%
2013-01,הצפון,4001,בוקעאתא,405,153,252,7,398,354,398,1,15%
2013-01,הצפון,998,ביר אל-מכסור,421,150,271,1,420,352,421,8,12%
2013-01,הצפון,480,בית ג'ן,367,120,247,9,358,259,366,1,7%
2013-01,הצפון,9200,בית שאן,880,392,488,20,860,474,878,73,9%
2013-01,הצפון,944,בסמת טבעון,217,101,116,3,214,167,216,4,7%
2013-01,הצפון,483,בענה,426,172,254,1,425,360,426,9,13%
2013-01,הצפון,1292,ג'דיידה-מכר,1557,655,902,6,1551,1375,1556,7,18%
2013-01,הצפון,485,ג'ולס,261,73,188,2,259,173,261,3,9%
2013-01,הצפון,487,ג'ש (גוש חלב),64,29,35,5,59,31,63,1,4%
2013-01,הצפון,489,דבורייה,412,178,234,17,395,306,412,2,10%
2013-01,הצפון,490,דייר אל-אסד,441,185,256,9,432,350,441,8,9%
2013-01,הצפון,492,דייר חנא,680,303,377,11,669,519,680,15,15%
2013-01,הצפון,975,זרזיר,350,164,186,1,349,241,345,13,12%
2013-01,הצפון,496,חורפיש,135,56,79,4,131,73,134,2,5%
2013-01,הצפון,2034,חצור הגלילית,273,117,156,19,254,140,268,5,6%
2013-01,הצפון,6700,טבריה,1990,890,1100,106,1884,1179,1846,65,8%
2013-01,הצפון,962,טובא-זנגרייה,374,171,203,4,370,267,371,0,13%
2013-01,הצפון,498,טורעאן,581,240,341,8,573,501,578,21,11%
2013-01,הצפון,8900,טמרה,2030,816,1214,13,2017,1779,2024,17,15%
2013-01,הצפון,1295,יאנוח-ג'ת,160,60,100,4,156,111,160,1,6%
2013-01,הצפון,46,יבנאל,154,107,47,8,146,118,141,1,9%
2013-01,הצפון,499,יפיע,678,302,376,12,666,527,676,12,9%
2013-01,הצפון,240,יקנעם עילית,523,229,294,85,438,169,521,41,5%
2013-01,הצפון,502,ירכא,553,220,333,1,552,437,553,1,10%
2013-01,הצפון,504,כאבול,705,278,427,6,699,615,702,13,15%
2013-01,הצפון,505,כאוכב אבו אל-היג'א,227,110,117,3,224,189,227,5,14%
2013-01,הצפון,1296,כסרא-סמיע,200,85,115,6,194,150,199,7,6%
2013-01,הצפון,978,כעביה-טבאש-חג'אג'רה,213,83,130,1,212,151,212,1,10%
2013-01,הצפון,1263,כפר ורדים,66,30,36,22,44,11,66,3,2%
2013-01,הצפון,507,כפר יאסיף,567,241,326,5,562,446,567,2,11%
2013-01,הצפון,508,כפר כמא,70,32,38,2,68,35,69,0,4%
2013-01,הצפון,509,כפר כנא,1230,481,749,29,1201,1094,1224,29,14%
2013-01,הצפון,510,כפר מנדא,971,446,525,10,961,740,965,15,14%
2013-01,הצפון,47,כפר תבור,40,17,23,9,31,6,40,0,2%
2013-01,הצפון,1139,כרמיאל,1826,735,1091,346,1480,914,1770,42,7%
2013-01,הצפון,481,מגאר,1535,636,899,19,1516,1354,1531,15,18%
2013-01,הצפון,516,מג'ד אל-כרום,589,257,332,7,582,462,589,13,9%
2013-01,הצפון,874,מגדל העמק,1067,454,613,82,985,493,1032,86,8%
2013-01,הצפון,4201,מג'דל שמס,475,177,298,11,464,409,469,6,10%
2013-01,הצפון,517,מזרעה,180,65,115,3,177,138,179,3,9%
2013-01,הצפון,4203,מסעדה,202,78,124,8,194,156,201,0,12%
2013-01,הצפון,518,מעיליא,45,24,21,5,40,16,45,2,3%
2013-01,הצפון,1063,מעלות-תרשיחא,896,438,458,112,784,542,893,36,7%
2013-01,הצפון,520,משהד,317,114,203,10,307,259,317,11,10%
2013-01,הצפון,9100,נהרייה,2107,962,1145,241,1866,1255,2096,58,7%
2013-01,הצפון,522,נחף,440,194,246,8,432,352,440,9,9%
2013-01,הצפון,7300,נצרת,3204,1412,1792,108,3096,2470,3200,48,10%
2013-01,הצפון,1061,נצרת עילית,2057,912,1145,261,1796,1174,1974,105,8%
2013-01,הצפון,525,סאג'ור,113,40,73,0,113,77,112,2,7%
2013-01,הצפון,7500,סח'נין,2095,914,1181,39,2056,1780,2094,28,16%
2013-01,הצפון,4501,ע'ג'ר,85,41,44,4,81,56,85,0,9%
2013-01,הצפון,530,עיילבון,204,84,120,6,198,149,204,1,8%
2013-01,הצפון,511,עילוט,321,135,186,3,318,257,320,1,12%
2013-01,הצפון,532,עין מאהל,636,286,350,11,625,546,626,6,13%
2013-01,הצפון,7600,עכו,3340,1554,1786,150,3190,2586,3323,61,13%
2013-01,הצפון,7700,עפולה,1718,712,1006,196,1522,856,1687,107,7%
2013-01,הצפון,531,עראבה,1516,628,888,43,1473,1324,1510,26,16%
2013-01,הצפון,535,פסוטה,120,52,68,5,115,83,120,3,7%
2013-01,הצפון,536,פקיעין (בוקייעה),140,76,64,8,132,88,139,4,5%
2013-01,הצפון,8000,צפת,1351,720,631,98,1253,1045,1338,8,10%
2013-01,הצפון,4100,קצרין,202,90,112,39,163,81,200,6,5%
2013-01,הצפון,2800,קריית שמונה,725,353,372,62,663,304,700,27,5%
2013-01,הצפון,543,ראמה,310,121,189,9,301,241,310,2,8%
2013-01,הצפון,26,ראש פינה,51,16,35,5,46,19,50,0,3%
2013-01,הצפון,542,ריינה,691,291,400,9,682,571,686,17,10%
2013-01,הצפון,122,רמת ישי,102,37,65,37,65,17,102,2,2%
2013-01,הצפון,913,שבלי - אום אל-גנם,232,114,118,5,227,155,230,3,9%
2013-01,הצפון,812,שלומי,261,112,149,22,239,151,259,8,7%
2013-01,הצפון,538,שעב,522,220,302,7,515,458,522,8,18%
2013-01,הצפון,8800,שפרעם,2016,765,1251,23,1993,1700,2012,32,12%
2013-01,חיפה,2710,אום אל-פחם,3905,1613,2292,21,3884,3342,3899,13,19%
2013-01,חיפה,1020,אור עקיבא,628,284,344,41,587,233,616,41,6%
2013-01,חיפה,6000,באקה אל-גרביה,716,341,375,16,700,475,715,19,6%
2013-01,חיפה,9800,בנימינה-גבעת עדה*,205,82,123,58,147,64,204,5,3%
2013-01,חיפה,1326,"בסמ""ה",445,192,253,2,443,356,445,13,12%
2013-01,חיפה,541,ג'סר א-זרקא,427,248,179,0,427,303,425,5,7%
2013-01,חיפה,628,ג'ת,234,107,127,11,223,141,234,12,5%
2013-01,חיפה,494,דאלית אל-כרמל,553,236,317,9,544,303,549,15,7%
2013-01,חיפה,9300,זכרון יעקב,258,103,155,85,173,51,255,4,2%
2013-01,חיפה,6500,חדרה,2493,1011,1482,323,2170,1022,2463,53,5%
2013-01,חיפה,4000,חיפה,6957,3340,3617,1207,5750,4002,6933,287,5%
2013-01,חיפה,1247,חריש,24,15,9,6,18,5,24,0,2%
2013-01,חיפה,2100,טירת כרמל,799,372,427,28,771,465,796,28,8%
2013-01,חיפה,654,כפר קרע,391,177,214,4,387,239,390,10,5%
2013-01,חיפה,1327,מעלה עירון,982,393,589,2,980,811,982,3,17%
2013-01,חיפה,2500,נשר,503,232,271,90,413,218,502,12,4%
2013-01,חיפה,534,עספיא,307,121,186,3,304,192,306,16,6%
2013-01,חיפה,637,ערערה,611,243,368,5,606,420,611,17,8%
2013-01,חיפה,537,פוריידיס,405,205,200,4,401,276,403,7,8%
2013-01,חיפה,7800,פרדס חנה-כרכור,863,380,483,146,717,296,859,40,4%
2013-01,חיפה,6800,קריית אתא,1750,786,964,173,1577,1025,1741,73,6%
2013-01,חיפה,9500,קריית ביאליק,1181,483,698,126,1055,629,1176,48,5%
2013-01,חיפה,2300,קריית טבעון,199,103,96,67,132,49,197,3,2%
2013-01,חיפה,9600,קריית ים,1625,766,859,174,1451,1006,1621,88,8%
2013-01,חיפה,8200,קריית מוצקין,1108,481,627,168,940,561,1103,46,5%
2013-01,חיפה,922,רכסים,153,79,74,12,141,88,152,3,5%
2013-01,ירושלים,472,אבו גוש,256,123,133,5,251,196,256,2,9%
2013-01,ירושלים,2610,בית שמש,1191,529,662,90,1101,574,1185,61,4%
2013-01,ירושלים,3000,ירושלים,10759,4858,5901,1264,9495,6718,10698,293,4%
2013-01,ירושלים,1015,מבשרת ציון,379,177,202,64,315,177,378,7,3%
2013-01,ירושלים,1137,קריית יערים,36,14,22,4,32,16,36,0,3%
2013-01,תל אביב,2400,אור יהודה,872,411,461,39,833,288,859,25,5%
2013-01,תל אביב,565,אזור,208,104,104,29,179,36,207,1,3%
2013-01,תל אביב,6100,בני ברק,2309,1149,1160,107,2202,1337,2291,7,4%
2013-01,תל אביב,6200,בת ים,3353,1632,1721,458,2895,1332,3283,37,5%
2013-01,תל אביב,6300,גבעתיים,747,338,409,321,426,94,742,2,3%
2013-01,תל אביב,6400,הרצלייה,1021,461,560,299,722,54,1004,123,2%
2013-01,תל אביב,6600,חולון,3342,1562,1780,510,2832,916,3296,29,3%
2013-01,תל אביב,2620,קריית אונו,386,169,217,124,262,48,383,41,2%
2013-01,תל אביב,8600,רמת גן,2147,1025,1122,669,1478,461,2123,12,3%
2013-01,תל אביב,2650,רמת השרון,400,168,232,157,243,8,397,44,2%
2013-01,תל אביב,5000,תל אביב -יפו,8086,3973,4113,2510,5576,2606,7999,36,3%
2013-02,אזור יהודה והשומרון,3760,אורנית,111,51,60,40,71,4,111,0,2%
2013-02,אזור יהודה והשומרון,3750,אלפי מנשה,112,49,63,39,73,0,111,1,3%
2013-02,אזור יהודה והשומרון,3560,אלקנה,29,13,16,16,13,1,29,1,2%
2013-02,אזור יהודה והשומרון,3650,אפרת,49,23,26,22,27,7,49,1,1%
2013-02,אזור יהודה והשומרון,3570,אריאל,382,179,203,71,311,105,381,12,4%
2013-02,אזור יהודה והשומרון,3574,בית אל,47,23,24,18,29,20,46,0,2%
2013-02,אזור יהודה והשומרון,3652,בית אריה,52,24,28,6,46,2,52,0,2%
2013-02,אזור יהודה והשומרון,3780,ביתר עילית,417,207,210,14,403,199,412,1,4%
2013-02,אזור יהודה והשומרון,3730,גבעת זאב,157,72,85,25,132,40,156,0,2%
2013-02,אזור יהודה והשומרון,3769,הר אדר,23,10,13,12,11,2,23,0,1%
2013-02,אזור יהודה והשומרון,3797,מודיעין עילית,327,130,197,18,309,107,320,2,2%
2013-02,אזור יהודה והשומרון,3616,מעלה אדומים,589,232,357,101,488,182,585,3,3%
2013-02,אזור יהודה והשומרון,3660,עמנואל,75,30,45,5,70,50,75,2,7%
2013-02,אזור יהודה והשומרון,3557,קדומים,39,18,21,10,29,9,39,1,2%
2013-02,אזור יהודה והשומרון,3611,קריית ארבע,103,48,55,23,80,59,103,0,3%
2013-02,אזור יהודה והשומרון,3640,קרני שומרון,93,44,49,26,67,14,93,1,3%
2013-02,הדרום,31,אופקים,1334,612,722,101,1233,967,1327,18,11%
2013-02,הדרום,2600,אילת,1668,737,931,77,1591,627,1655,46,5%
2013-02,הדרום,70,אשדוד,6879,2834,4045,752,6127,3796,6836,167,6%
2013-02,הדרום,7100,אשקלון,4369,1766,2603,691,3678,2628,4271,97,6%
2013-02,הדרום,9000,באר שבע,7317,3296,4021,977,6340,4550,7256,233,7%
2013-02,הדרום,2200,דימונה,2199,932,1267,140,2059,1521,2176,60,12%
2013-02,הדרום,1303,חורה,775,329,446,1,774,718,774,0,20%
2013-02,הדרום,831,ירוחם,432,213,219,22,410,274,427,22,10%
2013-02,הדרום,1059,כסיפה,1000,438,562,1,999,897,996,10,22%
2013-02,הדרום,1271,להבים,45,17,28,22,23,4,45,0,1%
2013-02,הדרום,1060,לקיה,999,445,554,2,997,927,999,4,25%
2013-02,הדרום,1268,מיתר,49,23,26,18,31,6,49,2,1%
2013-02,הדרום,99,מצפה רמון,232,87,145,11,221,144,225,8,9%
2013-02,הדרום,246,נתיבות,1015,462,553,58,957,542,1008,32,8%
2013-02,הדרום,666,עומר,53,26,27,22,31,4,53,2,1%
2013-02,הדרום,2560,ערד,800,365,435,137,663,446,781,55,6%
2013-02,הדרום,1192,ערערה-בנגב,984,404,580,3,981,905,983,0,25%
2013-02,הדרום,2630,קריית גת,2417,986,1431,180,2237,1504,2410,57,9%
2013-02,הדרום,1034,קריית מלאכי,1262,575,687,35,1227,805,1248,89,11%
2013-02,הדרום,1161,רהט,3165,1349,1816,9,3156,2817,3164,18,18%
2013-02,הדרום,1286,שגב-שלום,516,202,314,0,516,462,515,5,21%
2013-02,הדרום,1031,שדרות,1117,492,625,53,1064,706,1110,20,9%
2013-02,הדרום,1054,תל שבע,1177,552,625,1,1176,1097,1175,6,25%
2013-02,המרכז,182,אבן יהודה,167,78,89,62,105,20,166,2,3%
2013-02,המרכז,41,אליכין,52,29,23,4,48,20,52,0,3%
2013-02,המרכז,1309,אלעד,418,189,229,22,396,117,417,0,4%
2013-02,המרכז,2530,באר יעקב,243,112,131,42,201,59,241,2,3%
2013-02,המרכז,466,בית דגן,124,59,65,21,103,43,124,1,4%
2013-02,המרכז,1066,"בני עי""ש",191,92,99,25,166,72,190,2,5%
2013-02,המרכז,681,גבעת שמואל,332,175,157,138,194,67,331,0,3%
2013-02,המרכז,2550,גדרה,349,147,202,59,290,102,345,0,3%
2013-02,המרכז,627,ג'לג'וליה,87,42,45,1,86,47,86,0,3%
2013-02,המרכז,166,גן יבנה,378,151,227,39,339,102,377,8,3%
2013-02,המרכז,229,גני תקווה,197,86,111,63,134,27,196,0,2%
2013-02,המרכז,9700,הוד השרון,648,319,329,215,433,59,643,5,2%
2013-02,המרכז,1290,זמר,171,58,113,7,164,122,171,0,6%
2013-02,המרכז,2730,טייבה,2212,942,1270,14,2198,1885,2208,28,13%
2013-02,המרכז,2720,טירה,352,167,185,12,340,186,351,12,3%
2013-02,המרכז,2660,יבנה,902,430,472,92,810,386,896,23,4%
2013-02,המרכז,9400,יהוד,583,250,333,84,499,78,570,13,4%
2013-02,המרכז,1224,כוכב יאיר,113,48,65,56,57,1,113,0,2%
2013-02,המרכז,633,כפר ברא,33,20,13,2,31,13,33,0,3%
2013-02,המרכז,168,כפר יונה,299,133,166,64,235,64,296,6,3%
2013-02,המרכז,6900,כפר סבא,1254,534,720,394,860,190,1247,20,2%
2013-02,המרכז,634,כפר קאסם,248,122,126,3,245,152,246,2,3%
2013-02,המרכז,7000,לוד,2215,989,1226,152,2063,1232,2194,21,6%
2013-02,המרכז,1200,מודיעין-מכבים-רעות*,940,393,547,327,613,55,932,5,2%
2013-02,המרכז,28,מזכרת בתיה,155,70,85,27,128,36,154,0,2%
2013-02,המרכז,7200,נס ציונה,698,323,375,159,539,214,693,1,3%
2013-02,המרכז,7400,נתניה,4282,2033,2249,627,3655,1573,4256,94,4%
2013-02,המרכז,587,סביון*,11,6,5,6,5,0,11,0,1%
2013-02,המרכז,171,פרדסייה,65,30,35,14,51,6,65,0,2%
2013-02,המרכז,7900,פתח תקווה,4121,1882,2239,836,3285,1116,4092,18,3%
2013-02,המרכז,195,קדימה-צורן,269,118,151,77,192,36,266,3,3%
2013-02,המרכז,638,קלנסווה,930,368,562,4,926,798,927,7,11%
2013-02,המרכז,469,קריית עקרון,305,148,157,17,288,143,303,1,5%
2013-02,המרכז,2640,ראש העין,711,367,344,99,612,156,706,22,3%
2013-02,המרכז,8300,ראשון לציון,4680,2101,2579,976,3704,1546,4657,23,3%
2013-02,המרכז,8400,רחובות,2562,1146,1416,551,2011,1046,2515,9,4%
2013-02,המרכז,8500,רמלה,1832,870,962,124,1708,839,1790,24,5%
2013-02,המרכז,8700,רעננה,763,376,387,289,474,78,762,9,2%
2013-02,המרכז,1304,שוהם,198,92,106,78,120,9,198,1,2%
2013-02,המרכז,154,תל מונד,126,61,65,36,90,24,126,1,2%
2013-02,הצפון,473,אבו סנאן,766,300,466,5,761,652,760,2,13%
2013-02,הצפון,478,אכסאל,533,228,305,18,515,450,533,3,10%
2013-02,הצפון,529,אעבלין,635,262,373,11,624,525,635,3,12%
2013-02,הצפון,482,בועיינה-נוג'ידאת,408,174,234,4,404,350,404,2,11%
2013-02,הצפון,4001,בוקעאתא,416,159,257,6,410,362,409,1,15%
2013-02,הצפון,998,ביר אל-מכסור,411,146,265,1,410,346,411,6,12%
2013-02,הצפון,480,בית ג'ן,350,115,235,8,342,250,350,1,7%
2013-02,הצפון,9200,בית שאן,815,360,455,20,795,466,814,44,8%
2013-02,הצפון,944,בסמת טבעון,216,102,114,3,213,162,216,2,7%
2013-02,הצפון,483,בענה,407,164,243,1,406,342,407,5,13%
2013-02,הצפון,1292,ג'דיידה-מכר,1523,628,895,5,1518,1349,1517,0,17%
2013-02,הצפון,485,ג'ולס,250,65,185,1,249,165,249,0,9%
2013-02,הצפון,487,ג'ש (גוש חלב),58,28,30,4,54,30,57,1,4%
2013-02,הצפון,489,דבורייה,406,182,224,16,390,311,406,1,10%
2013-02,הצפון,490,דייר אל-אסד,399,171,228,5,394,311,399,4,8%
2013-02,הצפון,492,דייר חנא,667,295,372,11,656,515,667,4,14%
2013-02,הצפון,975,זרזיר,341,158,183,1,340,243,334,1,11%
2013-02,הצפון,496,חורפיש,130,52,78,4,126,72,129,3,5%
2013-02,הצפון,2034,חצור הגלילית,267,113,154,15,252,138,260,14,6%
2013-02,הצפון,6700,טבריה,1857,839,1018,93,1764,1143,1716,35,8%
2013-02,הצפון,962,טובא-זנגרייה,366,161,205,4,362,264,361,1,12%
2013-02,הצפון,498,טורעאן,548,217,331,5,543,473,542,16,10%
2013-02,הצפון,8900,טמרה,1996,794,1202,17,1979,1748,1987,8,15%
2013-02,הצפון,1295,יאנוח-ג'ת,154,49,105,3,151,108,152,4,6%
2013-02,הצפון,46,יבנאל,159,108,51,8,151,120,148,1,9%
2013-02,הצפון,499,יפיע,643,293,350,12,631,498,641,4,9%
2013-02,הצפון,240,יקנעם עילית,503,211,292,78,425,175,501,22,4%
2013-02,הצפון,502,ירכא,547,221,326,1,546,437,546,0,10%
2013-02,הצפון,504,כאבול,673,257,416,3,670,592,669,1,14%
2013-02,הצפון,505,כאוכב אבו אל-היג'א,223,102,121,3,220,189,223,0,14%
2013-02,הצפון,1296,כסרא-סמיע,215,85,130,5,210,162,215,2,7%
2013-02,הצפון,978,כעביה-טבאש-חג'אג'רה,214,83,131,1,213,150,213,2,10%
2013-02,הצפון,1263,כפר ורדים,63,28,35,23,40,9,62,3,2%
2013-02,הצפון,507,כפר יאסיף,550,230,320,5,545,443,550,1,11%
2013-02,הצפון,508,כפר כמא,70,29,41,1,69,32,69,1,4%
2013-02,הצפון,509,כפר כנא,1188,458,730,26,1162,1046,1182,26,14%
2013-02,הצפון,510,כפר מנדא,957,431,526,11,946,712,950,3,13%
2013-02,הצפון,47,כפר תבור,41,18,23,10,31,7,41,0,2%
2013-02,הצפון,1139,כרמיאל,1688,669,1019,337,1351,877,1650,14,6%
2013-02,הצפון,481,מגאר,1489,598,891,20,1469,1309,1483,4,17%
2013-02,הצפון,516,מג'ד אל-כרום,569,254,315,2,567,436,569,9,9%
2013-02,הצפון,874,מגדל העמק,988,413,575,78,910,474,964,54,7%
2013-02,הצפון,4201,מג'דל שמס,472,175,297,12,460,404,469,8,10%
2013-02,הצפון,517,מזרעה,180,66,114,3,177,137,179,0,9%
2013-02,הצפון,4203,מסעדה,206,77,129,8,198,161,205,2,12%
2013-02,הצפון,518,מעיליא,41,21,20,2,39,16,40,0,3%
2013-02,הצפון,1063,מעלות-תרשיחא,868,423,445,108,760,528,857,22,7%
2013-02,הצפון,520,משהד,305,113,192,11,294,255,304,10,10%
2013-02,הצפון,9100,נהרייה,1988,900,1088,226,1762,1234,1977,21,6%
2013-02,הצפון,522,נחף,407,177,230,8,399,334,407,1,9%
2013-02,הצפון,7300,נצרת,3167,1391,1776,104,3063,2485,3161,21,9%
2013-02,הצפון,1061,נצרת עילית,1913,836,1077,254,1659,1078,1831,92,8%
2013-02,הצפון,525,סאג'ור,104,38,66,0,104,71,104,0,6%
2013-02,הצפון,7500,סח'נין,2102,929,1173,32,2070,1781,2100,3,16%
2013-02,הצפון,4501,ע'ג'ר,77,35,42,4,73,58,76,0,8%
2013-02,הצפון,530,עיילבון,200,78,122,7,193,147,200,0,8%
2013-02,הצפון,511,עילוט,312,132,180,3,309,252,312,1,12%
2013-02,הצפון,532,עין מאהל,609,275,334,10,599,512,601,9,12%
2013-02,הצפון,7600,עכו,3229,1495,1734,138,3091,2520,3202,33,12%
2013-02,הצפון,7700,עפולה,1601,665,936,183,1418,821,1569,52,6%
2013-02,הצפון,531,עראבה,1460,612,848,30,1430,1293,1457,4,15%
2013-02,הצפון,535,פסוטה,116,51,65,3,113,80,116,3,7%
2013-02,הצפון,536,פקיעין (בוקייעה),141,75,66,5,136,86,140,1,5%
2013-02,הצפון,8000,צפת,1336,712,624,90,1246,1058,1319,3,10%
2013-02,הצפון,4100,קצרין,177,76,101,37,140,74,174,0,4%
2013-02,הצפון,2800,קריית שמונה,680,330,350,56,624,286,662,12,5%
2013-02,הצפון,543,ראמה,317,123,194,8,309,246,316,0,8%
2013-02,הצפון,26,ראש פינה,46,13,33,5,41,16,45,1,3%
2013-02,הצפון,542,ריינה,665,273,392,8,657,545,661,12,10%
2013-02,הצפון,122,רמת ישי,97,36,61,28,69,16,97,1,2%
2013-02,הצפון,913,שבלי - אום אל-גנם,216,97,119,3,213,148,215,0,9%
2013-02,הצפון,812,שלומי,238,102,136,18,220,153,237,3,7%
2013-02,הצפון,538,שעב,516,212,304,6,510,457,516,2,18%
2013-02,הצפון,8800,שפרעם,1951,723,1228,25,1926,1650,1944,10,11%
2013-02,חיפה,2710,אום אל-פחם,3879,1597,2282,20,3859,3350,3874,6,19%
2013-02,חיפה,1020,אור עקיבא,587,252,335,39,548,227,578,20,6%
2013-02,חיפה,6000,באקה אל-גרביה,689,322,367,17,672,460,689,15,6%
2013-02,חיפה,9800,בנימינה-גבעת עדה*,190,71,119,50,140,60,189,3,3%
2013-02,חיפה,1326,"בסמ""ה",449,195,254,1,448,358,449,5,12%
2013-02,חיפה,541,ג'סר א-זרקא,426,246,180,0,426,301,424,4,7%
2013-02,חיפה,628,ג'ת,218,95,123,10,208,137,218,2,4%
2013-02,חיפה,494,דאלית אל-כרמל,549,234,315,8,541,312,545,6,7%
2013-02,חיפה,9300,זכרון יעקב,239,102,137,80,159,48,236,0,2%
2013-02,חיפה,6500,חדרה,2339,952,1387,297,2042,986,2310,31,5%
2013-02,חיפה,4000,חיפה,6567,3213,3354,1138,5429,3768,6537,72,5%
2013-02,חיפה,1247,חריש,22,11,11,6,16,6,22,0,1%
2013-02,חיפה,2100,טירת כרמל,740,337,403,27,713,432,736,17,7%
2013-02,חיפה,654,כפר קרע,392,169,223,4,388,241,391,5,5%
2013-02,חיפה,1327,מעלה עירון,975,388,587,2,973,810,975,3,17%
2013-02,חיפה,2500,נשר,479,228,251,80,399,207,477,5,4%
2013-02,חיפה,534,עספיא,303,131,172,4,299,184,303,7,6%
2013-02,חיפה,637,ערערה,604,240,364,6,598,419,604,11,8%
2013-02,חיפה,537,פוריידיס,412,215,197,3,409,275,410,5,8%
2013-02,חיפה,7800,פרדס חנה-כרכור,798,354,444,129,669,291,792,29,4%
2013-02,חיפה,6800,קריית אתא,1659,747,912,162,1497,962,1652,14,6%
2013-02,חיפה,9500,קריית ביאליק,1134,468,666,127,1007,620,1128,13,5%
2013-02,חיפה,2300,קריית טבעון,175,85,90,62,113,40,173,1,2%
2013-02,חיפה,9600,קריית ים,1534,712,822,167,1367,982,1531,11,7%
2013-02,חיפה,8200,קריית מוצקין,1072,470,602,163,909,543,1070,10,5%
2013-02,חיפה,922,רכסים,128,65,63,10,118,73,127,1,4%
2013-02,ירושלים,472,אבו גוש,269,136,133,6,263,194,267,0,9%
2013-02,ירושלים,2610,בית שמש,1215,552,663,97,1118,575,1190,25,4%
2013-02,ירושלים,3000,ירושלים,11024,4955,6069,1275,9749,6853,10912,43,4%
2013-02,ירושלים,1015,מבשרת ציון,380,180,200,69,311,171,378,0,3%
2013-02,ירושלים,1137,קריית יערים,37,16,21,6,31,17,37,0,3%
2013-02,תל אביב,2400,אור יהודה,891,421,470,37,854,277,872,22,5%
2013-02,תל אביב,565,אזור,183,91,92,26,157,30,177,0,3%
2013-02,תל אביב,6100,בני ברק,2472,1218,1254,126,2346,1421,2456,1,5%
2013-02,תל אביב,6200,בת ים,3444,1665,1779,468,2976,1296,3366,41,5%
2013-02,תל אביב,6300,גבעתיים,780,356,424,335,445,103,775,0,3%
2013-02,תל אביב,6400,הרצלייה,1045,468,577,308,737,57,1026,9,2%
2013-02,תל אביב,6600,חולון,3362,1593,1769,497,2865,921,3296,24,3%
2013-02,תל אביב,2620,קריית אונו,403,181,222,130,273,44,400,1,2%
2013-02,תל אביב,8600,רמת גן,2171,1011,1160,674,1497,480,2139,10,3%
2013-02,תל אביב,2650,רמת השרון,410,170,240,154,256,11,407,2,2%
2013-02,תל אביב,5000,תל אביב -יפו,8184,4068,4116,2449,5735,2630,8066,37,3%
2013-03,אזור יהודה והשומרון,3760,אורנית,94,47,47,33,61,4,94,0,2%
2013-03,אזור יהודה והשומרון,3750,אלפי מנשה,125,56,69,39,86,0,124,0,3%
2013-03,אזור יהודה והשומרון,3560,אלקנה,29,14,15,13,16,1,29,1,2%
2013-03,אזור יהודה והשומרון,3650,אפרת,51,27,24,19,32,6,50,0,1%
2013-03,אזור יהודה והשומרון,3570,אריאל,369,170,199,70,299,105,367,4,4%
2013-03,אזור יהודה והשומרון,3574,בית אל,45,24,21,14,31,20,44,0,2%
2013-03,אזור יהודה והשומרון,3652,בית אריה,51,24,27,8,43,2,51,0,2%
2013-03,אזור יהודה והשומרון,3780,ביתר עילית,423,218,205,10,413,202,409,1,4%
2013-03,אזור יהודה והשומרון,3730,גבעת זאב,144,67,77,23,121,38,144,1,2%
2013-03,אזור יהודה והשומרון,3769,הר אדר,25,10,15,11,14,2,25,0,1%
2013-03,אזור יהודה והשומרון,3797,מודיעין עילית,346,133,213,13,333,108,340,5,3%
2013-03,אזור יהודה והשומרון,3616,מעלה אדומים,604,238,366,91,513,185,597,4,3%
2013-03,אזור יהודה והשומרון,3660,עמנואל,74,33,41,5,69,53,74,0,7%
2013-03,אזור יהודה והשומרון,3557,קדומים,37,21,16,8,29,9,36,0,2%
2013-03,אזור יהודה והשומרון,3611,קריית ארבע,104,48,56,21,83,56,104,0,3%
2013-03,אזור יהודה והשומרון,3640,קרני שומרון,70,30,40,18,52,12,69,0,2%
2013-03,הדרום,31,אופקים,1269,598,671,95,1174,934,1264,6,10%
2013-03,הדרום,2600,אילת,1523,669,854,70,1453,584,1510,16,5%
2013-03,הדרום,70,אשדוד,6418,2596,3822,691,5727,3659,6380,22,6%
2013-03,הדרום,7100,אשקלון,4077,1614,2463,605,3472,2531,3977,21,6%
2013-03,הדרום,9000,באר שבע,6858,3081,3777,915,5943,4392,6805,44,7%
2013-03,הדרום,2200,דימונה,2066,889,1177,127,1939,1473,2043,21,11%
2013-03,הדרום,1303,חורה,761,319,442,1,760,711,761,0,20%
2013-03,הדרום,831,ירוחם,401,189,212,25,376,271,398,15,9%
2013-03,הדרום,1059,כסיפה,970,416,554,1,969,881,967,0,22%
2013-03,הדרום,1271,להבים,41,16,25,21,20,4,41,0,1%
2013-03,הדרום,1060,לקיה,957,420,537,1,956,898,957,0,24%
2013-03,הדרום,1268,מיתר,46,20,26,17,29,5,46,0,1%
2013-03,הדרום,99,מצפה רמון,235,93,142,11,224,151,227,3,9%
2013-03,הדרום,246,נתיבות,906,422,484,47,859,520,903,3,7%
2013-03,הדרום,666,עומר,53,27,26,21,32,4,53,1,1%
2013-03,הדרום,2560,ערד,743,347,396,128,615,432,726,16,6%
2013-03,הדרום,1192,ערערה-בנגב,969,382,587,2,967,896,966,0,24%
2013-03,הדרום,2630,קריית גת,2197,893,1304,169,2028,1447,2191,25,8%
2013-03,הדרום,1034,קריית מלאכי,1111,486,625,34,1077,776,1099,17,9%
2013-03,הדרום,1161,רהט,3071,1283,1788,8,3063,2781,3065,19,17%
2013-03,הדרום,1286,שגב-שלום,488,188,300,0,488,441,486,0,20%
2013-03,הדרום,1031,שדרות,1063,466,597,48,1015,690,1056,8,8%
2013-03,הדרום,1054,תל שבע,1152,533,619,2,1150,1086,1147,1,25%
2013-03,המרכז,182,אבן יהודה,156,74,82,56,100,19,155,0,2%
2013-03,המרכז,41,אליכין,50,29,21,4,46,16,49,0,3%
2013-03,המרכז,1309,אלעד,399,189,210,18,381,118,397,0,3%
2013-03,המרכז,2530,באר יעקב,242,110,132,42,200,60,239,0,3%
2013-03,המרכז,466,בית דגן,118,57,61,25,93,41,118,1,3%
2013-03,המרכז,1066,"בני עי""ש",198,93,105,24,174,72,198,0,5%
2013-03,המרכז,681,גבעת שמואל,319,169,150,136,183,63,319,0,3%
2013-03,המרכז,2550,גדרה,343,148,195,53,290,105,336,1,3%
2013-03,המרכז,627,ג'לג'וליה,94,42,52,1,93,50,93,0,3%
2013-03,המרכז,166,גן יבנה,355,142,213,33,322,95,353,1,3%
2013-03,המרכז,229,גני תקווה,176,80,96,62,114,22,175,0,2%
2013-03,המרכז,9700,הוד השרון,666,320,346,207,459,56,660,0,2%
2013-03,המרכז,1290,זמר,174,56,118,7,167,128,174,1,6%
2013-03,המרכז,2730,טייבה,2243,961,1282,13,2230,1905,2214,15,13%
2013-03,המרכז,2720,טירה,346,160,186,7,339,181,342,3,3%
2013-03,המרכז,2660,יבנה,864,413,451,86,778,377,858,11,4%
2013-03,המרכז,9400,יהוד,494,196,298,77,417,75,484,8,3%
2013-03,המרכז,1224,כוכב יאיר,134,57,77,53,81,1,134,0,2%
2013-03,המרכז,633,כפר ברא,30,17,13,2,28,15,30,0,2%
2013-03,המרכז,168,כפר יונה,291,120,171,65,226,65,286,2,3%
2013-03,המרכז,6900,כפר סבא,1313,569,744,393,920,201,1295,5,3%
2013-03,המרכז,634,כפר קאסם,258,130,128,3,255,152,256,1,3%
2013-03,המרכז,7000,לוד,2219,999,1220,140,2079,1244,2195,15,6%
2013-03,המרכז,1200,מודיעין-מכבים-רעות*,982,433,549,307,675,59,972,10,2%
2013-03,המרכז,28,מזכרת בתיה,155,68,87,28,127,29,154,0,2%
2013-03,המרכז,7200,נס ציונה,719,333,386,145,574,213,714,0,3%
2013-03,המרכז,7400,נתניה,4336,1998,2338,604,3732,1683,4247,12,4%
2013-03,המרכז,587,סביון*,11,6,5,4,7,1,11,0,1%
2013-03,המרכז,171,פרדסייה,69,33,36,17,52,9,66,0,2%
2013-03,המרכז,7900,פתח תקווה,4116,1881,2235,846,3270,1094,4084,15,3%
2013-03,המרכז,195,קדימה-צורן,261,119,142,70,191,35,260,2,3%
2013-03,המרכז,638,קלנסווה,957,390,567,4,953,807,942,2,11%
2013-03,המרכז,469,קריית עקרון,306,149,157,18,288,135,304,2,5%
2013-03,המרכז,2640,ראש העין,714,361,353,82,632,152,706,3,3%
2013-03,המרכז,8300,ראשון לציון,4711,2114,2597,913,3798,1506,4691,47,3%
2013-03,המרכז,8400,רחובות,2536,1173,1363,516,2020,1017,2489,16,4%
2013-03,המרכז,8500,רמלה,1804,843,961,118,1686,828,1761,39,5%
2013-03,המרכז,8700,רעננה,795,370,425,281,514,90,790,2,2%
2013-03,המרכז,1304,שוהם,187,85,102,71,116,7,187,0,2%
2013-03,המרכז,154,תל מונד,143,71,72,34,109,27,143,0,2%
2013-03,הצפון,473,אבו סנאן,768,299,469,5,763,655,761,6,14%
2013-03,הצפון,478,אכסאל,526,225,301,17,509,449,523,0,10%
2013-03,הצפון,529,אעבלין,647,264,383,15,632,533,645,2,12%
2013-03,הצפון,482,בועיינה-נוג'ידאת,416,185,231,5,411,359,407,0,11%
2013-03,הצפון,4001,בוקעאתא,426,168,258,7,419,362,414,4,16%
2013-03,הצפון,998,ביר אל-מכסור,407,145,262,2,405,341,406,6,12%
2013-03,הצפון,480,בית ג'ן,358,124,234,8,350,257,356,0,7%
2013-03,הצפון,9200,בית שאן,792,362,430,19,773,476,788,29,8%
2013-03,הצפון,944,בסמת טבעון,212,103,109,2,210,159,212,0,7%
2013-03,הצפון,483,בענה,407,170,237,1,406,342,406,0,13%
2013-03,הצפון,1292,ג'דיידה-מכר,1533,645,888,7,1526,1347,1523,11,17%
2013-03,הצפון,485,ג'ולס,241,65,176,1,240,165,241,0,9%
2013-03,הצפון,487,ג'ש (גוש חלב),58,28,30,5,53,31,57,1,4%
2013-03,הצפון,489,דבורייה,404,183,221,16,388,303,403,1,10%
2013-03,הצפון,490,דייר אל-אסד,398,161,237,7,391,312,398,2,8%
2013-03,הצפון,492,דייר חנא,668,296,372,12,656,524,668,0,14%
2013-03,הצפון,975,זרזיר,327,145,182,1,326,243,323,3,11%
2013-03,הצפון,496,חורפיש,124,54,70,3,121,66,122,1,5%
2013-03,הצפון,2034,חצור הגלילית,261,113,148,14,247,139,255,4,5%
2013-03,הצפון,6700,טבריה,1841,843,998,96,1745,1158,1691,29,8%
2013-03,הצפון,962,טובא-זנגרייה,366,158,208,4,362,258,361,2,12%
2013-03,הצפון,498,טורעאן,534,210,324,6,528,460,514,2,10%
2013-03,הצפון,8900,טמרה,2042,829,1213,19,2023,1785,2029,1,15%
2013-03,הצפון,1295,יאנוח-ג'ת,156,50,106,3,153,104,155,2,6%
2013-03,הצפון,46,יבנאל,153,103,50,7,146,122,137,1,9%
2013-03,הצפון,499,יפיע,647,291,356,12,635,502,641,0,9%
2013-03,הצפון,240,יקנעם עילית,530,238,292,78,452,180,526,22,5%
2013-03,הצפון,502,ירכא,541,218,323,0,541,432,540,2,10%
2013-03,הצפון,504,כאבול,687,261,426,5,682,600,682,0,14%
2013-03,הצפון,505,כאוכב אבו אל-היג'א,223,104,119,3,220,187,223,1,14%
2013-03,הצפון,1296,כסרא-סמיע,234,99,135,5,229,173,231,3,7%
2013-03,הצפון,978,כעביה-טבאש-חג'אג'רה,206,80,126,2,204,144,206,0,10%
2013-03,הצפון,1263,כפר ורדים,58,24,34,20,38,8,58,0,2%
2013-03,הצפון,507,כפר יאסיף,548,227,321,3,545,443,543,5,11%
2013-03,הצפון,508,כפר כמא,78,34,44,4,74,32,76,0,5%
2013-03,הצפון,509,כפר כנא,1172,446,726,21,1151,1037,1144,1,13%
2013-03,הצפון,510,כפר מנדא,972,432,540,13,959,715,961,0,14%
2013-03,הצפון,47,כפר תבור,46,22,24,14,32,6,46,1,2%
2013-03,הצפון,1139,כרמיאל,1735,700,1035,340,1395,900,1678,33,6%
2013-03,הצפון,481,מגאר,1524,613,911,20,1504,1339,1513,3,17%
2013-03,הצפון,516,מג'ד אל-כרום,572,259,313,3,569,443,571,4,9%
2013-03,הצפון,874,מגדל העמק,955,393,562,77,878,473,927,33,7%
2013-03,הצפון,4201,מג'דל שמס,481,172,309,12,469,408,473,1,10%
2013-03,הצפון,517,מזרעה,188,73,115,4,184,146,187,1,10%
2013-03,הצפון,4203,מסעדה,202,78,124,8,194,161,201,2,12%
2013-03,הצפון,518,מעיליא,44,22,22,2,42,13,44,1,3%
2013-03,הצפון,1063,מעלות-תרשיחא,870,427,443,98,772,534,857,17,7%
2013-03,הצפון,520,משהד,303,115,188,11,292,254,296,0,10%
2013-03,הצפון,9100,נהרייה,1998,929,1069,235,1763,1223,1982,19,6%
2013-03,הצפון,522,נחף,420,187,233,10,410,347,419,3,9%
2013-03,הצפון,7300,נצרת,3131,1391,1740,95,3036,2442,3107,2,9%
2013-03,הצפון,1061,נצרת עילית,1854,836,1018,244,1610,1066,1769,35,7%
2013-03,הצפון,525,סאג'ור,107,41,66,0,107,76,106,2,6%
2013-03,הצפון,7500,סח'נין,2112,932,1180,31,2081,1796,2106,4,16%
2013-03,הצפון,4501,ע'ג'ר,77,36,41,4,73,58,76,0,8%
2013-03,הצפון,530,עיילבון,195,79,116,8,187,149,194,0,7%
2013-03,הצפון,511,עילוט,307,118,189,4,303,248,305,0,11%
2013-03,הצפון,532,עין מאהל,596,274,322,9,587,500,587,2,12%
2013-03,הצפון,7600,עכו,3192,1480,1712,127,3065,2521,3152,35,12%
2013-03,הצפון,7700,עפולה,1579,640,939,182,1397,828,1539,20,6%
2013-03,הצפון,531,עראבה,1474,623,851,25,1449,1303,1470,0,15%
2013-03,הצפון,535,פסוטה,109,50,59,3,106,77,109,0,7%
2013-03,הצפון,536,פקיעין (בוקייעה),146,74,72,6,140,88,145,1,5%
2013-03,הצפון,8000,צפת,1337,719,618,84,1253,1071,1317,9,10%
2013-03,הצפון,4100,קצרין,193,86,107,39,154,80,189,2,5%
2013-03,הצפון,2800,קריית שמונה,677,318,359,50,627,290,653,15,5%
2013-03,הצפון,543,ראמה,313,124,189,9,304,252,308,1,8%
2013-03,הצפון,26,ראש פינה,49,14,35,5,44,17,48,0,3%
2013-03,הצפון,542,ריינה,671,274,397,6,665,552,658,1,10%
2013-03,הצפון,122,רמת ישי,84,33,51,25,59,14,84,0,2%
2013-03,הצפון,913,שבלי - אום אל-גנם,221,96,125,6,215,154,219,2,9%
2013-03,הצפון,812,שלומי,238,96,142,20,218,150,236,0,7%
2013-03,הצפון,538,שעב,524,216,308,7,517,456,523,0,18%
2013-03,הצפון,8800,שפרעם,1997,751,1246,28,1969,1673,1987,6,12%
2013-03,חיפה,2710,אום אל-פחם,3895,1579,2316,21,3874,3355,3886,1,19%
2013-03,חיפה,1020,אור עקיבא,547,245,302,37,510,218,537,13,5%
2013-03,חיפה,6000,באקה אל-גרביה,691,327,364,16,675,461,690,2,6%
2013-03,חיפה,9800,בנימינה-גבעת עדה*,192,79,113,49,143,61,192,1,3%
2013-03,חיפה,1326,"בסמ""ה",439,179,260,1,438,350,438,1,12%
2013-03,חיפה,541,ג'סר א-זרקא,420,236,184,1,419,302,417,0,7%
2013-03,חיפה,628,ג'ת,217,93,124,11,206,141,217,1,4%
2013-03,חיפה,494,דאלית אל-כרמל,530,226,304,6,524,299,527,6,7%
2013-03,חיפה,9300,זכרון יעקב,251,107,144,78,173,54,248,0,2%
2013-03,חיפה,6500,חדרה,2349,955,1394,282,2067,1007,2314,11,5%
2013-03,חיפה,4000,חיפה,6778,3315,3463,1200,5578,3833,6701,38,5%
2013-03,חיפה,1247,חריש,22,9,13,6,16,7,22,0,1%
2013-03,חיפה,2100,טירת כרמל,734,332,402,25,709,433,727,16,7%
2013-03,חיפה,654,כפר קרע,402,176,226,5,397,247,400,1,5%
2013-03,חיפה,1327,מעלה עירון,972,382,590,2,970,803,970,0,17%
2013-03,חיפה,2500,נשר,502,243,259,89,413,204,499,1,4%
2013-03,חיפה,534,עספיא,303,129,174,6,297,186,301,3,6%
2013-03,חיפה,637,ערערה,613,244,369,3,610,422,611,8,8%
2013-03,חיפה,537,פוריידיס,399,212,187,2,397,269,394,0,7%
2013-03,חיפה,7800,פרדס חנה-כרכור,803,363,440,128,675,300,796,9,4%
2013-03,חיפה,6800,קריית אתא,1746,775,971,170,1576,992,1734,16,6%
2013-03,חיפה,9500,קריית ביאליק,1145,477,668,119,1026,611,1136,7,5%
2013-03,חיפה,2300,קריית טבעון,186,93,93,63,123,42,183,1,2%
2013-03,חיפה,9600,קריית ים,1546,712,834,161,1385,984,1536,9,7%
2013-03,חיפה,8200,קריית מוצקין,1096,489,607,158,938,553,1089,9,5%
2013-03,חיפה,922,רכסים,132,65,67,14,118,83,131,1,4%
2013-03,ירושלים,472,אבו גוש,257,119,138,7,250,193,256,1,9%
2013-03,ירושלים,2610,בית שמש,1239,565,674,87,1152,587,1208,49,4%
2013-03,ירושלים,3000,ירושלים,10904,4878,6026,1209,9695,6817,10816,34,4%
2013-03,ירושלים,1015,מבשרת ציון,373,167,206,62,311,171,371,1,3%
2013-03,ירושלים,1137,קריית יערים,35,17,18,5,30,15,35,0,3%
2013-03,תל אביב,2400,אור יהודה,829,368,461,42,787,265,812,19,4%
2013-03,תל אביב,565,אזור,182,89,93,23,159,27,181,3,3%
2013-03,תל אביב,6100,בני ברק,2375,1179,1196,111,2264,1410,2347,10,4%
2013-03,תל אביב,6200,בת ים,3399,1641,1758,431,2968,1297,3321,43,5%
2013-03,תל אביב,6300,גבעתיים,774,348,426,299,475,104,767,0,3%
2013-03,תל אביב,6400,הרצלייה,1039,474,565,290,749,56,1022,3,2%
2013-03,תל אביב,6600,חולון,3356,1596,1760,501,2855,876,3297,21,3%
2013-03,תל אביב,2620,קריית אונו,413,182,231,137,276,48,410,1,2%
2013-03,תל אביב,8600,רמת גן,2160,1014,1146,643,1517,477,2129,9,3%
2013-03,תל אביב,2650,רמת השרון,406,160,246,143,263,9,405,0,2%
2013-03,תל אביב,5000,תל אביב -יפו,7965,3983,3982,2314,5651,2636,7848,49,3%
2013-04,אזור יהודה והשומרון,3760,אורנית,96,48,48,31,65,4,96,0,2%
2013-04,אזור יהודה והשומרון,3750,אלפי מנשה,128,53,75,39,89,2,125,3,3%
2013-04,אזור יהודה והשומרון,3560,אלקנה,33,16,17,12,21,1,32,0,2%
2013-04,אזור יהודה והשומרון,3650,אפרת,47,24,23,17,30,6,47,1,1%
2013-04,אזור יהודה והשומרון,3570,אריאל,405,191,214,71,334,106,402,11,4%
2013-04,אזור יהודה והשומרון,3574,בית אל,56,28,28,15,41,21,55,1,2%
2013-04,אזור יהודה והשומרון,3652,בית אריה,51,20,31,9,42,2,51,0,2%
2013-04,אזור יהודה והשומרון,3780,ביתר עילית,441,218,223,14,427,195,435,16,4%
2013-04,אזור יהודה והשומרון,3730,גבעת זאב,174,85,89,25,149,43,173,6,2%
2013-04,אזור יהודה והשומרון,3769,הר אדר,22,9,13,13,9,2,22,0,1%
2013-04,אזור יהודה והשומרון,3797,מודיעין עילית,372,140,232,15,357,115,364,6,3%
2013-04,אזור יהודה והשומרון,3616,מעלה אדומים,636,258,378,87,549,199,626,7,3%
2013-04,אזור יהודה והשומרון,3660,עמנואל,74,34,40,4,70,53,74,0,7%
2013-04,אזור יהודה והשומרון,3557,קדומים,40,22,18,10,30,9,40,0,2%
2013-04,אזור יהודה והשומרון,3611,קריית ארבע,110,53,57,20,90,66,110,3,4%
2013-04,אזור יהודה והשומרון,3640,קרני שומרון,76,34,42,16,60,12,75,2,2%
2013-04,הדרום,31,אופקים,1330,599,731,90,1240,944,1316,5,10%
2013-04,הדרום,2600,אילת,1428,647,781,65,1363,606,1401,18,4%
2013-04,הדרום,70,אשדוד,7026,2862,4164,751,6275,3762,6958,84,6%
2013-04,הדרום,7100,אשקלון,4506,1780,2726,614,3892,2623,4381,52,7%
2013-04,הדרום,9000,באר שבע,7371,3274,4097,940,6431,4556,7259,108,7%
2013-04,הדרום,2200,דימונה,2241,962,1279,127,2114,1507,2198,32,12%
2013-04,הדרום,1303,חורה,774,321,453,1,773,722,773,1,20%
2013-04,הדרום,831,ירוחם,436,205,231,25,411,273,427,19,10%
2013-04,הדרום,1059,כסיפה,995,412,583,1,994,902,993,2,22%
2013-04,הדרום,1271,להבים,47,15,32,26,21,5,47,0,1%
2013-04,הדרום,1060,לקיה,995,442,553,1,994,932,991,3,25%
2013-04,הדרום,1268,מיתר,66,30,36,22,44,8,66,2,2%
2013-04,הדרום,99,מצפה רמון,259,100,159,15,244,157,248,8,10%
2013-04,הדרום,246,נתיבות,1126,500,626,57,1069,554,1098,26,8%
2013-04,הדרום,666,עומר,58,32,26,21,37,4,57,0,1%
2013-04,הדרום,2560,ערד,765,350,415,121,644,459,733,14,6%
2013-04,הדרום,1192,ערערה-בנגב,1014,398,616,2,1012,926,1011,1,25%
2013-04,הדרום,2630,קריית גת,2321,961,1360,163,2158,1476,2293,21,8%
2013-04,הדרום,1034,קריית מלאכי,1295,577,718,29,1266,799,1258,42,11%
2013-04,הדרום,1161,רהט,3200,1353,1847,7,3193,2828,3185,6,18%
2013-04,הדרום,1286,שגב-שלום,514,198,316,1,513,451,513,0,21%
2013-04,הדרום,1031,שדרות,1180,504,676,47,1133,715,1168,13,9%
2013-04,הדרום,1054,תל שבע,1175,550,625,2,1173,1101,1166,1,25%
2013-04,המרכז,182,אבן יהודה,171,76,95,59,112,20,170,2,3%
2013-04,המרכז,41,אליכין,63,34,29,5,58,19,63,1,3%
2013-04,המרכז,1309,אלעד,455,205,250,23,432,130,452,1,4%
2013-04,המרכז,2530,באר יעקב,252,111,141,45,207,61,247,1,3%
2013-04,המרכז,466,בית דגן,129,62,67,24,105,43,128,0,4%
2013-04,המרכז,1066,"בני עי""ש",197,92,105,25,172,71,196,7,5%
2013-04,המרכז,681,גבעת שמואל,321,173,148,131,190,68,321,0,3%
2013-04,המרכז,2550,גדרה,360,158,202,56,304,108,353,5,3%
2013-04,המרכז,627,ג'לג'וליה,99,47,52,1,98,52,98,2,3%
2013-04,המרכז,166,גן יבנה,391,152,239,35,356,109,386,2,4%
2013-04,המרכז,229,גני תקווה,179,84,95,63,116,26,177,0,2%
2013-04,המרכז,9700,הוד השרון,695,340,355,215,480,68,689,3,2%
2013-04,המרכז,1290,זמר,178,60,118,5,173,130,177,3,6%
2013-04,המרכז,2730,טייבה,2238,965,1273,11,2227,1899,2216,9,13%
2013-04,המרכז,2720,טירה,336,154,182,6,330,172,329,6,3%
2013-04,המרכז,2660,יבנה,918,435,483,84,834,375,911,36,4%
2013-04,המרכז,9400,יהוד,523,227,296,74,449,77,509,12,3%
2013-04,המרכז,1224,כוכב יאיר,123,55,68,56,67,1,123,0,2%
2013-04,המרכז,633,כפר ברא,36,22,14,2,34,15,36,0,3%
2013-04,המרכז,168,כפר יונה,309,129,180,66,243,72,306,3,3%
2013-04,המרכז,6900,כפר סבא,1356,573,783,397,959,207,1342,13,3%
2013-04,המרכז,634,כפר קאסם,287,146,141,4,283,155,282,3,3%
2013-04,המרכז,7000,לוד,2331,1066,1265,139,2192,1277,2305,35,7%
2013-04,המרכז,1200,מודיעין-מכבים-רעות*,1026,444,582,316,710,54,1017,11,2%
2013-04,המרכז,28,מזכרת בתיה,164,72,92,32,132,31,160,7,2%
2013-04,המרכז,7200,נס ציונה,691,321,370,150,541,208,680,4,3%
2013-04,המרכז,7400,נתניה,4593,2125,2468,604,3989,1691,4509,32,4%
2013-04,המרכז,587,סביון*,12,8,4,4,8,1,12,0,1%
2013-04,המרכז,171,פרדסייה,74,33,41,21,53,6,74,1,2%
2013-04,המרכז,7900,פתח תקווה,4244,1919,2325,879,3365,1112,4200,53,3%
2013-04,המרכז,195,קדימה-צורן,274,120,154,74,200,39,272,0,3%
2013-04,המרכז,638,קלנסווה,920,368,552,3,917,784,908,11,11%
2013-04,המרכז,469,קריית עקרון,310,155,155,21,289,136,307,5,5%
2013-04,המרכז,2640,ראש העין,803,411,392,72,731,162,790,10,4%
2013-04,המרכז,8300,ראשון לציון,4760,2137,2623,929,3831,1534,4732,95,3%
2013-04,המרכז,8400,רחובות,2651,1214,1437,540,2111,1041,2603,32,4%
2013-04,המרכז,8500,רמלה,1905,887,1018,112,1793,841,1863,43,5%
2013-04,המרכז,8700,רעננה,858,410,448,299,559,96,852,3,2%
2013-04,המרכז,1304,שוהם,192,87,105,75,117,6,191,0,2%
2013-04,המרכז,154,תל מונד,137,69,68,36,101,25,137,0,2%
2013-04,הצפון,473,אבו סנאן,761,298,463,4,757,644,755,10,13%
2013-04,הצפון,478,אכסאל,534,231,303,15,519,461,530,2,10%
2013-04,הצפון,529,אעבלין,642,267,375,13,629,535,638,1,12%
2013-04,הצפון,482,בועיינה-נוג'ידאת,421,181,240,2,419,355,414,8,11%
2013-04,הצפון,4001,בוקעאתא,424,166,258,7,417,358,407,5,15%
2013-04,הצפון,998,ביר אל-מכסור,421,148,273,2,419,340,419,10,12%
2013-04,הצפון,480,בית ג'ן,380,115,265,8,372,274,371,1,7%
2013-04,הצפון,9200,בית שאן,902,396,506,17,885,483,886,98,9%
2013-04,הצפון,944,בסמת טבעון,218,99,119,2,216,159,217,1,7%
2013-04,הצפון,483,בענה,415,171,244,1,414,347,415,4,13%
2013-04,הצפון,1292,ג'דיידה-מכר,1521,631,890,7,1514,1342,1511,19,17%
2013-04,הצפון,485,ג'ולס,243,64,179,3,240,166,242,0,9%
2013-04,הצפון,487,ג'ש (גוש חלב),63,29,34,5,58,30,62,0,4%
2013-04,הצפון,489,דבורייה,428,194,234,15,413,314,426,3,10%
2013-04,הצפון,490,דייר אל-אסד,399,163,236,5,394,313,399,4,8%
2013-04,הצפון,492,דייר חנא,656,283,373,11,645,511,656,3,14%
2013-04,הצפון,975,זרזיר,331,150,181,5,326,244,327,4,11%
2013-04,הצפון,496,חורפיש,133,55,78,4,129,65,131,1,5%
2013-04,הצפון,2034,חצור הגלילית,286,132,154,11,275,144,274,2,6%
2013-04,הצפון,6700,טבריה,1882,845,1037,88,1794,1164,1708,54,8%
2013-04,הצפון,962,טובא-זנגרייה,393,154,239,3,390,262,385,2,13%
2013-04,הצפון,498,טורעאן,539,209,330,7,532,461,523,5,10%
2013-04,הצפון,8900,טמרה,2064,840,1224,20,2044,1803,2054,6,15%
2013-04,הצפון,1295,יאנוח-ג'ת,166,54,112,3,163,106,165,3,6%
2013-04,הצפון,46,יבנאל,155,108,47,7,148,123,138,0,9%
2013-04,הצפון,499,יפיע,677,303,374,12,665,520,670,5,9%
2013-04,הצפון,240,יקנעם עילית,522,236,286,75,447,165,518,27,5%
2013-04,הצפון,502,ירכא,567,231,336,0,567,440,565,0,10%
2013-04,הצפון,504,כאבול,681,257,424,5,676,600,679,1,14%
2013-04,הצפון,505,כאוכב אבו אל-היג'א,216,97,119,3,213,183,216,1,13%
2013-04,הצפון,1296,כסרא-סמיע,214,92,122,2,212,155,212,3,7%
2013-04,הצפון,978,כעביה-טבאש-חג'אג'רה,208,79,129,2,206,141,207,1,10%
2013-04,הצפון,1263,כפר ורדים,64,30,34,19,45,9,63,0,2%
2013-04,הצפון,507,כפר יאסיף,558,223,335,4,554,447,552,6,11%
2013-04,הצפון,508,כפר כמא,66,28,38,3,63,31,64,0,4%
2013-04,הצפון,509,כפר כנא,1192,448,744,18,1174,1041,1166,7,14%
2013-04,הצפון,510,כפר מנדא,997,448,549,13,984,743,976,4,14%
2013-04,הצפון,47,כפר תבור,46,24,22,11,35,6,46,0,2%
2013-04,הצפון,1139,כרמיאל,1758,713,1045,315,1443,887,1685,27,7%
2013-04,הצפון,481,מגאר,1536,607,929,16,1520,1347,1520,11,17%
2013-04,הצפון,516,מג'ד אל-כרום,591,272,319,5,586,453,589,5,9%
2013-04,הצפון,874,מגדל העמק,1047,434,613,69,978,483,1000,45,7%
2013-04,הצפון,4201,מג'דל שמס,473,165,308,14,459,407,465,3,10%
2013-04,הצפון,517,מזרעה,182,72,110,5,177,142,181,1,9%
2013-04,הצפון,4203,מסעדה,206,77,129,8,198,166,204,1,12%
2013-04,הצפון,518,מעיליא,52,30,22,2,50,17,52,0,3%
2013-04,הצפון,1063,מעלות-תרשיחא,872,425,447,91,781,531,860,25,7%
2013-04,הצפון,520,משהד,296,107,189,8,288,250,292,4,9%
2013-04,הצפון,9100,נהרייה,2056,935,1121,232,1824,1240,2037,34,7%
2013-04,הצפון,522,נחף,420,193,227,11,409,340,419,1,9%
2013-04,הצפון,7300,נצרת,3241,1424,1817,83,3158,2531,3199,10,10%
2013-04,הצפון,1061,נצרת עילית,1957,867,1090,238,1719,1102,1838,66,8%
2013-04,הצפון,525,סאג'ור,115,38,77,0,115,78,114,0,7%
2013-04,הצפון,7500,סח'נין,2098,924,1174,29,2069,1766,2094,4,16%
2013-04,הצפון,4501,ע'ג'ר,83,38,45,4,79,56,83,0,8%
2013-04,הצפון,530,עיילבון,205,84,121,9,196,155,201,1,8%
2013-04,הצפון,511,עילוט,313,122,191,3,310,252,313,2,12%
2013-04,הצפון,532,עין מאהל,602,276,326,9,593,502,591,0,12%
2013-04,הצפון,7600,עכו,3295,1538,1757,121,3174,2525,3257,54,12%
2013-04,הצפון,7700,עפולה,1794,714,1080,187,1607,881,1716,58,7%
2013-04,הצפון,531,עראבה,1448,602,846,21,1427,1291,1447,1,15%
2013-04,הצפון,535,פסוטה,115,49,66,3,112,84,115,1,7%
2013-04,הצפון,536,פקיעין (בוקייעה),147,76,71,5,142,92,144,1,5%
2013-04,הצפון,8000,צפת,1383,740,643,77,1306,1104,1362,13,10%
2013-04,הצפון,4100,קצרין,184,81,103,33,151,80,181,7,5%
2013-04,הצפון,2800,קריית שמונה,750,349,401,52,698,322,721,12,6%
2013-04,הצפון,543,ראמה,319,128,191,7,312,251,313,0,8%
2013-04,הצפון,26,ראש פינה,49,12,37,7,42,19,48,1,3%
2013-04,הצפון,542,ריינה,667,267,400,6,661,553,660,0,10%
2013-04,הצפון,122,רמת ישי,100,41,59,24,76,16,98,1,2%
2013-04,הצפון,913,שבלי - אום אל-גנם,217,91,126,4,213,159,214,2,9%
2013-04,הצפון,812,שלומי,276,110,166,20,256,160,274,2,8%
2013-04,הצפון,538,שעב,525,220,305,7,518,451,525,1,18%
2013-04,הצפון,8800,שפרעם,2042,779,1263,35,2007,1695,2035,12,12%
2013-04,חיפה,2710,אום אל-פחם,3931,1596,2335,22,3909,3368,3920,0,19%
2013-04,חיפה,1020,אור עקיבא,578,254,324,39,539,230,563,11,6%
2013-04,חיפה,6000,באקה אל-גרביה,717,345,372,17,700,460,714,13,6%
2013-04,חיפה,9800,בנימינה-גבעת עדה*,217,93,124,47,170,62,215,2,3%
2013-04,חיפה,1326,"בסמ""ה",440,183,257,2,438,346,439,4,12%
2013-04,חיפה,541,ג'סר א-זרקא,435,243,192,1,434,299,432,1,8%
2013-04,חיפה,628,ג'ת,222,90,132,10,212,146,221,1,5%
2013-04,חיפה,494,דאלית אל-כרמל,531,225,306,9,522,299,522,4,7%
2013-04,חיפה,9300,זכרון יעקב,259,108,151,81,178,53,255,0,2%
2013-04,חיפה,6500,חדרה,2471,1005,1466,272,2199,1004,2436,25,5%
2013-04,חיפה,4000,חיפה,7007,3401,3606,1230,5777,3889,6907,81,5%
2013-04,חיפה,1247,חריש,26,12,14,7,19,8,25,0,2%
2013-04,חיפה,2100,טירת כרמל,781,357,424,27,754,468,774,20,7%
2013-04,חיפה,654,כפר קרע,431,195,236,5,426,251,429,7,5%
2013-04,חיפה,1327,מעלה עירון,982,389,593,2,980,810,977,0,17%
2013-04,חיפה,2500,נשר,503,251,252,85,418,210,500,3,4%
2013-04,חיפה,534,עספיא,319,142,177,8,311,183,314,2,6%
2013-04,חיפה,637,ערערה,601,232,369,3,598,411,599,6,8%
2013-04,חיפה,537,פוריידיס,402,216,186,2,400,271,397,0,7%
2013-04,חיפה,7800,פרדס חנה-כרכור,871,404,467,129,742,286,862,19,4%
2013-04,חיפה,6800,קריית אתא,1786,816,970,157,1629,990,1775,35,6%
2013-04,חיפה,9500,קריית ביאליק,1186,485,701,119,1067,617,1175,15,5%
2013-04,חיפה,2300,קריית טבעון,190,93,97,67,123,39,187,1,2%
2013-04,חיפה,9600,קריית ים,1636,758,878,162,1474,1010,1624,28,8%
2013-04,חיפה,8200,קריית מוצקין,1106,481,625,150,956,555,1097,18,5%
2013-04,חיפה,922,רכסים,131,70,61,12,119,74,130,0,4%
2013-04,ירושלים,472,אבו גוש,244,121,123,7,237,187,243,2,8%
2013-04,ירושלים,2610,בית שמש,1303,603,700,81,1222,606,1275,37,4%
2013-04,ירושלים,3000,ירושלים,11487,5199,6288,1217,10270,7003,11339,146,4%
2013-04,ירושלים,1015,מבשרת ציון,399,187,212,60,339,177,396,1,3%
2013-04,ירושלים,1137,קריית יערים,35,16,19,6,29,16,34,0,3%
2013-04,תל אביב,2400,אור יהודה,889,408,481,44,845,282,865,32,5%
2013-04,תל אביב,565,אזור,183,96,87,20,163,26,182,5,3%
2013-04,תל אביב,6100,בני ברק,2513,1238,1275,107,2406,1445,2479,12,5%
2013-04,תל אביב,6200,בת ים,3489,1692,1797,451,3038,1293,3405,71,5%
2013-04,תל אביב,6300,גבעתיים,809,365,444,303,506,114,800,6,3%
2013-04,תל אביב,6400,הרצלייה,1088,501,587,267,821,58,1072,14,2%
2013-04,תל אביב,6600,חולון,3448,1630,1818,509,2939,882,3385,46,3%
2013-04,תל אביב,2620,קריית אונו,453,203,250,148,305,52,447,4,2%
2013-04,תל אביב,8600,רמת גן,2214,1036,1178,643,1571,473,2185,11,3%
2013-04,תל אביב,2650,רמת השרון,431,171,260,139,292,13,429,3,2%
2013-04,תל אביב,5000,תל אביב -יפו,8239,4142,4097,2412,5827,2654,8118,72,3%
2013-05,אזור יהודה והשומרון,3760,אורנית,88,38,50,29,59,4,88,0,2%
2013-05,אזור יהודה והשומרון,3750,אלפי מנשה,121,52,69,30,91,4,119,2,3%
2013-05,אזור יהודה והשומרון,3560,אלקנה,32,14,18,12,20,1,32,0,2%
2013-05,אזור יהודה והשומרון,3650,אפרת,39,20,19,11,28,6,39,1,1%
2013-05,אזור יהודה והשומרון,3570,אריאל,369,173,196,58,311,101,362,5,3%
2013-05,אזור יהודה והשומרון,3574,בית אל,58,28,30,15,43,20,58,0,2%
2013-05,אזור יהודה והשומרון,3652,בית אריה,57,24,33,8,49,3,57,0,2%
2013-05,אזור יהודה והשומרון,3780,ביתר עילית,423,208,215,13,410,192,418,25,4%
2013-05,אזור יהודה והשומרון,3730,גבעת זאב,191,91,100,21,170,43,191,5,3%
2013-05,אזור יהודה והשומרון,3769,הר אדר,18,8,10,9,9,2,18,0,1%
2013-05,אזור יהודה והשומרון,3797,מודיעין עילית,359,130,229,9,350,105,348,7,3%
2013-05,אזור יהודה והשומרון,3616,מעלה אדומים,670,285,385,79,591,198,661,11,3%
2013-05,אזור יהודה והשומרון,3660,עמנואל,76,35,41,1,75,52,76,1,7%
2013-05,אזור יהודה והשומרון,3557,קדומים,41,21,20,10,31,9,41,0,2%
2013-05,אזור יהודה והשומרון,3611,קריית ארבע,117,59,58,18,99,66,117,3,4%
2013-05,אזור יהודה והשומרון,3640,קרני שומרון,73,36,37,16,57,9,72,1,2%
2013-05,הדרום,31,אופקים,1344,597,747,84,1260,935,1332,30,11%
2013-05,הדרום,2600,אילת,1447,665,782,64,1383,593,1427,33,4%
2013-05,הדרום,70,אשדוד,7156,2926,4230,774,6382,3763,7080,150,7%
2013-05,הדרום,7100,אשקלון,4646,1852,2794,571,4075,2610,4496,65,7%
2013-05,הדרום,9000,באר שבע,7327,3241,4086,906,6421,4548,7198,210,7%
2013-05,הדרום,2200,דימונה,2150,941,1209,117,2033,1466,2097,68,11%
2013-05,הדרום,1303,חורה,787,321,466,1,786,732,784,3,20%
2013-05,הדרום,831,ירוחם,422,202,220,18,404,271,407,31,9%
2013-05,הדרום,1059,כסיפה,994,420,574,1,993,902,990,13,22%
2013-05,הדרום,1271,להבים,47,18,29,22,25,5,47,0,1%
2013-05,הדרום,1060,לקיה,973,432,541,1,972,912,972,1,24%
2013-05,הדרום,1268,מיתר,74,33,41,25,49,8,74,2,2%
2013-05,הדרום,99,מצפה רמון,267,108,159,15,252,159,246,13,10%
2013-05,הדרום,246,נתיבות,1090,479,611,50,1040,546,1063,104,8%
2013-05,הדרום,666,עומר,65,36,29,25,40,6,63,0,2%
2013-05,הדרום,2560,ערד,775,354,421,104,671,461,746,48,6%
2013-05,הדרום,1192,ערערה-בנגב,1015,400,615,2,1013,936,1010,13,25%
2013-05,הדרום,2630,קריית גת,2293,960,1333,150,2143,1443,2274,56,8%
2013-05,הדרום,1034,קריית מלאכי,1300,588,712,24,1276,790,1265,42,11%
2013-05,הדרום,1161,רהט,3216,1349,1867,6,3210,2804,3200,26,18%
2013-05,הדרום,1286,שגב-שלום,518,189,329,1,517,457,517,0,21%
2013-05,הדרום,1031,שדרות,1122,475,647,42,1080,712,1105,15,9%
2013-05,הדרום,1054,תל שבע,1168,552,616,1,1167,1098,1159,6,25%
2013-05,המרכז,182,אבן יהודה,161,72,89,58,103,19,160,0,2%
2013-05,המרכז,41,אליכין,63,34,29,5,58,18,62,0,3%
2013-05,המרכז,1309,אלעד,463,200,263,26,437,129,459,3,4%
2013-05,המרכז,2530,באר יעקב,266,113,153,49,217,62,265,2,3%
2013-05,המרכז,466,בית דגן,119,62,57,26,93,42,119,5,3%
2013-05,המרכז,1066,"בני עי""ש",208,101,107,27,181,67,208,1,5%
2013-05,המרכז,681,גבעת שמואל,392,196,196,126,266,66,392,2,3%
2013-05,המרכז,2550,גדרה,381,169,212,59,322,110,374,6,3%
2013-05,המרכז,627,ג'לג'וליה,103,50,53,2,101,52,100,1,3%
2013-05,המרכז,166,גן יבנה,406,159,247,36,370,103,404,5,4%
2013-05,המרכז,229,גני תקווה,203,101,102,64,139,29,202,0,3%
2013-05,המרכז,9700,הוד השרון,682,323,359,208,474,57,674,3,2%
2013-05,המרכז,1290,זמר,178,57,121,4,174,132,177,3,6%
2013-05,המרכז,2730,טייבה,2212,953,1259,8,2204,1858,2191,20,13%
2013-05,המרכז,2720,טירה,347,162,185,8,339,165,343,8,3%
2013-05,המרכז,2660,יבנה,923,440,483,93,830,373,913,21,4%
2013-05,המרכז,9400,יהוד,554,237,317,82,472,78,539,8,3%
2013-05,המרכז,1224,כוכב יאיר,132,63,69,60,72,2,132,0,2%
2013-05,המרכז,633,כפר ברא,34,20,14,2,32,13,34,1,3%
2013-05,המרכז,168,כפר יונה,325,133,192,64,261,81,320,5,3%
2013-05,המרכז,6900,כפר סבא,1367,623,744,382,985,191,1351,16,3%
2013-05,המרכז,634,כפר קאסם,262,133,129,6,256,156,258,3,3%
2013-05,המרכז,7000,לוד,2290,1066,1224,138,2152,1202,2262,45,6%
2013-05,המרכז,1200,מודיעין-מכבים-רעות*,1467,696,771,285,1182,54,1456,10,3%
2013-05,המרכז,28,מזכרת בתיה,164,73,91,29,135,35,161,2,2%
2013-05,המרכז,7200,נס ציונה,726,335,391,162,564,204,722,8,3%
2013-05,המרכז,7400,נתניה,4630,2135,2495,601,4029,1680,4527,54,4%
2013-05,המרכז,587,סביון*,17,8,9,7,10,1,17,0,1%
2013-05,המרכז,171,פרדסייה,77,33,44,20,57,7,77,0,2%
2013-05,המרכז,7900,פתח תקווה,4311,1976,2335,884,3427,1117,4274,57,4%
2013-05,המרכז,195,קדימה-צורן,259,109,150,71,188,41,257,0,3%
2013-05,המרכז,638,קלנסווה,897,354,543,4,893,767,890,10,11%
2013-05,המרכז,469,קריית עקרון,305,155,150,18,287,135,302,7,5%
2013-05,המרכז,2640,ראש העין,800,395,405,83,717,162,787,16,4%
2013-05,המרכז,8300,ראשון לציון,5066,2278,2788,932,4134,1491,5044,118,4%
2013-05,המרכז,8400,רחובות,2650,1227,1423,535,2115,1048,2598,46,4%
2013-05,המרכז,8500,רמלה,1908,909,999,105,1803,840,1854,42,5%
2013-05,המרכז,8700,רעננה,861,402,459,305,556,97,857,5,2%
2013-05,המרכז,1304,שוהם,199,93,106,74,125,6,197,0,2%
2013-05,המרכז,154,תל מונד,153,71,82,35,118,25,152,0,3%
2013-05,הצפון,473,אבו סנאן,765,288,477,3,762,647,757,14,13%
2013-05,הצפון,478,אכסאל,532,232,300,12,520,455,524,0,10%
2013-05,הצפון,529,אעבלין,637,259,378,11,626,530,635,4,12%
2013-05,הצפון,482,בועיינה-נוג'ידאת,412,161,251,2,410,351,408,0,11%
2013-05,הצפון,4001,בוקעאתא,415,160,255,7,408,349,404,0,15%
2013-05,הצפון,998,ביר אל-מכסור,416,144,272,2,414,339,415,1,12%
2013-05,הצפון,480,בית ג'ן,389,118,271,8,381,275,378,2,7%
2013-05,הצפון,9200,בית שאן,827,355,472,14,813,445,817,95,8%
2013-05,הצפון,944,בסמת טבעון,232,106,126,1,231,170,228,1,7%
2013-05,הצפון,483,בענה,410,168,242,1,409,345,408,8,13%
2013-05,הצפון,1292,ג'דיידה-מכר,1492,622,870,7,1485,1318,1479,43,17%
2013-05,הצפון,485,ג'ולס,237,63,174,2,235,170,236,6,9%
2013-05,הצפון,487,ג'ש (גוש חלב),67,33,34,4,63,32,66,0,4%
2013-05,הצפון,489,דבורייה,432,194,238,14,418,317,430,5,10%
2013-05,הצפון,490,דייר אל-אסד,396,163,233,5,391,311,396,10,8%
2013-05,הצפון,492,דייר חנא,654,278,376,9,645,508,654,4,14%
2013-05,הצפון,975,זרזיר,325,145,180,6,319,241,318,5,11%
2013-05,הצפון,496,חורפיש,132,56,76,3,129,66,132,2,5%
2013-05,הצפון,2034,חצור הגלילית,276,121,155,8,268,147,263,2,6%
2013-05,הצפון,6700,טבריה,1873,832,1041,84,1789,1143,1721,63,8%
2013-05,הצפון,962,טובא-זנגרייה,396,146,250,2,394,249,388,4,13%
2013-05,הצפון,498,טורעאן,579,233,346,7,572,472,560,5,10%
2013-05,הצפון,8900,טמרה,2046,832,1214,16,2030,1799,2032,12,15%
2013-05,הצפון,1295,יאנוח-ג'ת,157,50,107,3,154,101,157,6,6%
2013-05,הצפון,46,יבנאל,156,102,54,8,148,123,138,2,9%
2013-05,הצפון,499,יפיע,650,287,363,9,641,510,640,4,9%
2013-05,הצפון,240,יקנעם עילית,563,252,311,71,492,177,559,23,5%
2013-05,הצפון,502,ירכא,565,220,345,0,565,447,563,7,10%
2013-05,הצפון,504,כאבול,665,249,416,5,660,585,660,2,14%
2013-05,הצפון,505,כאוכב אבו אל-היג'א,221,98,123,2,219,187,221,0,13%
2013-05,הצפון,1296,כסרא-סמיע,216,85,131,2,214,153,213,1,7%
2013-05,הצפון,978,כעביה-טבאש-חג'אג'רה,190,69,121,1,189,136,189,0,9%
2013-05,הצפון,1263,כפר ורדים,59,28,31,18,41,9,58,1,2%
2013-05,הצפון,507,כפר יאסיף,544,215,329,3,541,437,536,10,11%
2013-05,הצפון,508,כפר כמא,67,30,37,3,64,33,66,0,4%
2013-05,הצפון,509,כפר כנא,1207,467,740,17,1190,1059,1180,11,14%
2013-05,הצפון,510,כפר מנדא,998,440,558,14,984,736,975,17,14%
2013-05,הצפון,47,כפר תבור,41,21,20,8,33,4,41,0,2%
2013-05,הצפון,1139,כרמיאל,1819,761,1058,334,1485,899,1751,51,7%
2013-05,הצפון,481,מגאר,1500,567,933,14,1486,1324,1483,12,17%
2013-05,הצפון,516,מג'ד אל-כרום,574,259,315,5,569,446,574,10,9%
2013-05,הצפון,874,מגדל העמק,1065,447,618,74,991,497,992,54,7%
2013-05,הצפון,4201,מג'דל שמס,459,159,300,11,448,394,454,3,10%
2013-05,הצפון,517,מזרעה,179,65,114,4,175,137,178,2,9%
2013-05,הצפון,4203,מסעדה,206,74,132,7,199,166,205,0,12%
2013-05,הצפון,518,מעיליא,51,27,24,4,47,16,50,0,3%
2013-05,הצפון,1063,מעלות-תרשיחא,866,424,442,90,776,538,851,34,7%
2013-05,הצפון,520,משהד,294,106,188,6,288,250,287,3,9%
2013-05,הצפון,9100,נהרייה,2060,928,1132,220,1840,1245,2037,57,7%
2013-05,הצפון,522,נחף,430,193,237,9,421,347,428,9,9%
2013-05,הצפון,7300,נצרת,3230,1405,1825,88,3142,2521,3178,18,10%
2013-05,הצפון,1061,נצרת עילית,1936,860,1076,212,1724,1092,1808,81,8%
2013-05,הצפון,525,סאג'ור,108,41,67,0,108,69,108,0,6%
2013-05,הצפון,7500,סח'נין,2074,906,1168,29,2045,1774,2068,15,15%
2013-05,הצפון,4501,ע'ג'ר,84,36,48,1,83,59,81,1,8%
2013-05,הצפון,530,עיילבון,196,77,119,9,187,150,192,3,7%
2013-05,הצפון,511,עילוט,319,123,196,4,315,259,314,1,12%
2013-05,הצפון,532,עין מאהל,590,271,319,11,579,486,578,5,12%
2013-05,הצפון,7600,עכו,3264,1512,1752,110,3154,2497,3219,47,12%
2013-05,הצפון,7700,עפולה,1750,695,1055,187,1563,843,1684,64,7%
2013-05,הצפון,531,עראבה,1456,615,841,21,1435,1300,1453,7,15%
2013-05,הצפון,535,פסוטה,109,44,65,3,106,82,109,0,7%
2013-05,הצפון,536,פקיעין (בוקייעה),142,73,69,6,136,86,139,3,5%
2013-05,הצפון,8000,צפת,1403,754,649,68,1335,1106,1377,12,10%
2013-05,הצפון,4100,קצרין,183,85,98,32,151,75,182,6,5%
2013-05,הצפון,2800,קריית שמונה,771,348,423,48,723,324,743,22,6%
2013-05,הצפון,543,ראמה,317,118,199,4,313,252,315,0,8%
2013-05,הצפון,26,ראש פינה,56,17,39,9,47,19,54,0,3%
2013-05,הצפון,542,ריינה,663,263,400,4,659,555,651,3,10%
2013-05,הצפון,122,רמת ישי,105,40,65,25,80,18,103,1,3%
2013-05,הצפון,913,שבלי - אום אל-גנם,219,95,124,3,216,161,216,2,9%
2013-05,הצפון,812,שלומי,259,105,154,17,242,147,255,6,7%
2013-05,הצפון,538,שעב,518,215,303,7,511,449,518,3,18%
2013-05,הצפון,8800,שפרעם,2013,762,1251,33,1980,1672,2003,32,12%
2013-05,חיפה,2710,אום אל-פחם,3879,1572,2307,17,3862,3347,3856,2,19%
2013-05,חיפה,1020,אור עקיבא,589,260,329,35,554,227,566,12,6%
2013-05,חיפה,6000,באקה אל-גרביה,708,327,381,11,697,459,706,19,6%
2013-05,חיפה,9800,בנימינה-גבעת עדה*,230,102,128,39,191,65,228,4,3%
2013-05,חיפה,1326,"בסמ""ה",428,179,249,3,425,342,426,2,11%
2013-05,חיפה,541,ג'סר א-זרקא,473,260,213,0,473,302,468,3,8%
2013-05,חיפה,628,ג'ת,221,97,124,10,211,143,221,4,5%
2013-05,חיפה,494,דאלית אל-כרמל,533,220,313,10,523,292,524,4,7%
2013-05,חיפה,9300,זכרון יעקב,262,110,152,72,190,50,259,1,2%
2013-05,חיפה,6500,חדרה,2484,1035,1449,274,2210,973,2432,27,5%
2013-05,חיפה,4000,חיפה,6950,3345,3605,1195,5755,3855,6839,127,5%
2013-05,חיפה,1247,חריש,26,13,13,5,21,7,26,0,2%
2013-05,חיפה,2100,טירת כרמל,768,352,416,24,744,464,759,25,7%
2013-05,חיפה,654,כפר קרע,432,199,233,4,428,248,430,8,5%
2013-05,חיפה,1327,מעלה עירון,983,391,592,4,979,801,977,0,17%
2013-05,חיפה,2500,נשר,521,269,252,94,427,211,516,14,4%
2013-05,חיפה,534,עספיא,330,147,183,10,320,179,321,4,6%
2013-05,חיפה,637,ערערה,615,234,381,4,611,411,609,18,8%
2013-05,חיפה,537,פוריידיס,388,202,186,1,387,263,385,1,7%
2013-05,חיפה,7800,פרדס חנה-כרכור,856,382,474,121,735,287,849,35,4%
2013-05,חיפה,6800,קריית אתא,1862,836,1026,158,1704,1002,1838,52,6%
2013-05,חיפה,9500,קריית ביאליק,1192,496,696,121,1071,624,1185,32,5%
2013-05,חיפה,2300,קריית טבעון,193,86,107,61,132,44,190,1,2%
2013-05,חיפה,9600,קריית ים,1657,776,881,141,1516,1027,1642,50,8%
2013-05,חיפה,8200,קריית מוצקין,1126,494,632,146,980,545,1122,31,5%
2013-05,חיפה,922,רכסים,144,74,70,14,130,82,141,2,4%
2013-05,ירושלים,472,אבו גוש,232,109,123,7,225,184,231,2,8%
2013-05,ירושלים,2610,בית שמש,1253,584,669,78,1175,581,1230,44,4%
2013-05,ירושלים,3000,ירושלים,11627,5272,6355,1238,10389,6991,11462,179,4%
2013-05,ירושלים,1015,מבשרת ציון,409,185,224,59,350,178,405,4,3%
2013-05,ירושלים,1137,קריית יערים,33,12,21,6,27,16,33,0,3%
2013-05,תל אביב,2400,אור יהודה,879,403,476,40,839,280,850,38,5%
2013-05,תל אביב,565,אזור,201,102,99,27,174,28,199,5,3%
2013-05,תל אביב,6100,בני ברק,2464,1217,1247,102,2362,1451,2427,21,5%
2013-05,תל אביב,6200,בת ים,3513,1673,1840,455,3058,1305,3400,87,5%
2013-05,תל אביב,6300,גבעתיים,872,410,462,290,582,109,860,2,3%
2013-05,תל אביב,6400,הרצלייה,1087,503,584,271,816,55,1074,30,2%
2013-05,תל אביב,6600,חולון,3513,1702,1811,528,2985,886,3435,53,3%
2013-05,תל אביב,2620,קריית אונו,464,208,256,148,316,44,461,3,3%
2013-05,תל אביב,8600,רמת גן,2417,1133,1284,627,1790,468,2386,14,3%
2013-05,תל אביב,2650,רמת השרון,425,164,261,143,282,9,423,2,2%
2013-05,תל אביב,5000,תל אביב -יפו,8378,4215,4163,2374,6004,2629,8250,120,3%
2013-06,אזור יהודה והשומרון,3760,אורנית,212,103,109,32,180,5,212,0,5%
2013-06,אזור יהודה והשומרון,3750,אלפי מנשה,125,51,74,27,98,1,124,1,3%
2013-06,אזור יהודה והשומרון,3560,אלקנה,45,19,26,15,30,1,44,0,2%
2013-06,אזור יהודה והשומרון,3650,אפרת,50,30,20,11,39,4,50,1,1%
2013-06,אזור יהודה והשומרון,3570,אריאל,458,216,242,58,400,102,455,11,4%
2013-06,אזור יהודה והשומרון,3574,בית אל,81,45,36,13,68,20,80,0,3%
2013-06,אזור יהודה והשומרון,3652,בית אריה,99,51,48,7,92,3,99,0,4%
2013-06,אזור יהודה והשומרון,3780,ביתר עילית,450,209,241,11,439,200,444,14,4%
2013-06,אזור יהודה והשומרון,3730,גבעת זאב,269,128,141,29,240,39,269,11,4%
2013-06,אזור יהודה והשומרון,3769,הר אדר,52,22,30,13,39,2,50,4,2%
2013-06,אזור יהודה והשומרון,3797,מודיעין עילית,458,137,321,10,448,105,449,6,3%
2013-06,אזור יהודה והשומרון,3616,מעלה אדומים,1253,592,661,72,1181,202,1243,29,6%
2013-06,אזור יהודה והשומרון,3660,עמנואל,70,31,39,0,70,49,70,0,6%
2013-06,אזור יהודה והשומרון,3557,קדומים,62,38,24,13,49,8,62,0,3%
2013-06,אזור יהודה והשומרון,3611,קריית ארבע,132,78,54,13,119,63,132,2,4%
2013-06,אזור יהודה והשומרון,3640,קרני שומרון,111,65,46,17,94,11,110,2,3%
2013-06,הדרום,31,אופקים,1476,667,809,83,1393,923,1461,29,11%
2013-06,הדרום,2600,אילת,1978,925,1053,59,1919,577,1962,31,6%
2013-06,הדרום,70,אשדוד,8493,3595,4898,764,7729,3749,8403,205,8%
2013-06,הדרום,7100,אשקלון,5246,2150,3096,530,4716,2580,5091,90,7%
2013-06,הדרום,9000,באר שבע,8344,3801,4543,891,7453,4542,8205,218,8%
2013-06,הדרום,2200,דימונה,2315,1080,1235,117,2198,1402,2261,71,12%
2013-06,הדרום,1303,חורה,797,340,457,2,795,735,795,3,20%
2013-06,הדרום,831,ירוחם,486,241,245,17,469,259,472,26,10%
2013-06,הדרום,1059,כסיפה,1035,448,587,1,1034,918,1027,5,23%
2013-06,הדרום,1271,להבים,92,41,51,25,67,5,92,2,3%
2013-06,הדרום,1060,לקיה,989,437,552,2,987,926,985,2,24%
2013-06,הדרום,1268,מיתר,117,58,59,23,94,8,115,1,3%
2013-06,הדרום,99,מצפה רמון,296,124,172,10,286,151,280,7,11%
2013-06,הדרום,246,נתיבות,1291,601,690,51,1240,550,1266,44,9%
2013-06,הדרום,666,עומר,80,35,45,22,58,6,80,0,2%
2013-06,הדרום,2560,ערד,859,383,476,100,759,453,821,38,7%
2013-06,הדרום,1192,ערערה-בנגב,1026,411,615,2,1024,948,1022,3,25%
2013-06,הדרום,2630,קריית גת,2588,1101,1487,140,2448,1447,2557,77,9%
2013-06,הדרום,1034,קריית מלאכי,1519,709,810,21,1498,786,1482,71,12%
2013-06,הדרום,1161,רהט,3284,1372,1912,4,3280,2769,3267,59,18%
2013-06,הדרום,1286,שגב-שלום,537,203,334,1,536,469,533,1,21%
2013-06,הדרום,1031,שדרות,1239,570,669,38,1201,695,1219,19,10%
2013-06,הדרום,1054,תל שבע,1202,580,622,1,1201,1115,1190,3,25%
2013-06,המרכז,182,אבן יהודה,227,96,131,51,176,19,227,1,3%
2013-06,המרכז,41,אליכין,78,43,35,6,72,16,76,0,4%
2013-06,המרכז,1309,אלעד,550,250,300,23,527,129,545,6,5%
2013-06,המרכז,2530,באר יעקב,304,129,175,56,248,59,301,7,3%
2013-06,המרכז,466,בית דגן,192,95,97,24,168,39,192,0,5%
2013-06,המרכז,1066,"בני עי""ש",238,120,118,21,217,75,237,3,6%
2013-06,המרכז,681,גבעת שמואל,458,242,216,127,331,66,458,1,4%
2013-06,המרכז,2550,גדרה,501,233,268,59,442,106,497,4,4%
2013-06,המרכז,627,ג'לג'וליה,112,65,47,2,110,46,110,1,3%
2013-06,המרכז,166,גן יבנה,578,235,343,45,533,104,574,5,5%
2013-06,המרכז,229,גני תקווה,302,157,145,69,233,27,302,0,4%
2013-06,המרכז,9700,הוד השרון,828,402,426,217,611,67,819,5,3%
2013-06,המרכז,1290,זמר,196,75,121,3,193,135,195,1,7%
2013-06,המרכז,2730,טייבה,2233,983,1250,5,2228,1838,2216,14,13%
2013-06,המרכז,2720,טירה,354,176,178,8,346,171,349,12,3%
2013-06,המרכז,2660,יבנה,1180,555,625,84,1096,372,1171,23,5%
2013-06,המרכז,9400,יהוד,792,349,443,78,714,86,776,18,5%
2013-06,המרכז,1224,כוכב יאיר,172,89,83,60,112,3,172,0,3%
2013-06,המרכז,633,כפר ברא,48,33,15,3,45,13,48,1,4%
2013-06,המרכז,168,כפר יונה,443,195,248,62,381,76,439,7,4%
2013-06,המרכז,6900,כפר סבא,1588,781,807,384,1204,184,1570,13,3%
2013-06,המרכז,634,כפר קאסם,287,158,129,4,283,153,281,5,3%
2013-06,המרכז,7000,לוד,2542,1225,1317,144,2398,1223,2504,41,7%
2013-06,המרכז,1200,מודיעין-מכבים-רעות*,1680,818,862,283,1397,64,1657,14,4%
2013-06,המרכז,28,מזכרת בתיה,275,121,154,36,239,35,273,1,4%
2013-06,המרכז,7200,נס ציונה,926,438,488,154,772,209,920,6,4%
2013-06,המרכז,7400,נתניה,5482,2582,2900,586,4896,1637,5387,75,5%
2013-06,המרכז,587,סביון*,26,14,12,9,17,1,26,0,1%
2013-06,המרכז,171,פרדסייה,106,49,57,21,85,7,106,0,3%
2013-06,המרכז,7900,פתח תקווה,5890,2764,3126,834,5056,1108,5840,76,5%
2013-06,המרכז,195,קדימה-צורן,345,147,198,62,283,35,343,2,3%
2013-06,המרכז,638,קלנסווה,900,369,531,3,897,754,888,22,11%
2013-06,המרכז,469,קריית עקרון,373,182,191,17,356,135,372,7,6%
2013-06,המרכז,2640,ראש העין,1151,567,584,92,1059,170,1137,21,5%
2013-06,המרכז,8300,ראשון לציון,5973,2794,3179,878,5095,1465,5945,106,4%
2013-06,המרכז,8400,רחובות,3252,1526,1726,527,2725,1026,3204,36,5%
2013-06,המרכז,8500,רמלה,2233,1065,1168,104,2129,826,2174,52,6%
2013-06,המרכז,8700,רעננה,1140,560,580,286,854,94,1132,5,3%
2013-06,המרכז,1304,שוהם,467,258,209,79,388,6,466,0,4%
2013-06,המרכז,154,תל מונד,235,124,111,36,199,24,235,0,4%
2013-06,הצפון,473,אבו סנאן,757,287,470,3,754,631,751,21,13%
2013-06,הצפון,478,אכסאל,550,247,303,13,537,457,544,4,10%
2013-06,הצפון,529,אעבלין,658,270,388,9,649,529,657,9,12%
2013-06,הצפון,482,בועיינה-נוג'ידאת,441,186,255,1,440,343,433,4,12%
2013-06,הצפון,4001,בוקעאתא,414,158,256,7,407,351,400,2,15%
2013-06,הצפון,998,ביר אל-מכסור,432,150,282,2,430,345,430,1,12%
2013-06,הצפון,480,בית ג'ן,380,120,260,9,371,272,366,0,7%
2013-06,הצפון,9200,בית שאן,899,426,473,15,884,428,890,66,9%
2013-06,הצפון,944,בסמת טבעון,240,108,132,2,238,170,235,1,8%
2013-06,הצפון,483,בענה,417,177,240,1,416,346,416,11,13%
2013-06,הצפון,1292,ג'דיידה-מכר,1515,651,864,7,1508,1300,1500,40,17%
2013-06,הצפון,485,ג'ולס,230,65,165,1,229,167,230,2,8%
2013-06,הצפון,487,ג'ש (גוש חלב),66,30,36,5,61,29,65,0,4%
2013-06,הצפון,489,דבורייה,439,211,228,12,427,310,435,6,11%
2013-06,הצפון,490,דייר אל-אסד,401,171,230,5,396,319,400,3,8%
2013-06,הצפון,492,דייר חנא,656,289,367,9,647,500,656,4,14%
2013-06,הצפון,975,זרזיר,330,149,181,3,327,238,325,7,11%
2013-06,הצפון,496,חורפיש,118,50,68,3,115,64,117,3,5%
2013-06,הצפון,2034,חצור הגלילית,343,169,174,8,335,158,326,4,7%
2013-06,הצפון,6700,טבריה,2181,994,1187,81,2100,1132,1998,51,9%
2013-06,הצפון,962,טובא-זנגרייה,394,151,243,2,392,254,382,2,13%
2013-06,הצפון,498,טורעאן,548,220,328,7,541,466,521,3,10%
2013-06,הצפון,8900,טמרה,2076,850,1226,20,2056,1801,2062,13,15%
2013-06,הצפון,1295,יאנוח-ג'ת,162,56,106,2,160,104,160,4,6%
2013-06,הצפון,46,יבנאל,170,110,60,8,162,120,152,0,10%
2013-06,הצפון,499,יפיע,721,339,382,12,709,518,707,5,9%
2013-06,הצפון,240,יקנעם עילית,644,308,336,60,584,170,640,32,6%
2013-06,הצפון,502,ירכא,576,236,340,0,576,450,575,5,10%
2013-06,הצפון,504,כאבול,676,252,424,8,668,594,670,3,14%
2013-06,הצפון,505,כאוכב אבו אל-היג'א,221,90,131,1,220,186,220,1,13%
2013-06,הצפון,1296,כסרא-סמיע,206,91,115,3,203,138,203,6,6%
2013-06,הצפון,978,כעביה-טבאש-חג'אג'רה,197,74,123,1,196,137,195,0,9%
2013-06,הצפון,1263,כפר ורדים,137,72,65,19,118,8,134,1,4%
2013-06,הצפון,507,כפר יאסיף,556,242,314,3,553,415,546,14,11%
2013-06,הצפון,508,כפר כמא,72,32,40,4,68,33,71,0,4%
2013-06,הצפון,509,כפר כנא,1222,480,742,21,1201,1048,1183,9,14%
2013-06,הצפון,510,כפר מנדא,995,449,546,13,982,739,975,0,14%
2013-06,הצפון,47,כפר תבור,71,30,41,8,63,4,71,0,3%
2013-06,הצפון,1139,כרמיאל,2086,899,1187,316,1770,898,1996,58,8%
2013-06,הצפון,481,מגאר,1532,600,932,16,1516,1325,1508,12,17%
2013-06,הצפון,516,מג'ד אל-כרום,606,283,323,4,602,451,605,9,10%
2013-06,הצפון,874,מגדל העמק,1201,518,683,64,1137,490,1119,95,8%
2013-06,הצפון,4201,מג'דל שמס,467,158,309,10,457,399,460,1,10%
2013-06,הצפון,517,מזרעה,199,77,122,3,196,144,198,8,10%
2013-06,הצפון,4203,מסעדה,204,73,131,7,197,165,203,2,12%
2013-06,הצפון,518,מעיליא,53,34,19,5,48,16,52,0,3%
2013-06,הצפון,1063,מעלות-תרשיחא,998,501,497,95,903,522,978,32,8%
2013-06,הצפון,520,משהד,303,112,191,4,299,256,296,10,10%
2013-06,הצפון,9100,נהרייה,2281,1043,1238,218,2063,1231,2260,45,7%
2013-06,הצפון,522,נחף,435,201,234,8,427,340,432,22,9%
2013-06,הצפון,7300,נצרת,3377,1533,1844,84,3293,2551,3325,25,10%
2013-06,הצפון,1061,נצרת עילית,2183,982,1201,211,1972,1102,2047,91,9%
2013-06,הצפון,525,סאג'ור,122,49,73,0,122,75,118,1,7%
2013-06,הצפון,7500,סח'נין,2075,927,1148,29,2046,1755,2072,20,15%
2013-06,הצפון,4501,ע'ג'ר,80,34,46,1,79,58,80,0,8%
2013-06,הצפון,530,עיילבון,212,94,118,7,205,150,209,5,8%
2013-06,הצפון,511,עילוט,322,128,194,2,320,257,317,0,12%
2013-06,הצפון,532,עין מאהל,606,287,319,6,600,492,590,6,12%
2013-06,הצפון,7600,עכו,3423,1596,1827,94,3329,2484,3362,53,13%
2013-06,הצפון,7700,עפולה,1972,860,1112,189,1783,834,1910,83,8%
2013-06,הצפון,531,עראבה,1484,625,859,18,1466,1319,1480,14,15%
2013-06,הצפון,535,פסוטה,118,50,68,5,113,82,118,2,7%
2013-06,הצפון,536,פקיעין (בוקייעה),124,61,63,3,121,81,123,3,5%
2013-06,הצפון,8000,צפת,1574,856,718,69,1505,1120,1537,33,11%
2013-06,הצפון,4100,קצרין,247,113,134,30,217,81,245,10,6%
2013-06,הצפון,2800,קריית שמונה,931,439,492,48,883,314,906,30,7%
2013-06,הצפון,543,ראמה,327,125,202,4,323,247,325,0,9%
2013-06,הצפון,26,ראש פינה,69,25,44,8,61,18,69,2,4%
2013-06,הצפון,542,ריינה,695,295,400,5,690,559,677,5,10%
2013-06,הצפון,122,רמת ישי,132,55,77,26,106,19,130,1,3%
2013-06,הצפון,913,שבלי - אום אל-גנם,233,108,125,2,231,161,231,1,9%
2013-06,הצפון,812,שלומי,309,119,190,18,291,144,306,6,8%
2013-06,הצפון,538,שעב,512,214,298,7,505,447,512,7,18%
2013-06,הצפון,8800,שפרעם,2080,800,1280,29,2051,1660,2074,32,12%
2013-06,חיפה,2710,אום אל-פחם,3898,1599,2299,15,3883,3346,3860,10,19%
2013-06,חיפה,1020,אור עקיבא,701,315,386,38,663,238,678,18,7%
2013-06,חיפה,6000,באקה אל-גרביה,746,362,384,9,737,461,740,24,7%
2013-06,חיפה,9800,בנימינה-גבעת עדה*,284,134,150,40,244,63,283,4,4%
2013-06,חיפה,1326,"בסמ""ה",449,195,254,2,447,348,446,4,12%
2013-06,חיפה,541,ג'סר א-זרקא,489,266,223,0,489,303,486,4,8%
2013-06,חיפה,628,ג'ת,244,116,128,7,237,144,243,4,5%
2013-06,חיפה,494,דאלית אל-כרמל,534,221,313,8,526,296,526,6,7%
2013-06,חיפה,9300,זכרון יעקב,375,170,205,73,302,55,372,0,4%
2013-06,חיפה,6500,חדרה,2938,1274,1664,260,2678,982,2889,31,6%
2013-06,חיפה,4000,חיפה,8141,3947,4194,1159,6982,3807,7998,203,6%
2013-06,חיפה,1247,חריש,25,14,11,5,20,5,24,0,2%
2013-06,חיפה,2100,טירת כרמל,899,420,479,23,876,467,884,26,8%
2013-06,חיפה,654,כפר קרע,441,213,228,5,436,255,438,10,5%
2013-06,חיפה,1327,מעלה עירון,1003,404,599,8,995,809,994,4,18%
2013-06,חיפה,2500,נשר,689,354,335,91,598,208,683,10,5%
2013-06,חיפה,534,עספיא,344,159,185,11,333,179,339,2,6%
2013-06,חיפה,637,ערערה,635,262,373,3,632,402,630,15,8%
2013-06,חיפה,537,פוריידיס,410,207,203,3,407,265,407,1,8%
2013-06,חיפה,7800,פרדס חנה-כרכור,1052,490,562,120,932,287,1035,29,5%
2013-06,חיפה,6800,קריית אתא,2001,927,1074,142,1859,975,1982,45,7%
2013-06,חיפה,9500,קריית ביאליק,1362,583,779,115,1247,620,1355,31,6%
2013-06,חיפה,2300,קריית טבעון,253,126,127,62,191,36,253,1,3%
2013-06,חיפה,9600,קריית ים,1810,834,976,145,1665,1042,1793,41,8%
2013-06,חיפה,8200,קריית מוצקין,1327,602,725,138,1189,545,1316,34,6%
2013-06,חיפה,922,רכסים,142,67,75,14,128,82,138,1,4%
2013-06,ירושלים,472,אבו גוש,264,134,130,8,256,182,264,10,9%
2013-06,ירושלים,2610,בית שמש,1522,730,792,84,1438,562,1490,51,5%
2013-06,ירושלים,3000,ירושלים,13650,6411,7239,1230,12420,7077,13480,179,5%
2013-06,ירושלים,1015,מבשרת ציון,604,292,312,57,547,176,599,29,5%
2013-06,ירושלים,1137,קריית יערים,37,12,25,5,32,17,36,0,3%
2013-06,תל אביב,2400,אור יהודה,1149,541,608,42,1107,290,1115,38,6%
2013-06,תל אביב,565,אזור,244,134,110,23,221,30,243,2,4%
2013-06,תל אביב,6100,בני ברק,2670,1265,1405,105,2565,1459,2613,26,5%
2013-06,תל אביב,6200,בת ים,4176,2037,2139,427,3749,1305,4069,98,6%
2013-06,תל אביב,6300,גבעתיים,926,422,504,282,644,102,919,4,3%
2013-06,תל אביב,6400,הרצלייה,1596,745,851,284,1312,65,1578,33,3%
2013-06,תל אביב,6600,חולון,4959,2356,2603,496,4463,901,4887,49,5%
2013-06,תל אביב,2620,קריית אונו,655,325,330,124,531,47,649,6,4%
2013-06,תל אביב,8600,רמת גן,2792,1347,1445,576,2216,457,2759,21,4%
2013-06,תל אביב,2650,רמת השרון,632,266,366,149,483,6,627,2,3%
2013-06,תל אביב,5000,תל אביב -יפו,9707,4959,4748,2243,7464,2537,9577,112,4%
2013-07,אזור יהודה והשומרון,3760,אורנית,135,57,78,39,96,5,133,0,3%
2013-07,אזור יהודה והשומרון,3750,אלפי מנשה,142,54,88,30,112,0,140,0,3%
2013-07,אזור יהודה והשומרון,3560,אלקנה,50,22,28,15,35,2,49,0,3%
2013-07,אזור יהודה והשומרון,3650,אפרת,68,42,26,11,57,3,67,4,2%
2013-07,אזור יהודה והשומרון,3570,אריאל,496,249,247,70,426,106,493,13,5%
2013-07,אזור יהודה והשומרון,3574,בית אל,95,56,39,13,82,21,95,0,4%
2013-07,אזור יהודה והשומרון,3652,בית אריה,94,38,56,5,89,2,94,1,4%
2013-07,אזור יהודה והשומרון,3780,ביתר עילית,647,254,393,9,638,225,640,6,6%
2013-07,אזור יהודה והשומרון,3730,גבעת זאב,250,122,128,34,216,41,249,6,3%
2013-07,אזור יהודה והשומרון,3769,הר אדר,45,23,22,12,33,2,45,3,2%
2013-07,אזור יהודה והשומרון,3797,מודיעין עילית,811,180,631,10,801,101,799,3,6%
2013-07,אזור יהודה והשומרון,3616,מעלה אדומים,996,436,560,67,929,207,984,36,5%
2013-07,אזור יהודה והשומרון,3660,עמנואל,103,50,53,0,103,48,103,0,9%
2013-07,אזור יהודה והשומרון,3557,קדומים,69,38,31,14,55,7,69,0,4%
2013-07,אזור יהודה והשומרון,3611,קריית ארבע,158,88,70,14,144,64,156,15,5%
2013-07,אזור יהודה והשומרון,3640,קרני שומרון,93,44,49,18,75,8,93,1,3%
2013-07,הדרום,31,אופקים,1679,738,941,83,1596,925,1663,26,13%
2013-07,הדרום,2600,אילת,1748,791,957,52,1696,570,1718,50,5%
2013-07,הדרום,70,אשדוד,8437,3374,5063,780,7657,3737,8317,200,8%
2013-07,הדרום,7100,אשקלון,5382,2149,3233,502,4880,2590,5099,85,8%
2013-07,הדרום,9000,באר שבע,8454,3810,4644,888,7566,4609,8236,186,8%
2013-07,הדרום,2200,דימונה,2484,1099,1385,122,2362,1420,2438,74,13%
2013-07,הדרום,1303,חורה,830,356,474,4,826,754,823,1,21%
2013-07,הדרום,831,ירוחם,547,252,295,17,530,269,523,33,11%
2013-07,הדרום,1059,כסיפה,1055,441,614,1,1054,916,1045,7,23%
2013-07,הדרום,1271,להבים,85,40,45,24,61,4,85,0,2%
2013-07,הדרום,1060,לקיה,1018,440,578,2,1016,934,1011,1,25%
2013-07,הדרום,1268,מיתר,133,65,68,22,111,9,131,1,3%
2013-07,הדרום,99,מצפה רמון,303,115,188,10,293,155,287,11,11%
2013-07,הדרום,246,נתיבות,1341,553,788,55,1286,568,1311,32,10%
2013-07,הדרום,666,עומר,71,36,35,17,54,5,71,0,2%
2013-07,הדרום,2560,ערד,903,395,508,89,814,451,873,29,7%
2013-07,הדרום,1192,ערערה-בנגב,1030,407,623,2,1028,942,1028,3,26%
2013-07,הדרום,2630,קריית גת,2641,1107,1534,137,2504,1430,2610,50,9%
2013-07,הדרום,1034,קריית מלאכי,1525,701,824,23,1502,783,1478,85,12%
2013-07,הדרום,1161,רהט,3465,1424,2041,3,3462,2816,3443,26,19%
2013-07,הדרום,1286,שגב-שלום,559,218,341,2,557,471,550,4,22%
2013-07,הדרום,1031,שדרות,1278,550,728,40,1238,694,1250,21,10%
2013-07,הדרום,1054,תל שבע,1224,586,638,2,1222,1130,1207,1,26%
2013-07,המרכז,182,אבן יהודה,186,79,107,50,136,20,186,2,3%
2013-07,המרכז,41,אליכין,93,51,42,5,88,19,92,1,5%
2013-07,המרכז,1309,אלעד,659,275,384,26,633,124,647,9,5%
2013-07,המרכז,2530,באר יעקב,363,143,220,47,316,64,362,5,4%
2013-07,המרכז,466,בית דגן,141,78,63,23,118,39,140,2,4%
2013-07,המרכז,1066,"בני עי""ש",235,109,126,19,216,80,232,7,6%
2013-07,המרכז,681,גבעת שמואל,388,202,186,114,274,66,386,1,3%
2013-07,המרכז,2550,גדרה,536,227,309,65,471,103,531,10,5%
2013-07,המרכז,627,ג'לג'וליה,94,48,46,2,92,54,92,1,3%
2013-07,המרכז,166,גן יבנה,557,225,332,46,511,102,553,5,5%
2013-07,המרכז,229,גני תקווה,260,124,136,55,205,29,260,1,3%
2013-07,המרכז,9700,הוד השרון,829,399,430,214,615,64,820,3,3%
2013-07,המרכז,1290,זמר,195,72,123,3,192,136,195,3,7%
2013-07,המרכז,2730,טייבה,2290,979,1311,9,2281,1870,2241,28,13%
2013-07,המרכז,2720,טירה,334,156,178,8,326,165,327,10,3%
2013-07,המרכז,2660,יבנה,1156,526,630,82,1074,373,1147,31,5%
2013-07,המרכז,9400,יהוד,698,304,394,83,615,90,677,19,4%
2013-07,המרכז,1224,כוכב יאיר,178,90,88,55,123,0,178,0,3%
2013-07,המרכז,633,כפר ברא,41,22,19,3,38,15,40,0,3%
2013-07,המרכז,168,כפר יונה,437,194,243,61,376,70,432,8,4%
2013-07,המרכז,6900,כפר סבא,1628,742,886,369,1259,185,1613,17,3%
2013-07,המרכז,634,כפר קאסם,270,133,137,2,268,148,266,3,3%
2013-07,המרכז,7000,לוד,2660,1208,1452,163,2497,1272,2621,41,7%
2013-07,המרכז,1200,מודיעין-מכבים-רעות*,1507,669,838,270,1237,65,1492,40,4%
2013-07,המרכז,28,מזכרת בתיה,249,97,152,42,207,40,245,2,4%
2013-07,המרכז,7200,נס ציונה,937,425,512,155,782,209,932,3,4%
2013-07,המרכז,7400,נתניה,5637,2501,3136,597,5040,1605,5550,101,5%
2013-07,המרכז,587,סביון*,30,15,15,9,21,1,30,1,2%
2013-07,המרכז,171,פרדסייה,115,55,60,18,97,7,115,0,3%
2013-07,המרכז,7900,פתח תקווה,5044,2283,2761,825,4219,1118,4989,80,4%
2013-07,המרכז,195,קדימה-צורן,364,170,194,58,306,35,363,0,4%
2013-07,המרכז,638,קלנסווה,924,382,542,4,920,757,893,15,11%
2013-07,המרכז,469,קריית עקרון,394,179,215,19,375,138,390,7,7%
2013-07,המרכז,2640,ראש העין,1050,501,549,99,951,162,1037,23,5%
2013-07,המרכז,8300,ראשון לציון,5632,2615,3017,877,4755,1485,5594,118,4%
2013-07,המרכז,8400,רחובות,3442,1537,1905,575,2867,1029,3391,32,5%
2013-07,המרכז,8500,רמלה,2257,1041,1216,112,2145,803,2208,45,6%
2013-07,המרכז,8700,רעננה,1090,519,571,299,791,98,1081,9,3%
2013-07,המרכז,1304,שוהם,302,142,160,76,226,9,302,1,3%
2013-07,המרכז,154,תל מונד,183,94,89,31,152,22,183,0,3%
2013-07,הצפון,473,אבו סנאן,787,322,465,4,783,621,779,24,14%
2013-07,הצפון,478,אכסאל,551,245,306,14,537,456,545,1,10%
2013-07,הצפון,529,אעבלין,669,278,391,9,660,527,666,10,12%
2013-07,הצפון,482,בועיינה-נוג'ידאת,434,173,261,1,433,348,425,4,11%
2013-07,הצפון,4001,בוקעאתא,400,154,246,8,392,340,380,4,14%
2013-07,הצפון,998,ביר אל-מכסור,439,156,283,4,435,346,436,0,12%
2013-07,הצפון,480,בית ג'ן,390,123,267,8,382,275,384,10,8%
2013-07,הצפון,9200,בית שאן,992,454,538,17,975,429,971,73,10%
2013-07,הצפון,944,בסמת טבעון,260,113,147,2,258,175,256,2,8%
2013-07,הצפון,483,בענה,446,181,265,1,445,362,444,10,14%
2013-07,הצפון,1292,ג'דיידה-מכר,1557,668,889,8,1549,1301,1543,50,17%
2013-07,הצפון,485,ג'ולס,262,81,181,2,260,164,262,3,9%
2013-07,הצפון,487,ג'ש (גוש חלב),66,30,36,4,62,28,65,4,4%
2013-07,הצפון,489,דבורייה,459,208,251,12,447,314,454,2,11%
2013-07,הצפון,490,דייר אל-אסד,428,179,249,6,422,324,427,11,9%
2013-07,הצפון,492,דייר חנא,663,279,384,7,656,503,663,9,14%
2013-07,הצפון,975,זרזיר,356,165,191,3,353,245,346,10,12%
2013-07,הצפון,496,חורפיש,143,68,75,2,141,66,142,2,5%
2013-07,הצפון,2034,חצור הגלילית,377,173,204,10,367,157,359,27,8%
2013-07,הצפון,6700,טבריה,2192,954,1238,85,2107,1168,1973,82,9%
2013-07,הצפון,962,טובא-זנגרייה,406,151,255,2,404,261,393,4,13%
2013-07,הצפון,498,טורעאן,600,231,369,9,591,480,567,9,10%
2013-07,הצפון,8900,טמרה,2127,850,1277,24,2103,1813,2112,20,15%
2013-07,הצפון,1295,יאנוח-ג'ת,198,71,127,5,193,98,195,1,7%
2013-07,הצפון,46,יבנאל,197,125,72,7,190,124,176,2,11%
2013-07,הצפון,499,יפיע,709,318,391,11,698,528,697,4,9%
2013-07,הצפון,240,יקנעם עילית,687,310,377,55,632,174,679,36,6%
2013-07,הצפון,502,ירכא,616,252,364,0,616,455,612,11,11%
2013-07,הצפון,504,כאבול,724,283,441,12,712,603,718,0,15%
2013-07,הצפון,505,כאוכב אבו אל-היג'א,224,95,129,2,222,186,223,4,14%
2013-07,הצפון,1296,כסרא-סמיע,218,90,128,3,215,152,214,2,7%
2013-07,הצפון,978,כעביה-טבאש-חג'אג'רה,208,79,129,3,205,143,202,3,9%
2013-07,הצפון,1263,כפר ורדים,150,74,76,21,129,11,149,0,5%
2013-07,הצפון,507,כפר יאסיף,576,249,327,2,574,417,567,13,11%
2013-07,הצפון,508,כפר כמא,64,26,38,4,60,33,62,0,4%
2013-07,הצפון,509,כפר כנא,1266,500,766,19,1247,1054,1210,9,14%
2013-07,הצפון,510,כפר מנדא,1021,451,570,14,1007,734,1004,2,14%
2013-07,הצפון,47,כפר תבור,88,37,51,9,79,4,88,2,4%
2013-07,הצפון,1139,כרמיאל,2039,879,1160,310,1729,884,1955,52,7%
2013-07,הצפון,481,מגאר,1516,607,909,12,1504,1303,1490,22,17%
2013-07,הצפון,516,מג'ד אל-כרום,643,292,351,3,640,464,643,13,10%
2013-07,הצפון,874,מגדל העמק,1293,535,758,65,1228,490,1184,82,9%
2013-07,הצפון,4201,מג'דל שמס,481,162,319,10,471,394,469,20,10%
2013-07,הצפון,517,מזרעה,190,74,116,3,187,148,189,10,10%
2013-07,הצפון,4203,מסעדה,202,70,132,6,196,166,199,2,12%
2013-07,הצפון,518,מעיליא,70,43,27,8,62,20,68,1,4%
2013-07,הצפון,1063,מעלות-תרשיחא,1073,470,603,100,973,522,1054,35,9%
2013-07,הצפון,520,משהד,318,120,198,3,315,270,304,3,10%
2013-07,הצפון,9100,נהרייה,2333,1087,1246,202,2131,1214,2303,74,7%
2013-07,הצפון,522,נחף,430,203,227,7,423,336,427,10,9%
2013-07,הצפון,7300,נצרת,3468,1536,1932,90,3378,2533,3421,28,10%
2013-07,הצפון,1061,נצרת עילית,2244,977,1267,189,2055,1130,2057,91,9%
2013-07,הצפון,525,סאג'ור,140,55,85,0,140,69,137,4,8%
2013-07,הצפון,7500,סח'נין,2128,939,1189,25,2103,1759,2124,30,16%
2013-07,הצפון,4501,ע'ג'ר,81,35,46,2,79,59,81,1,8%
2013-07,הצפון,530,עיילבון,232,101,131,4,228,153,230,5,9%
2013-07,הצפון,511,עילוט,338,121,217,2,336,258,334,3,12%
2013-07,הצפון,532,עין מאהל,626,296,330,6,620,509,608,3,12%
2013-07,הצפון,7600,עכו,3490,1605,1885,95,3395,2453,3421,58,13%
2013-07,הצפון,7700,עפולה,2090,870,1220,190,1900,864,2018,69,8%
2013-07,הצפון,531,עראבה,1538,645,893,23,1515,1308,1530,17,16%
2013-07,הצפון,535,פסוטה,138,58,80,6,132,79,138,7,8%
2013-07,הצפון,536,פקיעין (בוקייעה),126,65,61,6,120,78,125,3,5%
2013-07,הצפון,8000,צפת,1708,876,832,65,1643,1104,1665,26,12%
2013-07,הצפון,4100,קצרין,278,127,151,25,253,90,278,54,7%
2013-07,הצפון,2800,קריית שמונה,1044,489,555,48,996,329,1014,47,8%
2013-07,הצפון,543,ראמה,345,137,208,7,338,249,341,3,9%
2013-07,הצפון,26,ראש פינה,68,23,45,7,61,17,66,10,4%
2013-07,הצפון,542,ריינה,730,309,421,7,723,569,696,5,11%
2013-07,הצפון,122,רמת ישי,137,64,73,27,110,19,133,0,3%
2013-07,הצפון,913,שבלי - אום אל-גנם,222,99,123,3,219,153,221,0,9%
2013-07,הצפון,812,שלומי,312,127,185,20,292,139,307,3,8%
2013-07,הצפון,538,שעב,519,220,299,5,514,455,518,5,18%
2013-07,הצפון,8800,שפרעם,2106,796,1310,33,2073,1699,2092,36,12%
2013-07,חיפה,2710,אום אל-פחם,3944,1573,2371,19,3925,3345,3899,12,19%
2013-07,חיפה,1020,אור עקיבא,732,320,412,45,687,238,706,23,7%
2013-07,חיפה,6000,באקה אל-גרביה,758,356,402,11,747,470,752,21,7%
2013-07,חיפה,9800,בנימינה-גבעת עדה*,275,117,158,44,231,65,273,5,4%
2013-07,חיפה,1326,"בסמ""ה",449,198,251,3,446,350,444,4,12%
2013-07,חיפה,541,ג'סר א-זרקא,492,265,227,0,492,309,488,9,8%
2013-07,חיפה,628,ג'ת,258,118,140,10,248,149,257,3,5%
2013-07,חיפה,494,דאלית אל-כרמל,551,218,333,7,544,298,533,7,7%
2013-07,חיפה,9300,זכרון יעקב,385,174,211,75,310,57,384,1,4%
2013-07,חיפה,6500,חדרה,2988,1278,1710,235,2753,1011,2922,27,6%
2013-07,חיפה,4000,חיפה,7853,3802,4051,1108,6745,3802,7690,214,5%
2013-07,חיפה,1247,חריש,25,17,8,5,20,6,24,0,2%
2013-07,חיפה,2100,טירת כרמל,839,379,460,24,815,471,823,28,8%
2013-07,חיפה,654,כפר קרע,472,228,244,4,468,262,467,10,6%
2013-07,חיפה,1327,מעלה עירון,1028,412,616,9,1019,820,1019,2,18%
2013-07,חיפה,2500,נשר,664,316,348,83,581,212,660,20,5%
2013-07,חיפה,534,עספיא,375,167,208,7,368,181,367,5,7%
2013-07,חיפה,637,ערערה,637,255,382,4,633,407,626,15,8%
2013-07,חיפה,537,פוריידיס,430,201,229,4,426,261,426,3,8%
2013-07,חיפה,7800,פרדס חנה-כרכור,1036,479,557,119,917,284,1018,29,5%
2013-07,חיפה,6800,קריית אתא,2104,901,1203,150,1954,992,2078,53,7%
2013-07,חיפה,9500,קריית ביאליק,1351,590,761,112,1239,632,1345,38,6%
2013-07,חיפה,2300,קריית טבעון,246,124,122,52,194,45,244,1,3%
2013-07,חיפה,9600,קריית ים,1852,845,1007,154,1698,1041,1835,54,8%
2013-07,חיפה,8200,קריית מוצקין,1245,565,680,139,1106,519,1232,22,5%
2013-07,חיפה,922,רכסים,212,74,138,11,201,77,209,1,6%
2013-07,ירושלים,472,אבו גוש,262,135,127,8,254,180,262,10,9%
2013-07,ירושלים,2610,בית שמש,1883,836,1047,91,1792,581,1849,64,6%
2013-07,ירושלים,3000,ירושלים,14285,6253,8032,1279,13006,7261,14074,184,5%
2013-07,ירושלים,1015,מבשרת ציון,536,246,290,61,475,159,531,20,4%
2013-07,ירושלים,1137,קריית יערים,50,17,33,4,46,19,49,0,4%
2013-07,תל אביב,2400,אור יהודה,1106,500,606,36,1070,281,1073,41,6%
2013-07,תל אביב,565,אזור,237,101,136,24,213,31,235,4,4%
2013-07,תל אביב,6100,בני ברק,3183,1274,1909,110,3073,1462,3117,23,6%
2013-07,תל אביב,6200,בת ים,3963,1915,2048,423,3540,1300,3845,108,5%
2013-07,תל אביב,6300,גבעתיים,957,415,542,276,681,97,949,11,3%
2013-07,תל אביב,6400,הרצלייה,1546,694,852,304,1242,54,1526,28,3%
2013-07,תל אביב,6600,חולון,4307,1981,2326,493,3814,920,4216,67,4%
2013-07,תל אביב,2620,קריית אונו,582,265,317,121,461,48,578,10,3%
2013-07,תל אביב,8600,רמת גן,2683,1219,1464,553,2130,450,2648,17,3%
2013-07,תל אביב,2650,רמת השרון,534,228,306,144,390,4,529,5,2%
2013-07,תל אביב,5000,תל אביב -יפו,9485,4777,4708,2307,7178,2579,9329,130,4%
2013-08,אזור יהודה והשומרון,3760,אורנית,121,48,73,35,86,4,121,0,3%
2013-08,אזור יהודה והשומרון,3750,אלפי מנשה,134,55,79,26,108,1,134,2,3%
2013-08,אזור יהודה והשומרון,3560,אלקנה,42,18,24,12,30,2,42,1,2%
2013-08,אזור יהודה והשומרון,3650,אפרת,48,26,22,7,41,3,48,0,1%
2013-08,אזור יהודה והשומרון,3570,אריאל,412,198,214,61,351,95,404,4,4%
2013-08,אזור יהודה והשומרון,3574,בית אל,73,37,36,11,62,20,73,2,3%
2013-08,אזור יהודה והשומרון,3652,בית אריה,74,27,47,4,70,2,73,1,3%
2013-08,אזור יהודה והשומרון,3780,ביתר עילית,656,245,411,10,646,227,648,12,6%
2013-08,אזור יהודה והשומרון,3730,גבעת זאב,201,85,116,37,164,42,198,2,3%
2013-08,אזור יהודה והשומרון,3769,הר אדר,36,18,18,12,24,2,35,0,2%
2013-08,אזור יהודה והשומרון,3797,מודיעין עילית,884,206,678,11,873,101,870,10,6%
2013-08,אזור יהודה והשומרון,3616,מעלה אדומים,882,372,510,59,823,201,852,14,4%
2013-08,אזור יהודה והשומרון,3660,עמנואל,96,42,54,0,96,50,95,2,8%
2013-08,אזור יהודה והשומרון,3557,קדומים,57,27,30,14,43,8,57,0,3%
2013-08,אזור יהודה והשומרון,3611,קריית ארבע,143,77,66,11,132,61,142,2,5%
2013-08,אזור יהודה והשומרון,3640,קרני שומרון,89,45,44,17,72,7,87,0,2%
2013-08,הדרום,31,אופקים,1599,659,940,74,1525,912,1570,40,12%
2013-08,הדרום,2600,אילת,1467,643,824,51,1416,558,1439,23,4%
2013-08,הדרום,70,אשדוד,7867,3018,4849,762,7105,3704,7742,207,7%
2013-08,הדרום,7100,אשקלון,4863,1875,2988,495,4368,2552,4573,112,7%
2013-08,הדרום,9000,באר שבע,7884,3471,4413,900,6984,4536,7648,169,7%
2013-08,הדרום,2200,דימונה,2363,1006,1357,123,2240,1432,2303,53,12%
2013-08,הדרום,1303,חורה,818,347,471,3,815,748,812,4,21%
2013-08,הדרום,831,ירוחם,539,235,304,18,521,279,516,24,11%
2013-08,הדרום,1059,כסיפה,1037,432,605,1,1036,897,1026,5,23%
2013-08,הדרום,1271,להבים,62,26,36,28,34,3,62,1,2%
2013-08,הדרום,1060,לקיה,994,433,561,2,992,920,988,3,24%
2013-08,הדרום,1268,מיתר,95,38,57,24,71,9,94,0,2%
2013-08,הדרום,99,מצפה רמון,289,116,173,9,280,160,271,20,11%
2013-08,הדרום,246,נתיבות,1277,479,798,57,1220,589,1246,36,9%
2013-08,הדרום,666,עומר,50,26,24,13,37,5,50,0,1%
2013-08,הדרום,2560,ערד,830,363,467,89,741,445,803,27,6%
2013-08,הדרום,1192,ערערה-בנגב,1041,418,623,2,1039,954,1038,1,26%
2013-08,הדרום,2630,קריית גת,2457,985,1472,135,2322,1412,2413,50,9%
2013-08,הדרום,1034,קריית מלאכי,1427,649,778,25,1402,771,1383,81,12%
2013-08,הדרום,1161,רהט,3406,1405,2001,4,3402,2804,3382,82,19%
2013-08,הדרום,1286,שגב-שלום,545,208,337,1,544,465,538,2,21%
2013-08,הדרום,1031,שדרות,1221,527,694,44,1177,686,1194,12,9%
2013-08,הדרום,1054,תל שבע,1230,581,649,2,1228,1141,1218,3,26%
2013-08,המרכז,182,אבן יהודה,179,86,93,54,125,20,179,1,3%
2013-08,המרכז,41,אליכין,92,50,42,7,85,18,91,2,5%
2013-08,המרכז,1309,אלעד,635,252,383,30,605,123,621,0,5%
2013-08,המרכז,2530,באר יעקב,305,114,191,54,251,62,303,3,3%
2013-08,המרכז,466,בית דגן,124,70,54,22,102,40,123,0,3%
2013-08,המרכז,1066,"בני עי""ש",219,97,122,20,199,75,217,9,5%
2013-08,המרכז,681,גבעת שמואל,341,165,176,106,235,69,338,1,3%
2013-08,המרכז,2550,גדרה,440,178,262,72,368,106,435,3,4%
2013-08,המרכז,627,ג'לג'וליה,92,47,45,3,89,53,90,2,3%
2013-08,המרכז,166,גן יבנה,473,177,296,50,423,106,468,6,4%
2013-08,המרכז,229,גני תקווה,224,103,121,51,173,28,224,1,3%
2013-08,המרכז,9700,הוד השרון,784,338,446,208,576,69,773,7,3%
2013-08,המרכז,1290,זמר,169,54,115,2,167,134,168,1,6%
2013-08,המרכז,2730,טייבה,2192,938,1254,8,2184,1834,2152,23,13%
2013-08,המרכז,2720,טירה,343,162,181,9,334,166,332,7,3%
2013-08,המרכז,2660,יבנה,1058,462,596,75,983,379,1045,31,5%
2013-08,המרכז,9400,יהוד,619,252,367,82,537,88,607,15,4%
2013-08,המרכז,1224,כוכב יאיר,136,62,74,47,89,1,136,1,2%
2013-08,המרכז,633,כפר ברא,34,16,18,3,31,14,34,0,3%
2013-08,המרכז,168,כפר יונה,356,154,202,59,297,65,353,2,3%
2013-08,המרכז,6900,כפר סבא,1512,669,843,368,1144,185,1489,26,3%
2013-08,המרכז,634,כפר קאסם,269,130,139,2,267,150,261,0,3%
2013-08,המרכז,7000,לוד,2442,1069,1373,163,2279,1262,2414,41,7%
2013-08,המרכז,1200,מודיעין-מכבים-רעות*,1279,517,762,263,1016,69,1257,21,3%
2013-08,המרכז,28,מזכרת בתיה,211,72,139,41,170,42,207,1,3%
2013-08,המרכז,7200,נס ציונה,832,337,495,149,683,211,821,8,4%
2013-08,המרכז,7400,נתניה,5122,2173,2949,588,4534,1616,5037,101,5%
2013-08,המרכז,587,סביון*,24,9,15,9,15,1,24,0,1%
2013-08,המרכז,171,פרדסייה,83,39,44,17,66,10,83,0,2%
2013-08,המרכז,7900,פתח תקווה,4620,1980,2640,818,3802,1126,4560,50,4%
2013-08,המרכז,195,קדימה-צורן,289,118,171,55,234,38,286,3,3%
2013-08,המרכז,638,קלנסווה,879,348,531,4,875,733,855,15,10%
2013-08,המרכז,469,קריית עקרון,359,157,202,20,339,139,356,7,6%
2013-08,המרכז,2640,ראש העין,931,414,517,93,838,170,920,16,4%
2013-08,המרכז,8300,ראשון לציון,4934,2171,2763,814,4120,1481,4903,80,4%
2013-08,המרכז,8400,רחובות,3092,1277,1815,565,2527,1028,3036,51,5%
2013-08,המרכז,8500,רמלה,2044,893,1151,104,1940,786,1994,43,6%
2013-08,המרכז,8700,רעננה,972,442,530,305,667,92,962,6,3%
2013-08,המרכז,1304,שוהם,230,105,125,63,167,7,230,0,2%
2013-08,המרכז,154,תל מונד,156,75,81,32,124,23,156,2,3%
2013-08,הצפון,473,אבו סנאן,724,280,444,4,720,609,720,12,13%
2013-08,הצפון,478,אכסאל,538,232,306,11,527,459,532,0,10%
2013-08,הצפון,529,אעבלין,645,255,390,10,635,541,639,6,12%
2013-08,הצפון,482,בועיינה-נוג'ידאת,414,159,255,1,413,339,408,10,11%
2013-08,הצפון,4001,בוקעאתא,398,151,247,8,390,341,385,2,15%
2013-08,הצפון,998,ביר אל-מכסור,420,142,278,3,417,343,418,1,12%
2013-08,הצפון,480,בית ג'ן,379,121,258,10,369,284,370,1,7%
2013-08,הצפון,9200,בית שאן,933,413,520,17,916,446,903,72,9%
2013-08,הצפון,944,בסמת טבעון,258,108,150,1,257,180,254,2,8%
2013-08,הצפון,483,בענה,423,166,257,2,421,348,422,3,13%
2013-08,הצפון,1292,ג'דיידה-מכר,1485,617,868,8,1477,1264,1475,26,17%
2013-08,הצפון,485,ג'ולס,222,58,164,2,220,157,222,0,8%
2013-08,הצפון,487,ג'ש (גוש חלב),69,32,37,4,65,30,67,2,4%
2013-08,הצפון,489,דבורייה,456,202,254,16,440,319,451,3,11%
2013-08,הצפון,490,דייר אל-אסד,395,155,240,6,389,316,395,4,8%
2013-08,הצפון,492,דייר חנא,635,250,385,7,628,510,635,12,14%
2013-08,הצפון,975,זרזיר,320,138,182,3,317,235,309,9,11%
2013-08,הצפון,496,חורפיש,128,62,66,2,126,71,125,3,5%
2013-08,הצפון,2034,חצור הגלילית,312,128,184,8,304,150,296,8,6%
2013-08,הצפון,6700,טבריה,1981,833,1148,81,1900,1153,1787,66,8%
2013-08,הצפון,962,טובא-זנגרייה,370,139,231,2,368,250,359,4,12%
2013-08,הצפון,498,טורעאן,565,204,361,11,554,455,553,7,10%
2013-08,הצפון,8900,טמרה,2088,826,1262,20,2068,1784,2075,23,15%
2013-08,הצפון,1295,יאנוח-ג'ת,181,64,117,5,176,103,178,0,7%
2013-08,הצפון,46,יבנאל,173,117,56,5,168,122,154,0,10%
2013-08,הצפון,499,יפיע,661,277,384,12,649,525,652,4,9%
2013-08,הצפון,240,יקנעם עילית,589,239,350,48,541,169,583,30,5%
2013-08,הצפון,502,ירכא,568,224,344,0,568,441,565,2,10%
2013-08,הצפון,504,כאבול,714,272,442,8,706,604,709,4,15%
2013-08,הצפון,505,כאוכב אבו אל-היג'א,222,89,133,1,221,189,221,2,13%
2013-08,הצפון,1296,כסרא-סמיע,213,88,125,5,208,150,208,6,6%
2013-08,הצפון,978,כעביה-טבאש-חג'אג'רה,201,76,125,2,199,145,197,2,9%
2013-08,הצפון,1263,כפר ורדים,99,47,52,17,82,13,95,1,3%
2013-08,הצפון,507,כפר יאסיף,510,203,307,2,508,400,501,8,10%
2013-08,הצפון,508,כפר כמא,65,27,38,3,62,31,63,0,4%
2013-08,הצפון,509,כפר כנא,1176,440,736,16,1160,1014,1142,9,13%
2013-08,הצפון,510,כפר מנדא,1004,442,562,13,991,737,990,1,14%
2013-08,הצפון,47,כפר תבור,57,26,31,8,49,4,56,0,3%
2013-08,הצפון,1139,כרמיאל,1827,745,1082,302,1525,880,1754,56,7%
2013-08,הצפון,481,מגאר,1405,531,874,11,1394,1253,1388,14,16%
2013-08,הצפון,516,מג'ד אל-כרום,587,244,343,3,584,453,586,7,9%
2013-08,הצפון,874,מגדל העמק,1163,464,699,65,1098,474,1059,73,8%
2013-08,הצפון,4201,מג'דל שמס,450,149,301,11,439,394,438,3,9%
2013-08,הצפון,517,מזרעה,179,66,113,4,175,141,178,3,9%
2013-08,הצפון,4203,מסעדה,187,63,124,5,182,159,185,2,11%
2013-08,הצפון,518,מעיליא,58,27,31,7,51,22,56,0,4%
2013-08,הצפון,1063,מעלות-תרשיחא,934,414,520,95,839,503,916,29,8%
2013-08,הצפון,520,משהד,289,106,183,4,285,249,282,4,9%
2013-08,הצפון,9100,נהרייה,2109,943,1166,196,1913,1223,2087,73,7%
2013-08,הצפון,522,נחף,409,182,227,7,402,338,407,4,9%
2013-08,הצפון,7300,נצרת,3332,1415,1917,96,3236,2533,3278,32,10%
2013-08,הצפון,1061,נצרת עילית,2072,888,1184,190,1882,1095,1910,101,8%
2013-08,הצפון,525,סאג'ור,114,43,71,2,112,73,109,1,6%
2013-08,הצפון,7500,סח'נין,2042,875,1167,18,2024,1747,2037,28,15%
2013-08,הצפון,4501,ע'ג'ר,81,36,45,2,79,62,80,0,8%
2013-08,הצפון,530,עיילבון,205,78,127,4,201,146,203,2,8%
2013-08,הצפון,511,עילוט,339,127,212,0,339,260,337,1,12%
2013-08,הצפון,532,עין מאהל,625,291,334,6,619,516,603,1,12%
2013-08,הצפון,7600,עכו,3328,1477,1851,100,3228,2436,3258,47,12%
2013-08,הצפון,7700,עפולה,1981,817,1164,189,1792,870,1913,85,8%
2013-08,הצפון,531,עראבה,1492,615,877,21,1471,1296,1483,16,15%
2013-08,הצפון,535,פסוטה,136,58,78,6,130,79,136,1,8%
2013-08,הצפון,536,פקיעין (בוקייעה),130,66,64,6,124,79,128,1,5%
2013-08,הצפון,8000,צפת,1590,799,791,60,1530,1097,1546,24,12%
2013-08,הצפון,4100,קצרין,189,80,109,20,169,86,188,10,5%
2013-08,הצפון,2800,קריית שמונה,918,416,502,43,875,329,891,41,7%
2013-08,הצפון,543,ראמה,322,119,203,7,315,246,321,3,8%
2013-08,הצפון,26,ראש פינה,56,18,38,6,50,19,55,0,4%
2013-08,הצפון,542,ריינה,678,262,416,6,672,549,661,3,10%
2013-08,הצפון,122,רמת ישי,111,42,69,27,84,18,105,0,3%
2013-08,הצפון,913,שבלי - אום אל-גנם,214,92,122,6,208,157,213,1,9%
2013-08,הצפון,812,שלומי,279,112,167,14,265,136,276,9,8%
2013-08,הצפון,538,שעב,506,205,301,3,503,453,504,5,17%
2013-08,הצפון,8800,שפרעם,2026,743,1283,31,1995,1672,2006,30,12%
2013-08,חיפה,2710,אום אל-פחם,3890,1538,2352,18,3872,3333,3841,8,19%
2013-08,חיפה,1020,אור עקיבא,617,259,358,42,575,225,597,19,6%
2013-08,חיפה,6000,באקה אל-גרביה,739,335,404,10,729,483,732,19,7%
2013-08,חיפה,9800,בנימינה-גבעת עדה*,235,94,141,43,192,63,234,2,3%
2013-08,חיפה,1326,"בסמ""ה",438,182,256,3,435,355,434,3,11%
2013-08,חיפה,541,ג'סר א-זרקא,466,244,222,0,466,306,464,1,8%
2013-08,חיפה,628,ג'ת,248,116,132,12,236,149,247,5,5%
2013-08,חיפה,494,דאלית אל-כרמל,534,206,328,9,525,306,519,7,7%
2013-08,חיפה,9300,זכרון יעקב,315,129,186,81,234,60,312,0,3%
2013-08,חיפה,6500,חדרה,2727,1092,1635,251,2476,1005,2664,47,5%
2013-08,חיפה,4000,חיפה,7021,3338,3683,1102,5919,3689,6860,194,5%
2013-08,חיפה,1247,חריש,33,21,12,6,27,8,31,0,2%
2013-08,חיפה,2100,טירת כרמל,757,354,403,25,732,450,747,23,7%
2013-08,חיפה,654,כפר קרע,450,209,241,4,446,264,443,7,5%
2013-08,חיפה,1327,מעלה עירון,1013,396,617,10,1003,837,1001,2,18%
2013-08,חיפה,2500,נשר,528,245,283,75,453,207,523,14,4%
2013-08,חיפה,534,עספיא,346,152,194,8,338,177,339,4,6%
2013-08,חיפה,637,ערערה,628,253,375,2,626,407,614,14,8%
2013-08,חיפה,537,פוריידיס,414,195,219,7,407,268,410,2,8%
2013-08,חיפה,7800,פרדס חנה-כרכור,911,400,511,114,797,276,898,32,5%
2013-08,חיפה,6800,קריית אתא,1915,802,1113,138,1777,974,1885,49,6%
2013-08,חיפה,9500,קריית ביאליק,1215,508,707,110,1105,626,1206,26,6%
2013-08,חיפה,2300,קריית טבעון,195,85,110,57,138,41,194,0,2%
2013-08,חיפה,9600,קריית ים,1691,758,933,145,1546,1018,1677,57,8%
2013-08,חיפה,8200,קריית מוצקין,1162,502,660,129,1033,544,1147,35,5%
2013-08,חיפה,922,רכסים,206,63,143,13,193,71,202,2,6%
2013-08,ירושלים,472,אבו גוש,238,118,120,5,233,177,238,4,8%
2013-08,ירושלים,2610,בית שמש,1584,655,929,95,1489,571,1544,48,5%
2013-08,ירושלים,3000,ירושלים,13288,5734,7554,1307,11981,7241,13066,170,4%
2013-08,ירושלים,1015,מבשרת ציון,430,196,234,63,367,164,424,6,3%
2013-08,ירושלים,1137,קריית יערים,45,19,26,5,40,21,44,1,4%
2013-08,תל אביב,2400,אור יהודה,1046,438,608,33,1013,260,1015,41,5%
2013-08,תל אביב,565,אזור,210,100,110,25,185,34,204,5,3%
2013-08,תל אביב,6100,בני ברק,3215,1240,1975,113,3102,1421,3136,24,6%
2013-08,תל אביב,6200,בת ים,3593,1687,1906,411,3182,1284,3488,97,5%
2013-08,תל אביב,6300,גבעתיים,869,371,498,267,602,100,858,3,3%
2013-08,תל אביב,6400,הרצלייה,1281,543,738,294,987,59,1262,37,3%
2013-08,תל אביב,6600,חולון,3650,1651,1999,475,3175,912,3561,49,4%
2013-08,תל אביב,2620,קריית אונו,481,212,269,108,373,51,477,1,3%
2013-08,תל אביב,8600,רמת גן,2402,1060,1342,516,1886,459,2364,16,3%
2013-08,תל אביב,2650,רמת השרון,449,183,266,141,308,9,444,3,2%
2013-08,תל אביב,5000,תל אביב -יפו,8733,4317,4416,2227,6506,2512,8580,121,3%
2013-09,אזור יהודה והשומרון,3760,אורנית,102,41,61,30,72,5,102,0,2%
2013-09,אזור יהודה והשומרון,3750,אלפי מנשה,112,44,68,20,92,1,112,0,3%
2013-09,אזור יהודה והשומרון,3560,אלקנה,37,15,22,12,25,2,36,0,2%
2013-09,אזור יהודה והשומרון,3650,אפרת,47,24,23,6,41,6,46,0,1%
2013-09,אזור יהודה והשומרון,3570,אריאל,376,182,194,58,318,96,371,11,4%
2013-09,אזור יהודה והשומרון,3574,בית אל,50,20,30,10,40,18,50,0,2%
2013-09,אזור יהודה והשומרון,3652,בית אריה,66,23,43,5,61,3,66,0,3%
2013-09,אזור יהודה והשומרון,3780,ביתר עילית,520,219,301,6,514,210,516,4,5%
2013-09,אזור יהודה והשומרון,3730,גבעת זאב,174,75,99,39,135,39,173,1,2%
2013-09,אזור יהודה והשומרון,3769,הר אדר,24,11,13,11,13,3,24,0,1%
2013-09,אזור יהודה והשומרון,3797,מודיעין עילית,490,145,345,12,478,93,477,1,4%
2013-09,אזור יהודה והשומרון,3616,מעלה אדומים,708,287,421,51,657,194,696,8,3%
2013-09,אזור יהודה והשומרון,3660,עמנואל,78,33,45,0,78,48,76,5,7%
2013-09,אזור יהודה והשומרון,3557,קדומים,44,24,20,11,33,9,43,0,2%
2013-09,אזור יהודה והשומרון,3611,קריית ארבע,125,61,64,14,111,64,125,1,4%
2013-09,אזור יהודה והשומרון,3640,קרני שומרון,85,39,46,14,71,11,85,1,2%
2013-09,הדרום,31,אופקים,1447,602,845,78,1369,897,1426,20,11%
2013-09,הדרום,2600,אילת,1385,583,802,50,1335,546,1363,17,4%
2013-09,הדרום,70,אשדוד,7039,2756,4283,707,6332,3562,6927,161,6%
2013-09,הדרום,7100,אשקלון,4423,1712,2711,457,3966,2413,4163,70,6%
2013-09,הדרום,9000,באר שבע,7261,3184,4077,856,6405,4399,7070,106,7%
2013-09,הדרום,2200,דימונה,2166,939,1227,113,2053,1377,2119,36,12%
2013-09,הדרום,1303,חורה,796,333,463,1,795,726,789,2,20%
2013-09,הדרום,831,ירוחם,495,223,272,16,479,272,472,13,10%
2013-09,הדרום,1059,כסיפה,975,415,560,1,974,872,966,2,22%
2013-09,הדרום,1271,להבים,65,31,34,27,38,5,65,1,2%
2013-09,הדרום,1060,לקיה,958,425,533,3,955,891,951,1,24%
2013-09,הדרום,1268,מיתר,78,38,40,23,55,7,77,1,2%
2013-09,הדרום,99,מצפה רמון,281,115,166,10,271,163,262,10,11%
2013-09,הדרום,246,נתיבות,1160,469,691,59,1101,566,1120,22,8%
2013-09,הדרום,666,עומר,53,24,29,18,35,5,53,1,1%
2013-09,הדרום,2560,ערד,790,354,436,76,714,444,757,27,6%
2013-09,הדרום,1192,ערערה-בנגב,1034,416,618,2,1032,937,1029,0,26%
2013-09,הדרום,2630,קריית גת,2230,899,1331,126,2104,1340,2196,20,8%
2013-09,הדרום,1034,קריית מלאכי,1277,541,736,24,1253,731,1249,40,11%
2013-09,הדרום,1161,רהט,3228,1298,1930,5,3223,2738,3209,39,18%
2013-09,הדרום,1286,שגב-שלום,528,194,334,1,527,450,523,0,21%
2013-09,הדרום,1031,שדרות,1135,483,652,33,1102,665,1112,11,9%
2013-09,הדרום,1054,תל שבע,1210,581,629,1,1209,1126,1195,2,26%
2013-09,המרכז,182,אבן יהודה,160,70,90,48,112,19,160,0,2%
2013-09,המרכז,41,אליכין,70,37,33,7,63,19,69,0,4%
2013-09,המרכז,1309,אלעד,474,213,261,27,447,122,464,4,4%
2013-09,המרכז,2530,באר יעקב,266,107,159,58,208,59,263,2,3%
2013-09,המרכז,466,בית דגן,117,68,49,21,96,42,115,1,3%
2013-09,המרכז,1066,"בני עי""ש",187,84,103,18,169,73,185,3,5%
2013-09,המרכז,681,גבעת שמואל,302,142,160,98,204,66,297,2,3%
2013-09,המרכז,2550,גדרה,376,151,225,72,304,107,369,4,3%
2013-09,המרכז,627,ג'לג'וליה,75,35,40,3,72,44,75,1,2%
2013-09,המרכז,166,גן יבנה,407,147,260,49,358,99,404,3,4%
2013-09,המרכז,229,גני תקווה,180,84,96,40,140,25,180,0,2%
2013-09,המרכז,9700,הוד השרון,672,282,390,179,493,62,663,4,2%
2013-09,המרכז,1290,זמר,167,50,117,1,166,129,166,1,6%
2013-09,המרכז,2730,טייבה,2146,920,1226,14,2132,1810,2104,18,12%
2013-09,המרכז,2720,טירה,325,144,181,8,317,163,315,4,3%
2013-09,המרכז,2660,יבנה,914,416,498,67,847,361,905,17,4%
2013-09,המרכז,9400,יהוד,532,219,313,72,460,84,516,7,3%
2013-09,המרכז,1224,כוכב יאיר,116,57,59,44,72,1,115,0,2%
2013-09,המרכז,633,כפר ברא,28,14,14,2,26,12,28,0,2%
2013-09,המרכז,168,כפר יונה,332,152,180,57,275,62,328,5,3%
2013-09,המרכז,6900,כפר סבא,1283,573,710,324,959,175,1268,13,2%
2013-09,המרכז,634,כפר קאסם,249,126,123,2,247,146,242,1,3%
2013-09,המרכז,7000,לוד,2222,1009,1213,157,2065,1226,2193,28,6%
2013-09,המרכז,1200,מודיעין-מכבים-רעות*,1036,439,597,256,780,59,1024,9,2%
2013-09,המרכז,28,מזכרת בתיה,159,58,101,37,122,37,157,0,2%
2013-09,המרכז,7200,נס ציונה,732,303,429,154,578,209,726,5,3%
2013-09,המרכז,7400,נתניה,4446,1964,2482,510,3936,1540,4374,40,4%
2013-09,המרכז,587,סביון*,20,7,13,7,13,0,20,0,1%
2013-09,המרכז,171,פרדסייה,83,39,44,14,69,9,83,0,2%
2013-09,המרכז,7900,פתח תקווה,4003,1713,2290,737,3266,1097,3944,30,3%
2013-09,המרכז,195,קדימה-צורן,252,100,152,56,196,36,251,0,3%
2013-09,המרכז,638,קלנסווה,851,334,517,5,846,717,828,5,10%
2013-09,המרכז,469,קריית עקרון,313,140,173,19,294,132,311,10,5%
2013-09,המרכז,2640,ראש העין,749,343,406,83,666,162,740,7,3%
2013-09,המרכז,8300,ראשון לציון,4420,1985,2435,719,3701,1408,4398,54,3%
2013-09,המרכז,8400,רחובות,2671,1185,1486,515,2156,998,2625,26,4%
2013-09,המרכז,8500,רמלה,1808,791,1017,98,1710,756,1753,27,5%
2013-09,המרכז,8700,רעננה,847,395,452,282,565,87,838,1,2%
2013-09,המרכז,1304,שוהם,192,87,105,62,130,7,192,0,2%
2013-09,המרכז,154,תל מונד,133,57,76,35,98,23,132,1,2%
2013-09,הצפון,473,אבו סנאן,696,264,432,4,692,593,693,2,12%
2013-09,הצפון,478,אכסאל,511,213,298,11,500,442,508,0,9%
2013-09,הצפון,529,אעבלין,612,234,378,4,608,517,609,10,11%
2013-09,הצפון,482,בועיינה-נוג'ידאת,387,152,235,1,386,338,376,0,10%
2013-09,הצפון,4001,בוקעאתא,387,149,238,7,380,337,375,0,14%
2013-09,הצפון,998,ביר אל-מכסור,407,142,265,2,405,335,404,1,11%
2013-09,הצפון,480,בית ג'ן,345,105,240,7,338,265,339,0,7%
2013-09,הצפון,9200,בית שאן,832,361,471,20,812,440,816,43,8%
2013-09,הצפון,944,בסמת טבעון,229,98,131,1,228,168,226,1,7%
2013-09,הצפון,483,בענה,409,157,252,2,407,340,409,3,13%
2013-09,הצפון,1292,ג'דיידה-מכר,1427,590,837,6,1421,1243,1415,14,16%
2013-09,הצפון,485,ג'ולס,199,55,144,2,197,152,198,1,7%
2013-09,הצפון,487,ג'ש (גוש חלב),65,29,36,4,61,31,65,4,4%
2013-09,הצפון,489,דבורייה,400,175,225,14,386,299,396,3,10%
2013-09,הצפון,490,דייר אל-אסד,371,141,230,6,365,308,371,4,8%
2013-09,הצפון,492,דייר חנא,621,251,370,7,614,505,621,4,13%
2013-09,הצפון,975,זרזיר,289,120,169,4,285,217,282,2,10%
2013-09,הצפון,496,חורפיש,118,53,65,2,116,67,117,0,5%
2013-09,הצפון,2034,חצור הגלילית,284,110,174,8,276,136,268,4,6%
2013-09,הצפון,6700,טבריה,1778,755,1023,70,1708,1074,1586,27,7%
2013-09,הצפון,962,טובא-זנגרייה,352,130,222,2,350,240,340,2,12%
2013-09,הצפון,498,טורעאן,533,195,338,10,523,444,519,4,10%
2013-09,הצפון,8900,טמרה,2025,802,1223,18,2007,1774,2008,12,15%
2013-09,הצפון,1295,יאנוח-ג'ת,149,54,95,3,146,96,148,3,6%
2013-09,הצפון,46,יבנאל,159,103,56,6,153,116,146,2,9%
2013-09,הצפון,499,יפיע,646,274,372,14,632,515,638,2,8%
2013-09,הצפון,240,יקנעם עילית,516,197,319,43,473,164,511,15,5%
2013-09,הצפון,502,ירכא,523,203,320,0,523,421,522,0,10%
2013-09,הצפון,504,כאבול,693,272,421,8,685,598,686,1,14%
2013-09,הצפון,505,כאוכב אבו אל-היג'א,224,93,131,2,222,194,223,0,14%
2013-09,הצפון,1296,כסרא-סמיע,206,87,119,6,200,150,199,1,6%
2013-09,הצפון,978,כעביה-טבאש-חג'אג'רה,193,68,125,3,190,142,187,0,9%
2013-09,הצפון,1263,כפר ורדים,63,21,42,16,47,9,62,0,2%
2013-09,הצפון,507,כפר יאסיף,501,195,306,3,498,402,492,5,10%
2013-09,הצפון,508,כפר כמא,63,22,41,2,61,31,61,0,4%
2013-09,הצפון,509,כפר כנא,1126,435,691,15,1111,991,1090,6,13%
2013-09,הצפון,510,כפר מנדא,963,434,529,12,951,711,950,0,13%
2013-09,הצפון,47,כפר תבור,51,24,27,10,41,4,49,0,2%
2013-09,הצפון,1139,כרמיאל,1675,658,1017,290,1385,849,1621,20,6%
2013-09,הצפון,481,מגאר,1344,507,837,11,1333,1223,1324,1,16%
2013-09,הצפון,516,מג'ד אל-כרום,558,237,321,3,555,438,557,11,9%
2013-09,הצפון,874,מגדל העמק,1025,398,627,69,956,460,935,36,7%
2013-09,הצפון,4201,מג'דל שמס,448,148,300,11,437,392,440,2,9%
2013-09,הצפון,517,מזרעה,167,57,110,4,163,135,164,0,9%
2013-09,הצפון,4203,מסעדה,187,65,122,5,182,162,184,3,11%
2013-09,הצפון,518,מעיליא,52,23,29,5,47,22,51,0,3%
2013-09,הצפון,1063,מעלות-תרשיחא,881,395,486,88,793,499,865,13,7%
2013-09,הצפון,520,משהד,272,102,170,4,268,235,266,1,9%
2013-09,הצפון,9100,נהרייה,1940,867,1073,169,1771,1197,1915,41,6%
2013-09,הצפון,522,נחף,393,175,218,5,388,329,390,3,8%
2013-09,הצפון,7300,נצרת,3201,1384,1817,93,3108,2497,3162,13,9%
2013-09,הצפון,1061,נצרת עילית,1870,797,1073,177,1693,1048,1731,44,7%
2013-09,הצפון,525,סאג'ור,98,39,59,2,96,67,97,0,6%
2013-09,הצפון,7500,סח'נין,2001,865,1136,13,1988,1746,1994,5,15%
2013-09,הצפון,4501,ע'ג'ר,76,30,46,0,76,64,76,0,8%
2013-09,הצפון,530,עיילבון,204,75,129,3,201,143,203,2,8%
2013-09,הצפון,511,עילוט,308,123,185,0,308,253,305,1,11%
2013-09,הצפון,532,עין מאהל,585,263,322,7,578,494,569,2,12%
2013-09,הצפון,7600,עכו,3222,1438,1784,99,3123,2435,3152,34,12%
2013-09,הצפון,7700,עפולה,1757,705,1052,197,1560,830,1703,45,7%
2013-09,הצפון,531,עראבה,1463,599,864,20,1443,1292,1451,13,15%
2013-09,הצפון,535,פסוטה,111,49,62,6,105,78,111,0,7%
2013-09,הצפון,536,פקיעין (בוקייעה),117,58,59,4,113,77,115,2,4%
2013-09,הצפון,8000,צפת,1466,755,711,61,1405,1077,1424,21,11%
2013-09,הצפון,4100,קצרין,180,74,106,20,160,90,179,1,5%
2013-09,הצפון,2800,קריית שמונה,856,358,498,46,810,342,830,19,6%
2013-09,הצפון,543,ראמה,307,117,190,8,299,240,306,1,8%
2013-09,הצפון,26,ראש פינה,46,15,31,7,39,19,45,0,3%
2013-09,הצפון,542,ריינה,667,261,406,5,662,552,649,0,10%
2013-09,הצפון,122,רמת ישי,100,36,64,26,74,13,96,0,2%
2013-09,הצפון,913,שבלי - אום אל-גנם,216,95,121,6,210,158,214,2,9%
2013-09,הצפון,812,שלומי,264,109,155,15,249,133,259,3,7%
2013-09,הצפון,538,שעב,507,209,298,3,504,452,506,1,17%
2013-09,הצפון,8800,שפרעם,1973,740,1233,33,1940,1659,1954,20,12%
2013-09,חיפה,2710,אום אל-פחם,3805,1509,2296,19,3786,3306,3758,9,19%
2013-09,חיפה,1020,אור עקיבא,575,234,341,47,528,215,561,16,6%
2013-09,חיפה,6000,באקה אל-גרביה,705,313,392,7,698,473,699,13,6%
2013-09,חיפה,9800,בנימינה-גבעת עדה*,211,75,136,43,168,62,208,1,3%
2013-09,חיפה,1326,"בסמ""ה",434,178,256,3,431,359,432,1,11%
2013-09,חיפה,541,ג'סר א-זרקא,454,243,211,0,454,290,452,0,8%
2013-09,חיפה,628,ג'ת,262,132,130,13,249,149,262,4,5%
2013-09,חיפה,494,דאלית אל-כרמל,488,190,298,7,481,289,478,0,6%
2013-09,חיפה,9300,זכרון יעקב,264,108,156,76,188,57,263,0,3%
2013-09,חיפה,6500,חדרה,2485,981,1504,238,2247,980,2431,27,5%
2013-09,חיפה,4000,חיפה,6535,3080,3455,987,5548,3506,6374,81,5%
2013-09,חיפה,1247,חריש,26,16,10,4,22,7,25,0,2%
2013-09,חיפה,2100,טירת כרמל,724,325,399,20,704,449,710,11,7%
2013-09,חיפה,654,כפר קרע,426,192,234,6,420,256,419,7,5%
2013-09,חיפה,1327,מעלה עירון,955,366,589,7,948,804,946,5,17%
2013-09,חיפה,2500,נשר,493,230,263,79,414,196,489,13,4%
2013-09,חיפה,534,עספיא,338,139,199,8,330,176,335,0,6%
2013-09,חיפה,637,ערערה,588,228,360,5,583,393,578,12,7%
2013-09,חיפה,537,פוריידיס,382,177,205,9,373,262,378,1,7%
2013-09,חיפה,7800,פרדס חנה-כרכור,837,358,479,110,727,268,824,16,4%
2013-09,חיפה,6800,קריית אתא,1697,740,957,126,1571,933,1675,29,6%
2013-09,חיפה,9500,קריית ביאליק,1159,468,691,117,1042,614,1146,9,5%
2013-09,חיפה,2300,קריית טבעון,168,72,96,43,125,42,167,1,2%
2013-09,חיפה,9600,קריית ים,1575,726,849,139,1436,975,1557,23,7%
2013-09,חיפה,8200,קריית מוצקין,1071,449,622,133,938,511,1050,12,5%
2013-09,חיפה,922,רכסים,153,56,97,12,141,63,150,0,5%
2013-09,ירושלים,472,אבו גוש,242,116,126,7,235,176,242,2,8%
2013-09,ירושלים,2610,בית שמש,1377,579,798,84,1293,552,1343,27,5%
2013-09,ירושלים,3000,ירושלים,11853,5148,6705,1220,10633,7088,11660,90,4%
2013-09,ירושלים,1015,מבשרת ציון,380,178,202,61,319,156,376,3,3%
2013-09,ירושלים,1137,קריית יערים,40,17,23,2,38,19,39,0,3%
2013-09,תל אביב,2400,אור יהודה,800,344,456,30,770,254,779,17,4%
2013-09,תל אביב,565,אזור,176,90,86,25,151,30,175,2,3%
2013-09,תל אביב,6100,בני ברק,2583,1144,1439,114,2469,1363,2518,9,5%
2013-09,תל אביב,6200,בת ים,3206,1455,1751,360,2846,1238,3119,53,4%
2013-09,תל אביב,6300,גבעתיים,732,317,415,226,506,94,724,4,2%
2013-09,תל אביב,6400,הרצלייה,1065,450,615,269,796,40,1054,22,2%
2013-09,תל אביב,6600,חולון,3199,1491,1708,428,2771,860,3137,34,3%
2013-09,תל אביב,2620,קריית אונו,414,174,240,99,315,41,411,2,2%
2013-09,תל אביב,8600,רמת גן,2074,953,1121,467,1607,444,2040,13,3%
2013-09,תל אביב,2650,רמת השרון,403,164,239,135,268,13,395,3,2%
2013-09,תל אביב,5000,תל אביב -יפו,7998,3943,4055,1961,6037,2394,7880,74,3%
2013-10,אזור יהודה והשומרון,3760,אורנית,107,45,62,33,74,5,106,1,2%
2013-10,אזור יהודה והשומרון,3750,אלפי מנשה,116,48,68,21,95,4,116,1,3%
2013-10,אזור יהודה והשומרון,3560,אלקנה,41,17,24,16,25,2,40,1,2%
2013-10,אזור יהודה והשומרון,3650,אפרת,54,29,25,10,44,4,53,2,1%
2013-10,אזור יהודה והשומרון,3570,אריאל,408,197,211,55,353,87,403,12,4%
2013-10,אזור יהודה והשומרון,3574,בית אל,59,25,34,12,47,17,58,0,2%
2013-10,אזור יהודה והשומרון,3652,בית אריה,66,26,40,5,61,2,65,1,3%
2013-10,אזור יהודה והשומרון,3780,ביתר עילית,586,258,328,8,578,233,576,15,5%
2013-10,אזור יהודה והשומרון,3730,גבעת זאב,185,86,99,42,143,42,183,1,3%
2013-10,אזור יהודה והשומרון,3769,הר אדר,32,13,19,14,18,3,32,0,2%
2013-10,אזור יהודה והשומרון,3797,מודיעין עילית,491,162,329,15,476,96,481,6,4%
2013-10,אזור יהודה והשומרון,3616,מעלה אדומים,780,323,457,52,728,209,763,12,4%
2013-10,אזור יהודה והשומרון,3660,עמנואל,74,37,37,0,74,51,73,3,7%
2013-10,אזור יהודה והשומרון,3557,קדומים,42,23,19,14,28,8,42,2,2%
2013-10,אזור יהודה והשומרון,3611,קריית ארבע,121,61,60,14,107,61,120,4,4%
2013-10,אזור יהודה והשומרון,3640,קרני שומרון,97,47,50,19,78,14,97,4,3%
2013-10,הדרום,31,אופקים,1532,663,869,77,1455,893,1507,58,12%
2013-10,הדרום,2600,אילת,1509,667,842,58,1451,595,1475,53,4%
2013-10,הדרום,70,אשדוד,7475,2986,4489,697,6778,3624,7330,253,7%
2013-10,הדרום,7100,אשקלון,4708,1893,2815,439,4269,2483,4425,129,7%
2013-10,הדרום,9000,באר שבע,7853,3495,4358,883,6970,4500,7628,245,7%
2013-10,הדרום,2200,דימונה,2349,1015,1334,118,2231,1423,2285,66,12%
2013-10,הדרום,1303,חורה,812,348,464,1,811,749,802,5,21%
2013-10,הדרום,831,ירוחם,541,251,290,18,523,286,515,25,11%
2013-10,הדרום,1059,כסיפה,1013,433,580,1,1012,902,1003,16,22%
2013-10,הדרום,1271,להבים,71,28,43,29,42,7,71,0,2%
2013-10,הדרום,1060,לקיה,1012,451,561,2,1010,938,1009,1,25%
2013-10,הדרום,1268,מיתר,99,47,52,26,73,7,96,0,2%
2013-10,הדרום,99,מצפה רמון,289,116,173,12,277,179,274,13,11%
2013-10,הדרום,246,נתיבות,1232,508,724,59,1173,592,1186,22,9%
2013-10,הדרום,666,עומר,64,28,36,20,44,7,64,1,2%
2013-10,הדרום,2560,ערד,849,400,449,84,765,456,811,44,6%
2013-10,הדרום,1192,ערערה-בנגב,1046,421,625,2,1044,956,1038,2,26%
2013-10,הדרום,2630,קריית גת,2383,976,1407,130,2253,1388,2324,57,8%
2013-10,הדרום,1034,קריית מלאכי,1473,647,826,28,1445,761,1419,93,12%
2013-10,הדרום,1161,רהט,3320,1390,1930,5,3315,2821,3297,26,18%
2013-10,הדרום,1286,שגב-שלום,538,201,337,1,537,461,534,3,21%
2013-10,הדרום,1031,שדרות,1206,533,673,39,1167,671,1175,30,9%
2013-10,הדרום,1054,תל שבע,1254,607,647,0,1254,1148,1241,10,26%
2013-10,המרכז,182,אבן יהודה,177,72,105,50,127,17,177,1,3%
2013-10,המרכז,41,אליכין,68,34,34,5,63,21,66,0,4%
2013-10,המרכז,1309,אלעד,485,223,262,32,453,118,469,8,4%
2013-10,המרכז,2530,באר יעקב,292,112,180,59,233,59,287,4,3%
2013-10,המרכז,466,בית דגן,122,68,54,22,100,43,120,1,3%
2013-10,המרכז,1066,"בני עי""ש",202,97,105,20,182,73,201,7,5%
2013-10,המרכז,681,גבעת שמואל,327,152,175,109,218,74,316,1,3%
2013-10,המרכז,2550,גדרה,414,167,247,77,337,109,410,4,4%
2013-10,המרכז,627,ג'לג'וליה,80,42,38,3,77,44,80,0,2%
2013-10,המרכז,166,גן יבנה,416,163,253,44,372,113,410,8,4%
2013-10,המרכז,229,גני תקווה,204,92,112,39,165,25,204,1,3%
2013-10,המרכז,9700,הוד השרון,719,304,415,205,514,76,705,7,3%
2013-10,המרכז,1290,זמר,183,61,122,0,183,133,182,5,6%
2013-10,המרכז,2730,טייבה,2155,939,1216,13,2142,1808,2102,23,12%
2013-10,המרכז,2720,טירה,332,147,185,12,320,174,323,6,3%
2013-10,המרכז,2660,יבנה,1069,486,583,76,993,382,1051,23,5%
2013-10,המרכז,9400,יהוד,617,262,355,77,540,89,593,16,4%
2013-10,המרכז,1224,כוכב יאיר,104,54,50,41,63,2,102,2,2%
2013-10,המרכז,633,כפר ברא,29,13,16,2,27,14,29,0,2%
2013-10,המרכז,168,כפר יונה,375,174,201,59,316,64,372,7,4%
2013-10,המרכז,6900,כפר סבא,1436,661,775,347,1089,184,1413,22,3%
2013-10,המרכז,634,כפר קאסם,255,134,121,1,254,149,251,5,3%
2013-10,המרכז,7000,לוד,2357,1094,1263,158,2199,1252,2322,49,7%
2013-10,המרכז,1200,מודיעין-מכבים-רעות*,1223,541,682,295,928,69,1200,16,3%
2013-10,המרכז,28,מזכרת בתיה,172,62,110,41,131,40,170,4,3%
2013-10,המרכז,7200,נס ציונה,790,322,468,174,616,211,784,10,3%
2013-10,המרכז,7400,נתניה,4854,2236,2618,495,4359,1628,4749,107,5%
2013-10,המרכז,587,סביון*,23,8,15,8,15,0,23,0,1%
2013-10,המרכז,171,פרדסייה,85,36,49,14,71,9,85,3,2%
2013-10,המרכז,7900,פתח תקווה,4462,1944,2518,771,3691,1152,4392,74,4%
2013-10,המרכז,195,קדימה-צורן,255,100,155,59,196,39,254,0,3%
2013-10,המרכז,638,קלנסווה,856,338,518,7,849,724,824,4,10%
2013-10,המרכז,469,קריית עקרון,352,162,190,26,326,142,349,7,6%
2013-10,המרכז,2640,ראש העין,845,389,456,89,756,170,827,21,4%
2013-10,המרכז,8300,ראשון לציון,4805,2200,2605,782,4023,1478,4756,104,4%
2013-10,המרכז,8400,רחובות,2843,1291,1552,515,2328,1043,2781,45,4%
2013-10,המרכז,8500,רמלה,1966,893,1073,103,1863,803,1909,60,5%
2013-10,המרכז,8700,רעננה,890,413,477,281,609,86,879,10,2%
2013-10,המרכז,1304,שוהם,225,93,132,73,152,8,224,0,2%
2013-10,המרכז,154,תל מונד,146,57,89,33,113,25,144,2,2%
2013-10,הצפון,473,אבו סנאן,720,281,439,5,715,611,715,12,13%
2013-10,הצפון,478,אכסאל,532,227,305,12,520,463,526,2,10%
2013-10,הצפון,529,אעבלין,634,251,383,4,630,529,630,8,12%
2013-10,הצפון,482,בועיינה-נוג'ידאת,417,170,247,3,414,349,405,7,11%
2013-10,הצפון,4001,בוקעאתא,395,155,240,4,391,341,381,2,14%
2013-10,הצפון,998,ביר אל-מכסור,415,148,267,1,414,330,413,6,12%
2013-10,הצפון,480,בית ג'ן,382,118,264,9,373,292,374,1,7%
2013-10,הצפון,9200,בית שאן,940,406,534,18,922,457,906,68,9%
2013-10,הצפון,944,בסמת טבעון,237,104,133,1,236,180,235,1,8%
2013-10,הצפון,483,בענה,417,164,253,2,415,347,416,8,13%
2013-10,הצפון,1292,ג'דיידה-מכר,1477,631,846,5,1472,1265,1467,43,17%
2013-10,הצפון,485,ג'ולס,208,62,146,3,205,153,207,1,8%
2013-10,הצפון,487,ג'ש (גוש חלב),67,37,30,3,64,31,66,0,4%
2013-10,הצפון,489,דבורייה,422,183,239,15,407,309,417,4,10%
2013-10,הצפון,490,דייר אל-אסד,378,141,237,7,371,313,378,5,8%
2013-10,הצפון,492,דייר חנא,622,256,366,9,613,499,622,0,13%
2013-10,הצפון,975,זרזיר,316,136,180,2,314,225,304,4,11%
2013-10,הצפון,496,חורפיש,128,57,71,4,124,66,126,3,5%
2013-10,הצפון,2034,חצור הגלילית,319,133,186,12,307,146,294,5,6%
2013-10,הצפון,6700,טבריה,1953,850,1103,67,1886,1125,1741,74,8%
2013-10,הצפון,962,טובא-זנגרייה,369,143,226,2,367,251,358,4,12%
2013-10,הצפון,498,טורעאן,531,197,334,8,523,450,515,7,10%
2013-10,הצפון,8900,טמרה,2025,812,1213,16,2009,1776,2006,9,15%
2013-10,הצפון,1295,יאנוח-ג'ת,145,55,90,4,141,95,144,2,6%
2013-10,הצפון,46,יבנאל,168,106,62,6,162,122,146,1,9%
2013-10,הצפון,499,יפיע,665,291,374,14,651,520,656,6,9%
2013-10,הצפון,240,יקנעם עילית,598,232,366,48,550,177,592,26,5%
2013-10,הצפון,502,ירכא,534,207,326,0,534,439,532,7,10%
2013-10,הצפון,504,כאבול,705,280,425,8,697,612,699,0,15%
2013-10,הצפון,505,כאוכב אבו אל-היג'א,230,96,134,4,226,194,229,2,14%
2013-10,הצפון,1296,כסרא-סמיע,203,88,115,3,200,147,199,3,6%
2013-10,הצפון,978,כעביה-טבאש-חג'אג'רה,209,74,135,3,206,151,202,6,9%
2013-10,הצפון,1263,כפר ורדים,61,21,40,17,44,9,59,2,2%
2013-10,הצפון,507,כפר יאסיף,505,203,302,4,501,403,496,5,10%
2013-10,הצפון,508,כפר כמא,71,30,41,3,68,36,69,1,4%
2013-10,הצפון,509,כפר כנא,1143,446,697,17,1126,997,1111,8,13%
2013-10,הצפון,510,כפר מנדא,984,445,539,14,970,741,960,23,14%
2013-10,הצפון,47,כפר תבור,53,25,28,10,43,4,52,1,3%
2013-10,הצפון,1139,כרמיאל,1822,728,1094,305,1517,873,1744,73,7%
2013-10,הצפון,481,מגאר,1399,546,853,12,1387,1254,1381,2,16%
2013-10,הצפון,516,מג'ד אל-כרום,551,234,317,3,548,449,547,12,9%
2013-10,הצפון,874,מגדל העמק,1165,463,702,65,1100,473,1057,96,8%
2013-10,הצפון,4201,מג'דל שמס,468,164,304,13,455,401,458,0,10%
2013-10,הצפון,517,מזרעה,171,63,108,4,167,134,169,2,9%
2013-10,הצפון,4203,מסעדה,189,70,119,5,184,162,188,1,12%
2013-10,הצפון,518,מעיליא,58,26,32,6,52,23,56,0,4%
2013-10,הצפון,1063,מעלות-תרשיחא,953,441,512,83,870,512,929,33,8%
2013-10,הצפון,520,משהד,270,93,177,6,264,242,264,5,9%
2013-10,הצפון,9100,נהרייה,2103,947,1156,176,1927,1218,2064,95,7%
2013-10,הצפון,522,נחף,415,190,225,6,409,340,410,7,9%
2013-10,הצפון,7300,נצרת,3299,1414,1885,96,3203,2579,3250,29,10%
2013-10,הצפון,1061,נצרת עילית,2050,878,1172,176,1874,1080,1885,125,8%
2013-10,הצפון,525,סאג'ור,95,40,55,3,92,63,94,0,6%
2013-10,הצפון,7500,סח'נין,2007,866,1141,14,1993,1721,2001,8,15%
2013-10,הצפון,4501,ע'ג'ר,80,33,47,0,80,64,79,0,8%
2013-10,הצפון,530,עיילבון,206,81,125,4,202,147,204,0,8%
2013-10,הצפון,511,עילוט,308,121,187,0,308,256,304,0,11%
2013-10,הצפון,532,עין מאהל,595,266,329,6,589,499,578,4,12%
2013-10,הצפון,7600,עכו,3339,1482,1857,103,3236,2480,3271,54,12%
2013-10,הצפון,7700,עפולה,2022,837,1185,198,1824,876,1938,113,8%
2013-10,הצפון,531,עראבה,1482,614,868,23,1459,1300,1472,19,15%
2013-10,הצפון,535,פסוטה,124,56,68,8,116,87,124,3,8%
2013-10,הצפון,536,פקיעין (בוקייעה),127,68,59,4,123,80,126,2,5%
2013-10,הצפון,8000,צפת,1659,858,801,66,1593,1150,1603,43,12%
2013-10,הצפון,4100,קצרין,191,78,113,20,171,93,188,8,5%
2013-10,הצפון,2800,קריית שמונה,969,416,553,42,927,352,934,39,7%
2013-10,הצפון,543,ראמה,322,120,202,10,312,247,315,4,8%
2013-10,הצפון,26,ראש פינה,56,19,37,10,46,20,54,0,3%
2013-10,הצפון,542,ריינה,674,263,411,7,667,562,659,5,10%
2013-10,הצפון,122,רמת ישי,120,50,70,27,93,14,116,1,3%
2013-10,הצפון,913,שבלי - אום אל-גנם,222,101,121,6,216,156,221,1,9%
2013-10,הצפון,812,שלומי,259,110,149,12,247,138,254,5,7%
2013-10,הצפון,538,שעב,517,210,307,1,516,457,516,2,18%
2013-10,הצפון,8800,שפרעם,2030,765,1265,26,2004,1703,2013,58,12%
2013-10,חיפה,2710,אום אל-פחם,3793,1504,2289,17,3776,3300,3750,17,19%
2013-10,חיפה,1020,אור עקיבא,658,266,392,52,606,233,632,31,6%
2013-10,חיפה,6000,באקה אל-גרביה,733,340,393,5,728,473,730,11,7%
2013-10,חיפה,9800,בנימינה-גבעת עדה*,240,88,152,50,190,62,238,1,3%
2013-10,חיפה,1326,"בסמ""ה",435,181,254,3,432,357,432,3,11%
2013-10,חיפה,541,ג'סר א-זרקא,431,227,204,0,431,305,428,3,7%
2013-10,חיפה,628,ג'ת,284,143,141,15,269,156,283,14,6%
2013-10,חיפה,494,דאלית אל-כרמל,501,204,297,9,492,297,489,2,6%
2013-10,חיפה,9300,זכרון יעקב,278,117,161,70,208,57,278,0,3%
2013-10,חיפה,6500,חדרה,2694,1089,1605,251,2443,985,2635,72,5%
2013-10,חיפה,4000,חיפה,7058,3285,3773,1054,6004,3698,6848,194,5%
2013-10,חיפה,1247,חריש,22,8,14,4,18,8,20,0,1%
2013-10,חיפה,2100,טירת כרמל,748,342,406,20,728,457,736,25,7%
2013-10,חיפה,654,כפר קרע,412,184,228,5,407,251,405,10,5%
2013-10,חיפה,1327,מעלה עירון,954,371,583,6,948,820,948,3,17%
2013-10,חיפה,2500,נשר,544,253,291,86,458,217,534,18,4%
2013-10,חיפה,534,עספיא,342,142,200,11,331,173,337,9,6%
2013-10,חיפה,637,ערערה,615,240,375,5,610,414,598,14,8%
2013-10,חיפה,537,פוריידיס,412,199,213,8,404,271,407,0,8%
2013-10,חיפה,7800,פרדס חנה-כרכור,902,388,514,116,786,275,887,36,5%
2013-10,חיפה,6800,קריית אתא,1851,808,1043,127,1724,976,1826,60,6%
2013-10,חיפה,9500,קריית ביאליק,1277,519,758,134,1143,630,1267,42,6%
2013-10,חיפה,2300,קריית טבעון,192,88,104,46,146,44,191,0,2%
2013-10,חיפה,9600,קריית ים,1697,776,921,142,1555,1008,1676,49,8%
2013-10,חיפה,8200,קריית מוצקין,1158,476,682,129,1029,538,1138,34,5%
2013-10,חיפה,922,רכסים,158,65,93,7,151,73,151,0,5%
2013-10,ירושלים,472,אבו גוש,258,131,127,8,250,179,256,4,9%
2013-10,ירושלים,2610,בית שמש,1522,666,856,90,1432,580,1471,53,5%
2013-10,ירושלים,3000,ירושלים,12700,5608,7092,1362,11338,7345,12447,161,4%
2013-10,ירושלים,1015,מבשרת ציון,415,192,223,62,353,165,410,6,3%
2013-10,ירושלים,1137,קריית יערים,42,21,21,3,39,19,41,0,3%
2013-10,תל אביב,2400,אור יהודה,903,395,508,34,869,262,872,35,5%
2013-10,תל אביב,565,אזור,190,91,99,27,163,34,187,3,3%
2013-10,תל אביב,6100,בני ברק,2638,1241,1397,114,2524,1409,2559,36,5%
2013-10,תל אביב,6200,בת ים,3645,1707,1938,384,3261,1284,3523,102,5%
2013-10,תל אביב,6300,גבעתיים,779,336,443,242,537,97,771,5,3%
2013-10,תל אביב,6400,הרצלייה,1203,515,688,287,916,46,1189,30,3%
2013-10,תל אביב,6600,חולון,3537,1660,1877,446,3091,889,3458,90,4%
2013-10,תל אביב,2620,קריית אונו,464,194,270,101,363,43,461,4,3%
2013-10,תל אביב,8600,רמת גן,2320,1071,1249,518,1802,472,2273,29,3%
2013-10,תל אביב,2650,רמת השרון,401,160,241,130,271,12,395,5,2%
2013-10,תל אביב,5000,תל אביב -יפו,8703,4240,4463,2114,6589,2466,8552,147,3%
2013-11,אזור יהודה והשומרון,3760,אורנית,94,38,56,34,60,3,93,0,2%
2013-11,אזור יהודה והשומרון,3750,אלפי מנשה,109,47,62,17,92,4,109,1,3%
2013-11,אזור יהודה והשומרון,3560,אלקנה,41,19,22,18,23,2,40,0,2%
2013-11,אזור יהודה והשומרון,3650,אפרת,49,22,27,12,37,3,49,0,1%
2013-11,אזור יהודה והשומרון,3570,אריאל,367,183,184,47,320,82,366,7,4%
2013-11,אזור יהודה והשומרון,3574,בית אל,59,22,37,13,46,15,59,0,2%
2013-11,אזור יהודה והשומרון,3652,בית אריה,55,24,31,6,49,3,54,0,2%
2013-11,אזור יהודה והשומרון,3780,ביתר עילית,536,250,286,8,528,228,533,6,5%
2013-11,אזור יהודה והשומרון,3730,גבעת זאב,173,79,94,34,139,43,172,3,2%
2013-11,אזור יהודה והשומרון,3769,הר אדר,29,11,18,14,15,3,29,0,1%
2013-11,אזור יהודה והשומרון,3797,מודיעין עילית,431,156,275,17,414,88,423,3,3%
2013-11,אזור יהודה והשומרון,3616,מעלה אדומים,729,306,423,53,676,203,713,17,4%
2013-11,אזור יהודה והשומרון,3660,עמנואל,71,38,33,0,71,52,70,0,6%
2013-11,אזור יהודה והשומרון,3557,קדומים,38,24,14,15,23,8,38,0,2%
2013-11,אזור יהודה והשומרון,3611,קריית ארבע,112,58,54,13,99,60,111,3,4%
2013-11,אזור יהודה והשומרון,3640,קרני שומרון,86,43,43,14,72,11,85,2,2%
2013-11,הדרום,31,אופקים,1368,593,775,70,1298,868,1347,39,11%
2013-11,הדרום,2600,אילת,1398,620,778,46,1352,551,1373,49,4%
2013-11,הדרום,70,אשדוד,6977,2877,4100,673,6304,3506,6832,206,6%
2013-11,הדרום,7100,אשקלון,4406,1834,2572,393,4013,2375,4126,119,6%
2013-11,הדרום,9000,באר שבע,7249,3216,4033,854,6395,4332,7041,178,7%
2013-11,הדרום,2200,דימונה,2136,942,1194,114,2022,1386,2074,64,11%
2013-11,הדרום,1303,חורה,791,336,455,2,789,734,783,9,20%
2013-11,הדרום,831,ירוחם,479,216,263,17,462,270,462,25,10%
2013-11,הדרום,1059,כסיפה,1002,422,580,1,1001,898,995,9,22%
2013-11,הדרום,1271,להבים,64,26,38,25,39,5,64,0,2%
2013-11,הדרום,1060,לקיה,1008,457,551,2,1006,935,1001,23,25%
2013-11,הדרום,1268,מיתר,68,32,36,24,44,6,67,0,2%
2013-11,הדרום,99,מצפה רמון,290,126,164,13,277,174,270,14,11%
2013-11,הדרום,246,נתיבות,1071,463,608,42,1029,548,1041,28,8%
2013-11,הדרום,666,עומר,52,21,31,16,36,6,51,1,1%
2013-11,הדרום,2560,ערד,849,383,466,83,766,436,811,39,6%
2013-11,הדרום,1192,ערערה-בנגב,1036,418,618,2,1034,950,1026,40,26%
2013-11,הדרום,2630,קריית גת,2235,918,1317,119,2116,1310,2194,36,8%
2013-11,הדרום,1034,קריית מלאכי,1262,548,714,22,1240,749,1226,55,10%
2013-11,הדרום,1161,רהט,3184,1322,1862,5,3179,2765,3163,45,18%
2013-11,הדרום,1286,שגב-שלום,541,216,325,0,541,462,534,5,21%
2013-11,הדרום,1031,שדרות,1122,500,622,28,1094,650,1092,21,9%
2013-11,הדרום,1054,תל שבע,1212,591,621,0,1212,1124,1201,12,26%
2013-11,המרכז,182,אבן יהודה,174,71,103,47,127,21,174,2,3%
2013-11,המרכז,41,אליכין,62,36,26,7,55,20,60,1,3%
2013-11,המרכז,1309,אלעד,454,211,243,31,423,117,443,5,4%
2013-11,המרכז,2530,באר יעקב,269,115,154,58,211,56,268,2,3%
2013-11,המרכז,466,בית דגן,107,59,48,18,89,45,106,1,3%
2013-11,המרכז,1066,"בני עי""ש",181,89,92,22,159,73,179,6,5%
2013-11,המרכז,681,גבעת שמואל,300,143,157,94,206,70,290,3,3%
2013-11,המרכז,2550,גדרה,371,148,223,64,307,105,365,3,3%
2013-11,המרכז,627,ג'לג'וליה,86,40,46,1,85,46,86,0,3%
2013-11,המרכז,166,גן יבנה,374,149,225,38,336,99,369,9,3%
2013-11,המרכז,229,גני תקווה,201,96,105,41,160,28,201,2,2%
2013-11,המרכז,9700,הוד השרון,705,307,398,197,508,76,695,7,2%
2013-11,המרכז,1290,זמר,174,58,116,0,174,125,172,4,6%
2013-11,המרכז,2730,טייבה,2080,876,1204,14,2066,1766,2024,21,12%
2013-11,המרכז,2720,טירה,328,149,179,6,322,173,323,9,3%
2013-11,המרכז,2660,יבנה,969,450,519,66,903,372,952,45,4%
2013-11,המרכז,9400,יהוד,540,232,308,84,456,77,532,12,3%
2013-11,המרכז,1224,כוכב יאיר,102,49,53,44,58,2,100,3,2%
2013-11,המרכז,633,כפר ברא,25,11,14,1,24,13,25,0,2%
2013-11,המרכז,168,כפר יונה,335,160,175,50,285,62,332,10,3%
2013-11,המרכז,6900,כפר סבא,1335,589,746,322,1013,180,1317,31,3%
2013-11,המרכז,634,כפר קאסם,284,154,130,1,283,155,279,3,3%
2013-11,המרכז,7000,לוד,2226,1012,1214,151,2075,1200,2200,43,6%
2013-11,המרכז,1200,מודיעין-מכבים-רעות*,1092,491,601,284,808,63,1069,14,3%
2013-11,המרכז,28,מזכרת בתיה,161,66,95,35,126,39,159,2,2%
2013-11,המרכז,7200,נס ציונה,718,300,418,157,561,216,713,7,3%
2013-11,המרכז,7400,נתניה,4467,2093,2374,474,3993,1607,4384,102,4%
2013-11,המרכז,587,סביון*,23,7,16,9,14,0,23,0,1%
2013-11,המרכז,171,פרדסייה,81,32,49,12,69,12,81,0,2%
2013-11,המרכז,7900,פתח תקווה,4203,1857,2346,773,3430,1081,4140,50,3%
2013-11,המרכז,195,קדימה-צורן,258,106,152,52,206,41,256,1,3%
2013-11,המרכז,638,קלנסווה,818,316,502,3,815,691,794,11,10%
2013-11,המרכז,469,קריית עקרון,316,154,162,23,293,138,314,10,5%
2013-11,המרכז,2640,ראש העין,785,374,411,86,699,162,773,16,3%
2013-11,המרכז,8300,ראשון לציון,4422,2009,2413,757,3665,1396,4380,68,3%
2013-11,המרכז,8400,רחובות,2672,1207,1465,473,2199,1003,2619,50,4%
2013-11,המרכז,8500,רמלה,1795,835,960,88,1707,758,1750,50,5%
2013-11,המרכז,8700,רעננה,839,396,443,270,569,80,828,6,2%
2013-11,המרכז,1304,שוהם,206,86,120,80,126,11,204,1,2%
2013-11,המרכז,154,תל מונד,148,64,84,35,113,19,148,0,3%
2013-11,הצפון,473,אבו סנאן,718,285,433,4,714,608,715,15,13%
2013-11,הצפון,478,אכסאל,528,226,302,11,517,451,523,3,10%
2013-11,הצפון,529,אעבלין,629,247,382,3,626,527,626,7,11%
2013-11,הצפון,482,בועיינה-נוג'ידאת,402,163,239,2,400,334,395,8,11%
2013-11,הצפון,4001,בוקעאתא,385,142,243,4,381,337,375,0,14%
2013-11,הצפון,998,ביר אל-מכסור,415,154,261,1,414,331,413,4,12%
2013-11,הצפון,480,בית ג'ן,378,120,258,9,369,285,372,0,7%
2013-11,הצפון,9200,בית שאן,836,373,463,17,819,421,807,57,8%
2013-11,הצפון,944,בסמת טבעון,230,105,125,1,229,176,228,5,7%
2013-11,הצפון,483,בענה,408,159,249,2,406,342,406,8,13%
2013-11,הצפון,1292,ג'דיידה-מכר,1442,610,832,5,1437,1261,1429,44,16%
2013-11,הצפון,485,ג'ולס,197,58,139,2,195,149,196,0,7%
2013-11,הצפון,487,ג'ש (גוש חלב),70,37,33,1,69,32,70,2,4%
2013-11,הצפון,489,דבורייה,397,174,223,13,384,304,393,3,10%
2013-11,הצפון,490,דייר אל-אסד,390,155,235,8,382,317,390,6,8%
2013-11,הצפון,492,דייר חנא,623,260,363,10,613,496,623,3,13%
2013-11,הצפון,975,זרזיר,297,130,167,1,296,212,283,5,10%
2013-11,הצפון,496,חורפיש,117,47,70,4,113,61,115,2,4%
2013-11,הצפון,2034,חצור הגלילית,321,131,190,14,307,152,294,10,6%
2013-11,הצפון,6700,טבריה,1799,807,992,62,1737,1081,1585,53,7%
2013-11,הצפון,962,טובא-זנגרייה,366,158,208,2,364,252,355,2,12%
2013-11,הצפון,498,טורעאן,525,197,328,10,515,455,505,15,9%
2013-11,הצפון,8900,טמרה,1984,794,1190,13,1971,1753,1966,28,15%
2013-11,הצפון,1295,יאנוח-ג'ת,159,57,102,6,153,103,157,2,6%
2013-11,הצפון,46,יבנאל,168,107,61,5,163,130,145,0,9%
2013-11,הצפון,499,יפיע,657,289,368,13,644,519,648,10,9%
2013-11,הצפון,240,יקנעם עילית,531,205,326,40,491,171,524,29,5%
2013-11,הצפון,502,ירכא,545,211,333,0,545,442,541,5,10%
2013-11,הצפון,504,כאבול,714,281,433,7,707,620,709,0,15%
2013-11,הצפון,505,כאוכב אבו אל-היג'א,227,94,133,4,223,195,226,2,14%
2013-11,הצפון,1296,כסרא-סמיע,199,86,113,4,195,150,196,2,6%
2013-11,הצפון,978,כעביה-טבאש-חג'אג'רה,208,75,133,3,205,146,204,9,9%
2013-11,הצפון,1263,כפר ורדים,45,19,26,20,25,5,45,0,1%
2013-11,הצפון,507,כפר יאסיף,504,203,301,4,500,403,495,15,10%
2013-11,הצפון,508,כפר כמא,62,23,39,2,60,36,60,1,4%
2013-11,הצפון,509,כפר כנא,1113,440,673,19,1094,980,1070,20,13%
2013-11,הצפון,510,כפר מנדא,973,439,534,13,960,737,952,13,14%
2013-11,הצפון,47,כפר תבור,47,23,24,5,42,1,45,0,2%
2013-11,הצפון,1139,כרמיאל,1698,665,1033,296,1402,833,1621,69,6%
2013-11,הצפון,481,מגאר,1389,540,849,13,1376,1244,1370,2,16%
2013-11,הצפון,516,מג'ד אל-כרום,564,248,316,4,560,451,557,12,9%
2013-11,הצפון,874,מגדל העמק,1046,414,632,55,991,458,935,77,7%
2013-11,הצפון,4201,מג'דל שמס,480,175,305,13,467,405,469,1,10%
2013-11,הצפון,517,מזרעה,171,64,107,3,168,135,169,5,9%
2013-11,הצפון,4203,מסעדה,191,71,120,3,188,161,188,0,12%
2013-11,הצפון,518,מעיליא,56,25,31,3,53,24,55,3,4%
2013-11,הצפון,1063,מעלות-תרשיחא,894,420,474,82,812,521,879,22,7%
2013-11,הצפון,520,משהד,269,99,170,4,265,240,262,1,9%
2013-11,הצפון,9100,נהרייה,2052,918,1134,171,1881,1213,2009,87,7%
2013-11,הצפון,522,נחף,398,183,215,6,392,322,395,6,8%
2013-11,הצפון,7300,נצרת,3213,1380,1833,89,3124,2540,3172,40,9%
2013-11,הצפון,1061,נצרת עילית,1863,782,1081,157,1706,1039,1709,105,7%
2013-11,הצפון,525,סאג'ור,102,42,60,2,100,63,101,2,6%
2013-11,הצפון,7500,סח'נין,2014,861,1153,18,1996,1722,2010,16,15%
2013-11,הצפון,4501,ע'ג'ר,84,35,49,0,84,66,84,1,9%
2013-11,הצפון,530,עיילבון,214,87,127,4,210,153,210,0,8%
2013-11,הצפון,511,עילוט,311,121,190,0,311,257,310,2,11%
2013-11,הצפון,532,עין מאהל,586,261,325,8,578,491,567,1,12%
2013-11,הצפון,7600,עכו,3259,1484,1775,99,3160,2441,3197,55,12%
2013-11,הצפון,7700,עפולה,1821,792,1029,180,1641,833,1742,88,7%
2013-11,הצפון,531,עראבה,1458,590,868,15,1443,1288,1449,8,15%
2013-11,הצפון,535,פסוטה,125,49,76,5,120,88,125,1,8%
2013-11,הצפון,536,פקיעין (בוקייעה),123,67,56,5,118,81,122,1,5%
2013-11,הצפון,8000,צפת,1523,797,726,67,1456,1112,1475,23,11%
2013-11,הצפון,4100,קצרין,185,71,114,17,168,93,184,7,5%
2013-11,הצפון,2800,קריית שמונה,874,388,486,45,829,352,843,30,6%
2013-11,הצפון,543,ראמה,318,120,198,9,309,237,312,0,8%
2013-11,הצפון,26,ראש פינה,58,18,40,12,46,21,56,1,4%
2013-11,הצפון,542,ריינה,673,270,403,5,668,568,656,6,10%
2013-11,הצפון,122,רמת ישי,95,36,59,28,67,11,91,1,2%
2013-11,הצפון,913,שבלי - אום אל-גנם,227,108,119,6,221,154,225,3,9%
2013-11,הצפון,812,שלומי,246,106,140,10,236,136,237,6,7%
2013-11,הצפון,538,שעב,519,208,311,1,518,454,518,2,18%
2013-11,הצפון,8800,שפרעם,2003,757,1246,23,1980,1683,1986,16,12%
2013-11,חיפה,2710,אום אל-פחם,3751,1495,2256,17,3734,3274,3697,3,18%
2013-11,חיפה,1020,אור עקיבא,596,236,360,45,551,217,577,10,6%
2013-11,חיפה,6000,באקה אל-גרביה,726,337,389,3,723,473,718,16,6%
2013-11,חיפה,9800,בנימינה-גבעת עדה*,241,90,151,56,185,62,240,1,4%
2013-11,חיפה,1326,"בסמ""ה",423,174,249,3,420,354,420,1,11%
2013-11,חיפה,541,ג'סר א-זרקא,424,227,197,0,424,303,421,2,7%
2013-11,חיפה,628,ג'ת,262,131,131,13,249,151,261,8,5%
2013-11,חיפה,494,דאלית אל-כרמל,508,212,296,11,497,304,496,8,7%
2013-11,חיפה,9300,זכרון יעקב,265,116,149,58,207,59,265,0,3%
2013-11,חיפה,6500,חדרה,2501,1037,1464,252,2249,958,2441,52,5%
2013-11,חיפה,4000,חיפה,6727,3173,3554,1002,5725,3598,6537,191,5%
2013-11,חיפה,1247,חריש,24,13,11,4,20,8,20,0,1%
2013-11,חיפה,2100,טירת כרמל,744,357,387,20,724,444,732,18,7%
2013-11,חיפה,654,כפר קרע,407,174,233,6,401,242,403,9,5%
2013-11,חיפה,1327,מעלה עירון,926,357,569,5,921,803,919,4,16%
2013-11,חיפה,2500,נשר,490,236,254,79,411,192,482,10,4%
2013-11,חיפה,534,עספיא,340,134,206,10,330,178,336,3,6%
2013-11,חיפה,637,ערערה,580,221,359,6,574,410,569,11,7%
2013-11,חיפה,537,פוריידיס,408,196,212,8,400,272,403,0,8%
2013-11,חיפה,7800,פרדס חנה-כרכור,864,408,456,107,757,278,851,16,4%
2013-11,חיפה,6800,קריית אתא,1714,771,943,113,1601,930,1693,56,6%
2013-11,חיפה,9500,קריית ביאליק,1206,507,699,122,1084,609,1198,43,6%
2013-11,חיפה,2300,קריית טבעון,182,81,101,54,128,46,179,2,2%
2013-11,חיפה,9600,קריית ים,1609,748,861,127,1482,973,1588,45,7%
2013-11,חיפה,8200,קריית מוצקין,1111,465,646,123,988,517,1095,26,5%
2013-11,חיפה,922,רכסים,144,60,84,7,137,72,135,1,4%
2013-11,ירושלים,472,אבו גוש,255,128,127,6,249,182,254,3,9%
2013-11,ירושלים,2610,בית שמש,1379,623,756,85,1294,547,1333,35,4%
2013-11,ירושלים,3000,ירושלים,12160,5393,6767,1293,10867,7259,11911,162,4%
2013-11,ירושלים,1015,מבשרת ציון,384,172,212,61,323,162,381,4,3%
2013-11,ירושלים,1137,קריית יערים,35,18,17,4,31,18,34,0,3%
2013-11,תל אביב,2400,אור יהודה,865,409,456,33,832,268,827,37,4%
2013-11,תל אביב,565,אזור,185,102,83,24,161,32,182,3,3%
2013-11,תל אביב,6100,בני ברק,2416,1169,1247,105,2311,1376,2345,34,4%
2013-11,תל אביב,6200,בת ים,3424,1624,1800,377,3047,1256,3316,97,5%
2013-11,תל אביב,6300,גבעתיים,754,337,417,252,502,103,747,7,3%
2013-11,תל אביב,6400,הרצלייה,1092,472,620,257,835,31,1078,31,2%
2013-11,תל אביב,6600,חולון,3366,1596,1770,431,2935,863,3290,83,3%
2013-11,תל אביב,2620,קריית אונו,440,187,253,95,345,46,435,2,2%
2013-11,תל אביב,8600,רמת גן,2203,1017,1186,532,1671,456,2161,27,3%
2013-11,תל אביב,2650,רמת השרון,385,164,221,120,265,7,381,9,2%
2013-11,תל אביב,5000,תל אביב -יפו,8258,4064,4194,2096,6162,2416,8109,114,3%
2013-12,אזור יהודה והשומרון,3760,אורנית,108,45,63,39,69,3,107,0,2%
2013-12,אזור יהודה והשומרון,3750,אלפי מנשה,120,57,63,18,102,5,119,1,3%
2013-12,אזור יהודה והשומרון,3560,אלקנה,36,17,19,18,18,2,35,2,2%
2013-12,אזור יהודה והשומרון,3650,אפרת,44,25,19,10,34,1,44,1,1%
2013-12,אזור יהודה והשומרון,3570,אריאל,368,174,194,49,319,87,364,1,4%
2013-12,אזור יהודה והשומרון,3574,בית אל,61,24,37,15,46,18,60,3,3%
2013-12,אזור יהודה והשומרון,3652,בית אריה,62,23,39,10,52,3,62,0,3%
2013-12,אזור יהודה והשומרון,3780,ביתר עילית,531,246,285,7,524,229,528,6,5%
2013-12,אזור יהודה והשומרון,3730,גבעת זאב,186,80,106,40,146,40,185,2,3%
2013-12,אזור יהודה והשומרון,3769,הר אדר,32,15,17,12,20,3,32,0,2%
2013-12,אזור יהודה והשומרון,3797,מודיעין עילית,462,164,298,24,438,91,451,9,3%
2013-12,אזור יהודה והשומרון,3616,מעלה אדומים,715,302,413,48,667,211,706,15,4%
2013-12,אזור יהודה והשומרון,3660,עמנואל,72,41,31,0,72,49,71,2,6%
2013-12,אזור יהודה והשומרון,3557,קדומים,38,21,17,11,27,9,38,0,2%
2013-12,אזור יהודה והשומרון,3611,קריית ארבע,112,56,56,13,99,61,109,4,4%
2013-12,אזור יהודה והשומרון,3640,קרני שומרון,97,58,39,14,83,13,95,2,3%
2013-12,הדרום,31,אופקים,1343,586,757,75,1268,852,1319,39,10%
2013-12,הדרום,2600,אילת,1529,692,837,46,1483,580,1494,53,5%
2013-12,הדרום,70,אשדוד,7124,2972,4152,716,6408,3540,6970,234,6%
2013-12,הדרום,7100,אשקלון,4393,1840,2553,380,4013,2371,4086,100,6%
2013-12,הדרום,9000,באר שבע,7409,3326,4083,858,6551,4394,7183,182,7%
2013-12,הדרום,2200,דימונה,2204,968,1236,116,2088,1396,2137,59,12%
2013-12,הדרום,1303,חורה,816,361,455,4,812,750,808,2,21%
2013-12,הדרום,831,ירוחם,483,224,259,15,468,270,463,19,10%
2013-12,הדרום,1059,כסיפה,1023,436,587,2,1021,914,1009,3,23%
2013-12,הדרום,1271,להבים,57,24,33,22,35,5,56,2,2%
2013-12,הדרום,1060,לקיה,1006,449,557,0,1006,938,1001,4,25%
2013-12,הדרום,1268,מיתר,67,29,38,21,46,8,64,0,2%
2013-12,הדרום,99,מצפה רמון,285,119,166,10,275,173,270,13,11%
2013-12,הדרום,246,נתיבות,1143,506,637,46,1097,574,1105,61,8%
2013-12,הדרום,666,עומר,58,25,33,19,39,7,57,0,1%
2013-12,הדרום,2560,ערד,908,428,480,89,819,452,868,41,7%
2013-12,הדרום,1192,ערערה-בנגב,1021,432,589,2,1019,939,1011,18,25%
2013-12,הדרום,2630,קריית גת,2272,941,1331,121,2151,1310,2226,42,8%
2013-12,הדרום,1034,קריית מלאכי,1300,584,716,21,1279,765,1259,53,11%
2013-12,הדרום,1161,רהט,3280,1372,1908,4,3276,2826,3256,46,18%
2013-12,הדרום,1286,שגב-שלום,565,223,342,0,565,469,560,5,22%
2013-12,הדרום,1031,שדרות,1164,528,636,38,1126,653,1125,21,9%
2013-12,הדרום,1054,תל שבע,1251,616,635,0,1251,1142,1240,11,26%
2013-12,המרכז,182,אבן יהודה,170,74,96,51,119,20,168,2,3%
2013-12,המרכז,41,אליכין,70,37,33,7,63,18,67,3,4%
2013-12,המרכז,1309,אלעד,440,215,225,28,412,109,432,8,4%
2013-12,המרכז,2530,באר יעקב,278,116,162,60,218,58,277,6,3%
2013-12,המרכז,466,בית דגן,113,67,46,17,96,46,112,1,3%
2013-12,המרכז,1066,"בני עי""ש",180,82,98,15,165,71,178,6,5%
2013-12,המרכז,681,גבעת שמואל,302,146,156,88,214,70,293,2,3%
2013-12,המרכז,2550,גדרה,391,162,229,59,332,108,381,6,3%
2013-12,המרכז,627,ג'לג'וליה,92,40,52,1,91,57,86,2,3%
2013-12,המרכז,166,גן יבנה,380,166,214,38,342,102,372,9,3%
2013-12,המרכז,229,גני תקווה,209,99,110,47,162,24,208,2,3%
2013-12,המרכז,9700,הוד השרון,713,306,407,213,500,71,704,8,3%
2013-12,המרכז,1290,זמר,195,65,130,1,194,129,193,9,7%
2013-12,המרכז,2730,טייבה,2101,914,1187,15,2086,1761,2042,35,12%
2013-12,המרכז,2720,טירה,365,172,193,8,357,183,354,9,3%
2013-12,המרכז,2660,יבנה,1000,464,536,91,909,376,984,32,4%
2013-12,המרכז,9400,יהוד,561,247,314,83,478,82,546,21,4%
2013-12,המרכז,1224,כוכב יאיר,100,42,58,41,59,1,98,5,2%
2013-12,המרכז,633,כפר ברא,38,22,16,2,36,18,37,1,3%
2013-12,המרכז,168,כפר יונה,332,161,171,58,274,70,327,4,3%
2013-12,המרכז,6900,כפר סבא,1333,611,722,333,1000,183,1313,19,3%
2013-12,המרכז,634,כפר קאסם,278,145,133,2,276,152,274,2,3%
2013-12,המרכז,7000,לוד,2315,1067,1248,153,2162,1222,2273,45,6%
2013-12,המרכז,1200,מודיעין-מכבים-רעות*,1089,479,610,305,784,64,1057,26,3%
2013-12,המרכז,28,מזכרת בתיה,153,60,93,31,122,37,151,2,2%
2013-12,המרכז,7200,נס ציונה,750,326,424,165,585,213,746,8,3%
2013-12,המרכז,7400,נתניה,4643,2198,2445,596,4047,1649,4532,104,4%
2013-12,המרכז,587,סביון*,23,7,16,9,14,0,23,0,1%
2013-12,המרכז,171,פרדסייה,86,36,50,16,70,8,85,0,2%
2013-12,המרכז,7900,פתח תקווה,4306,1925,2381,812,3494,1102,4237,55,4%
2013-12,המרכז,195,קדימה-צורן,268,118,150,61,207,46,264,1,3%
2013-12,המרכז,638,קלנסווה,827,333,494,5,822,684,797,11,10%
2013-12,המרכז,469,קריית עקרון,337,166,171,25,312,137,336,1,6%
2013-12,המרכז,2640,ראש העין,792,392,400,88,704,169,777,10,3%
2013-12,המרכז,8300,ראשון לציון,4472,2051,2421,790,3682,1423,4431,96,3%
2013-12,המרכז,8400,רחובות,2668,1212,1456,483,2185,1020,2605,46,4%
2013-12,המרכז,8500,רמלה,1876,891,985,106,1770,793,1806,58,5%
2013-12,המרכז,8700,רעננה,833,405,428,263,570,68,827,5,2%
2013-12,המרכז,1304,שוהם,182,76,106,71,111,8,181,0,2%
2013-12,המרכז,154,תל מונד,156,68,88,51,105,20,156,0,3%
2013-12,הצפון,473,אבו סנאן,755,309,446,6,749,616,750,14,13%
2013-12,הצפון,478,אכסאל,545,233,312,13,532,464,536,2,10%
2013-12,הצפון,529,אעבלין,638,250,388,4,634,528,632,11,12%
2013-12,הצפון,482,בועיינה-נוג'ידאת,435,189,246,3,432,350,421,0,11%
2013-12,הצפון,4001,בוקעאתא,406,159,247,4,402,344,391,0,15%
2013-12,הצפון,998,ביר אל-מכסור,438,177,261,1,437,340,434,5,12%
2013-12,הצפון,480,בית ג'ן,413,131,282,11,402,308,405,1,8%
2013-12,הצפון,9200,בית שאן,849,374,475,16,833,420,829,51,8%
2013-12,הצפון,944,בסמת טבעון,233,115,118,2,231,171,232,3,8%
2013-12,הצפון,483,בענה,399,155,244,3,396,335,396,7,12%
2013-12,הצפון,1292,ג'דיידה-מכר,1472,628,844,6,1466,1255,1461,31,17%
2013-12,הצפון,485,ג'ולס,214,67,147,1,213,157,214,2,8%
2013-12,הצפון,487,ג'ש (גוש חלב),71,37,34,1,70,34,70,7,4%
2013-12,הצפון,489,דבורייה,410,181,229,14,396,314,405,3,10%
2013-12,הצפון,490,דייר אל-אסד,398,160,238,10,388,324,396,11,8%
2013-12,הצפון,492,דייר חנא,649,278,371,13,636,495,647,5,14%
2013-12,הצפון,975,זרזיר,323,148,175,3,320,223,307,5,11%
2013-12,הצפון,496,חורפיש,126,52,74,5,121,66,122,3,5%
2013-12,הצפון,2034,חצור הגלילית,339,138,201,14,325,156,316,17,7%
2013-12,הצפון,6700,טבריה,1872,842,1030,65,1807,1109,1627,52,8%
2013-12,הצפון,962,טובא-זנגרייה,381,165,216,2,379,258,371,5,13%
2013-12,הצפון,498,טורעאן,547,204,343,8,539,475,523,9,10%
2013-12,הצפון,8900,טמרה,2039,850,1189,17,2022,1790,2012,20,15%
2013-12,הצפון,1295,יאנוח-ג'ת,171,66,105,6,165,109,167,7,6%
2013-12,הצפון,46,יבנאל,167,112,55,7,160,128,146,0,9%
2013-12,הצפון,499,יפיע,671,297,374,12,659,526,662,14,9%
2013-12,הצפון,240,יקנעם עילית,560,215,345,45,515,173,551,35,5%
2013-12,הצפון,502,ירכא,557,226,331,0,557,448,554,5,10%
2013-12,הצפון,504,כאבול,710,294,416,9,701,614,703,4,15%
2013-12,הצפון,505,כאוכב אבו אל-היג'א,236,104,132,5,231,196,236,2,14%
2013-12,הצפון,1296,כסרא-סמיע,228,92,136,6,222,166,222,3,7%
2013-12,הצפון,978,כעביה-טבאש-חג'אג'רה,220,86,134,2,218,145,216,4,10%
2013-12,הצפון,1263,כפר ורדים,49,23,26,21,28,5,47,1,2%
2013-12,הצפון,507,כפר יאסיף,506,208,298,6,500,411,497,7,10%
2013-12,הצפון,508,כפר כמא,68,26,42,2,66,34,67,0,4%
2013-12,הצפון,509,כפר כנא,1158,451,707,19,1139,1021,1107,10,13%
2013-12,הצפון,510,כפר מנדא,993,458,535,11,982,744,964,3,14%
2013-12,הצפון,47,כפר תבור,44,19,25,6,38,2,41,1,2%
2013-12,הצפון,1139,כרמיאל,1793,701,1092,305,1488,887,1696,55,7%
2013-12,הצפון,481,מגאר,1422,566,856,15,1407,1250,1396,11,16%
2013-12,הצפון,516,מג'ד אל-כרום,564,257,307,3,561,448,558,17,9%
2013-12,הצפון,874,מגדל העמק,1067,439,628,55,1012,449,957,84,7%
2013-12,הצפון,4201,מג'דל שמס,497,184,313,11,486,413,483,3,10%
2013-12,הצפון,517,מזרעה,178,67,111,5,173,141,176,7,9%
2013-12,הצפון,4203,מסעדה,207,75,132,1,206,168,206,0,13%
2013-12,הצפון,518,מעיליא,57,27,30,3,54,27,57,1,4%
2013-12,הצפון,1063,מעלות-תרשיחא,934,451,483,83,851,537,919,36,8%
2013-12,הצפון,520,משהד,285,108,177,4,281,244,278,6,9%
2013-12,הצפון,9100,נהרייה,2027,928,1099,173,1854,1207,1985,71,7%
2013-12,הצפון,522,נחף,411,189,222,7,404,335,406,16,9%
2013-12,הצפון,7300,נצרת,3309,1440,1869,85,3224,2589,3254,31,10%
2013-12,הצפון,1061,נצרת עילית,1878,828,1050,157,1721,1071,1711,88,7%
2013-12,הצפון,525,סאג'ור,114,46,68,1,113,75,112,2,7%
2013-12,הצפון,7500,סח'נין,2073,897,1176,16,2057,1762,2066,12,15%
2013-12,הצפון,4501,ע'ג'ר,96,44,52,0,96,69,96,2,10%
2013-12,הצפון,530,עיילבון,217,87,130,3,214,151,214,1,8%
2013-12,הצפון,511,עילוט,317,126,191,3,314,258,313,0,12%
2013-12,הצפון,532,עין מאהל,597,267,330,10,587,491,575,7,12%
2013-12,הצפון,7600,עכו,3287,1495,1792,97,3190,2462,3205,61,12%
2013-12,הצפון,7700,עפולה,1805,778,1027,176,1629,848,1713,80,7%
2013-12,הצפון,531,עראבה,1481,597,884,19,1462,1290,1473,8,15%
2013-12,הצפון,535,פסוטה,128,55,73,7,121,90,127,3,8%
2013-12,הצפון,536,פקיעין (בוקייעה),125,65,60,5,120,84,124,2,5%
2013-12,הצפון,8000,צפת,1540,816,724,68,1472,1130,1484,32,11%
2013-12,הצפון,4100,קצרין,206,85,121,20,186,96,203,6,5%
2013-12,הצפון,2800,קריית שמונה,928,422,506,41,887,374,894,49,7%
2013-12,הצפון,543,ראמה,344,129,215,11,333,256,332,2,9%
2013-12,הצפון,26,ראש פינה,54,14,40,12,42,21,51,1,3%
2013-12,הצפון,542,ריינה,709,295,414,8,701,581,687,9,10%
2013-12,הצפון,122,רמת ישי,110,42,68,28,82,12,107,3,3%
2013-12,הצפון,913,שבלי - אום אל-גנם,268,134,134,6,262,165,264,4,10%
2013-12,הצפון,812,שלומי,273,116,157,12,261,151,267,13,7%
2013-12,הצפון,538,שעב,530,219,311,1,529,465,529,1,18%
2013-12,הצפון,8800,שפרעם,2071,813,1258,30,2041,1722,2045,46,12%
2013-12,חיפה,2710,אום אל-פחם,3849,1560,2289,19,3830,3308,3778,21,19%
2013-12,חיפה,1020,אור עקיבא,634,265,369,40,594,223,611,26,6%
2013-12,חיפה,6000,באקה אל-גרביה,779,372,407,4,775,484,771,28,7%
2013-12,חיפה,9800,בנימינה-גבעת עדה*,243,92,151,57,186,69,242,0,4%
2013-12,חיפה,1326,"בסמ""ה",434,181,253,3,431,360,430,2,11%
2013-12,חיפה,541,ג'סר א-זרקא,421,230,191,0,421,306,418,3,7%
2013-12,חיפה,628,ג'ת,284,141,143,13,271,162,281,5,6%
2013-12,חיפה,494,דאלית אל-כרמל,523,225,298,11,512,297,513,7,7%
2013-12,חיפה,9300,זכרון יעקב,275,120,155,58,217,56,274,2,3%
2013-12,חיפה,6500,חדרה,2610,1108,1502,266,2344,999,2521,65,5%
2013-12,חיפה,4000,חיפה,6882,3299,3583,1115,5767,3669,6676,206,5%
2013-12,חיפה,1247,חריש,25,13,12,4,21,9,21,1,1%
2013-12,חיפה,2100,טירת כרמל,757,360,397,19,738,472,742,23,7%
2013-12,חיפה,654,כפר קרע,441,192,249,7,434,258,437,12,5%
2013-12,חיפה,1327,מעלה עירון,956,378,578,5,951,818,949,4,17%
2013-12,חיפה,2500,נשר,499,238,261,87,412,212,488,13,4%
2013-12,חיפה,534,עספיא,343,148,195,12,331,180,336,4,6%
2013-12,חיפה,637,ערערה,628,241,387,6,622,425,615,12,8%
2013-12,חיפה,537,פוריידיס,439,223,216,7,432,280,434,2,8%
2013-12,חיפה,7800,פרדס חנה-כרכור,885,406,479,110,775,281,872,16,4%
2013-12,חיפה,6800,קריית אתא,1758,800,958,131,1627,949,1731,55,6%
2013-12,חיפה,9500,קריית ביאליק,1180,494,686,134,1046,598,1167,38,5%
2013-12,חיפה,2300,קריית טבעון,193,95,98,60,133,43,190,4,2%
2013-12,חיפה,9600,קריית ים,1601,752,849,132,1469,965,1575,55,7%
2013-12,חיפה,8200,קריית מוצקין,1087,469,618,146,941,520,1069,32,5%
2013-12,חיפה,922,רכסים,145,62,83,7,138,79,139,1,4%
2013-12,ירושלים,472,אבו גוש,259,130,129,7,252,186,259,3,9%
2013-12,ירושלים,2610,בית שמש,1387,642,745,82,1305,556,1339,36,4%
2013-12,ירושלים,3000,ירושלים,12225,5567,6658,1296,10929,7316,12016,170,4%
2013-12,ירושלים,1015,מבשרת ציון,384,184,200,59,325,168,381,7,3%
2013-12,ירושלים,1137,קריית יערים,39,20,19,4,35,19,38,0,3%
2013-12,תל אביב,2400,אור יהודה,864,427,437,31,833,275,823,44,4%
2013-12,תל אביב,565,אזור,187,104,83,25,162,31,185,4,3%
2013-12,תל אביב,6100,בני ברק,2372,1205,1167,95,2277,1358,2303,45,4%
2013-12,תל אביב,6200,בת ים,3492,1690,1802,375,3117,1305,3370,90,5%
2013-12,תל אביב,6300,גבעתיים,765,349,416,260,505,112,755,2,3%
2013-12,תל אביב,6400,הרצלייה,1131,488,643,250,881,41,1109,31,2%
2013-12,תל אביב,6600,חולון,3332,1549,1783,414,2918,854,3252,90,3%
2013-12,תל אביב,2620,קריית אונו,439,193,246,89,350,47,431,4,2%
2013-12,תל אביב,8600,רמת גן,2264,1081,1183,550,1714,492,2223,21,3%
2013-12,תל אביב,2650,רמת השרון,391,170,221,108,283,7,385,3,2%
2013-12,תל אביב,5000,תל אביב -יפו,8323,4069,4254,2092,6231,2453,8177,149,3%
2014-01,אזור יהודה והשומרון,3760,אורנית,114,49,65,42,72,3,113,0,2%
2014-01,אזור יהודה והשומרון,3750,אלפי מנשה,104,49,55,18,86,2,104,0,2%
2014-01,אזור יהודה והשומרון,3560,אלקנה,33,16,17,14,19,1,33,1,2%
2014-01,אזור יהודה והשומרון,3650,אפרת,98,50,48,28,70,4,98,0,2%
2014-01,אזור יהודה והשומרון,3570,אריאל,375,174,201,53,322,85,370,2,4%
2014-01,אזור יהודה והשומרון,3574,בית אל,54,19,35,12,42,13,54,1,2%
2014-01,אזור יהודה והשומרון,3652,בית אריה,61,22,39,11,50,4,60,2,2%
2014-01,אזור יהודה והשומרון,3780,ביתר עילית,530,238,292,7,523,215,524,5,4%
2014-01,אזור יהודה והשומרון,3730,גבעת זאב,187,84,103,44,143,39,184,3,2%
2014-01,אזור יהודה והשומרון,3769,הר אדר,33,16,17,12,21,3,33,0,2%
2014-01,אזור יהודה והשומרון,3797,מודיעין עילית,421,169,252,25,396,92,405,10,3%
2014-01,אזור יהודה והשומרון,3616,מעלה אדומים,747,318,429,57,690,224,735,14,4%
2014-01,אזור יהודה והשומרון,3660,עמנואל,77,44,33,0,77,50,74,0,7%
2014-01,אזור יהודה והשומרון,3557,קדומים,34,17,17,11,23,9,34,0,2%
2014-01,אזור יהודה והשומרון,3611,קריית ארבע,111,53,58,11,100,61,110,4,3%
2014-01,אזור יהודה והשומרון,3640,קרני שומרון,93,53,40,12,81,11,91,3,2%
2014-01,הדרום,31,אופקים,1334,575,759,73,1261,860,1304,53,10%
2014-01,הדרום,2600,אילת,1642,750,892,44,1598,581,1611,53,5%
2014-01,הדרום,70,אשדוד,6916,2915,4001,709,6207,3470,6765,198,6%
2014-01,הדרום,7100,אשקלון,4410,1836,2574,352,4058,2327,4103,118,6%
2014-01,הדרום,9000,באר שבע,7426,3344,4082,840,6586,4430,7164,213,7%
2014-01,הדרום,2200,דימונה,2155,994,1161,121,2034,1360,2083,72,11%
2014-01,הדרום,1303,חורה,820,358,462,3,817,749,810,0,20%
2014-01,הדרום,831,ירוחם,478,233,245,15,463,268,458,19,10%
2014-01,הדרום,1059,כסיפה,1035,438,597,2,1033,914,1025,6,22%
2014-01,הדרום,1271,להבים,61,28,33,27,34,5,61,2,2%
2014-01,הדרום,1060,לקיה,1015,461,554,0,1015,950,1007,2,24%
2014-01,הדרום,1268,מיתר,68,31,37,21,47,5,64,2,2%
2014-01,הדרום,99,מצפה רמון,262,109,153,10,252,172,249,8,10%
2014-01,הדרום,246,נתיבות,1051,485,566,45,1006,551,1009,40,7%
2014-01,הדרום,666,עומר,60,27,33,18,42,7,60,0,1%
2014-01,הדרום,2560,ערד,949,448,501,90,859,443,902,39,7%
2014-01,הדרום,1192,ערערה-בנגב,1010,426,584,2,1008,932,1001,11,24%
2014-01,הדרום,2630,קריית גת,2248,951,1297,120,2128,1299,2186,44,8%
2014-01,הדרום,1034,קריית מלאכי,1300,607,693,28,1272,743,1259,83,11%
2014-01,הדרום,1161,רהט,3299,1396,1903,6,3293,2838,3276,60,17%
2014-01,הדרום,1286,שגב-שלום,559,219,340,1,558,477,552,2,21%
2014-01,הדרום,1031,שדרות,1121,528,593,44,1077,650,1078,17,8%
2014-01,הדרום,1054,תל שבע,1258,624,634,0,1258,1144,1241,6,25%
2014-01,המרכז,182,אבן יהודה,178,76,102,62,116,20,176,2,3%
2014-01,המרכז,41,אליכין,65,34,31,6,59,19,61,2,3%
2014-01,המרכז,1309,אלעד,417,201,216,25,392,105,409,5,3%
2014-01,המרכז,2530,באר יעקב,271,114,157,59,212,62,268,3,3%
2014-01,המרכז,466,בית דגן,116,68,48,19,97,40,115,1,3%
2014-01,המרכז,1066,"בני עי""ש",178,76,102,16,162,71,177,2,4%
2014-01,המרכז,681,גבעת שמואל,292,140,152,84,208,61,283,5,2%
2014-01,המרכז,2550,גדרה,387,157,230,61,326,110,381,5,3%
2014-01,המרכז,627,ג'לג'וליה,95,47,48,1,94,49,94,1,3%
2014-01,המרכז,166,גן יבנה,375,157,218,43,332,96,371,4,3%
2014-01,המרכז,229,גני תקווה,219,101,118,56,163,25,215,3,3%
2014-01,המרכז,9700,הוד השרון,715,318,397,213,502,76,705,2,2%
2014-01,המרכז,1290,זמר,191,63,128,0,191,127,190,15,6%
2014-01,המרכז,2730,טייבה,2080,914,1166,14,2066,1756,1969,35,11%
2014-01,המרכז,2720,טירה,355,173,182,8,347,176,345,10,3%
2014-01,המרכז,2660,יבנה,949,438,511,88,861,355,928,22,4%
2014-01,המרכז,9400,יהוד,570,242,328,87,483,86,552,17,3%
2014-01,המרכז,1224,כוכב יאיר,99,41,58,43,56,0,98,1,2%
2014-01,המרכז,633,כפר ברא,31,18,13,1,30,16,30,0,2%
2014-01,המרכז,168,כפר יונה,332,164,168,60,272,65,329,5,3%
2014-01,המרכז,6900,כפר סבא,1297,599,698,347,950,174,1280,22,2%
2014-01,המרכז,634,כפר קאסם,271,142,129,4,267,147,266,4,3%
2014-01,המרכז,7000,לוד,2273,1053,1220,148,2125,1217,2245,45,6%
2014-01,המרכז,1200,מודיעין-מכבים-רעות*,1079,478,601,319,760,66,1048,20,2%
2014-01,המרכז,28,מזכרת בתיה,159,73,86,32,127,34,157,1,2%
2014-01,המרכז,7200,נס ציונה,753,332,421,168,585,213,743,8,3%
2014-01,המרכז,7400,נתניה,4633,2204,2429,583,4050,1641,4528,98,4%
2014-01,המרכז,587,סביון*,25,6,19,9,16,0,25,0,1%
2014-01,המרכז,171,פרדסייה,91,43,48,16,75,8,91,0,3%
2014-01,המרכז,7900,פתח תקווה,4236,1893,2343,811,3425,1091,4166,36,3%
2014-01,המרכז,195,קדימה-צורן,248,106,142,69,179,43,246,1,2%
2014-01,המרכז,638,קלנסווה,851,349,502,4,847,691,802,14,9%
2014-01,המרכז,469,קריית עקרון,327,157,170,22,305,147,321,7,5%
2014-01,המרכז,2640,ראש העין,798,405,393,91,707,176,783,16,3%
2014-01,המרכז,8300,ראשון לציון,4498,2076,2422,781,3717,1384,4461,102,3%
2014-01,המרכז,8400,רחובות,2684,1204,1480,496,2188,1019,2613,46,4%
2014-01,המרכז,8500,רמלה,1884,910,974,104,1780,767,1822,53,5%
2014-01,המרכז,8700,רעננה,840,414,426,276,564,69,833,7,2%
2014-01,המרכז,1304,שוהם,189,82,107,81,108,8,188,0,2%
2014-01,המרכז,154,תל מונד,154,65,89,57,97,20,153,2,2%
2014-01,הצפון,473,אבו סנאן,732,298,434,5,727,593,728,11,12%
2014-01,הצפון,478,אכסאל,535,235,300,14,521,456,529,1,9%
2014-01,הצפון,529,אעבלין,640,254,386,5,635,523,637,5,11%
2014-01,הצפון,482,בועיינה-נוג'ידאת,422,177,245,4,418,344,410,7,11%
2014-01,הצפון,4001,בוקעאתא,416,164,252,3,413,348,399,0,15%
2014-01,הצפון,998,ביר אל-מכסור,443,181,262,2,441,333,440,6,12%
2014-01,הצפון,480,בית ג'ן,414,131,283,8,406,315,401,2,8%
2014-01,הצפון,9200,בית שאן,869,379,490,10,859,427,839,53,8%
2014-01,הצפון,944,בסמת טבעון,228,109,119,3,225,167,225,1,7%
2014-01,הצפון,483,בענה,394,157,237,4,390,335,391,8,12%
2014-01,הצפון,1292,ג'דיידה-מכר,1484,642,842,8,1476,1249,1472,41,16%
2014-01,הצפון,485,ג'ולס,216,68,148,1,215,154,216,1,7%
2014-01,הצפון,487,ג'ש (גוש חלב),75,38,37,1,74,35,75,4,5%
2014-01,הצפון,489,דבורייה,415,179,236,14,401,322,412,3,10%
2014-01,הצפון,490,דייר אל-אסד,404,166,238,10,394,329,401,6,8%
2014-01,הצפון,492,דייר חנא,678,308,370,15,663,491,676,4,14%
2014-01,הצפון,975,זרזיר,308,149,159,2,306,204,298,9,10%
2014-01,הצפון,496,חורפיש,111,44,67,7,104,59,108,1,4%
2014-01,הצפון,2034,חצור הגלילית,340,148,192,13,327,148,311,16,7%
2014-01,הצפון,6700,טבריה,1886,852,1034,69,1817,1102,1629,63,8%
2014-01,הצפון,962,טובא-זנגרייה,379,173,206,2,377,250,366,3,12%
2014-01,הצפון,498,טורעאן,560,224,336,12,548,479,528,7,9%
2014-01,הצפון,8900,טמרה,2038,881,1157,19,2019,1774,2013,11,14%
2014-01,הצפון,1295,יאנוח-ג'ת,167,62,105,5,162,108,165,3,6%
2014-01,הצפון,46,יבנאל,171,117,54,8,163,130,146,1,9%
2014-01,הצפון,499,יפיע,652,298,354,13,639,506,645,6,8%
2014-01,הצפון,240,יקנעם עילית,552,226,326,42,510,164,540,30,5%
2014-01,הצפון,502,ירכא,545,221,324,1,544,431,543,3,9%
2014-01,הצפון,504,כאבול,701,296,405,9,692,607,693,5,14%
2014-01,הצפון,505,כאוכב אבו אל-היג'א,226,104,122,4,222,191,226,6,13%
2014-01,הצפון,1296,כסרא-סמיע,232,91,141,5,227,169,224,5,7%
2014-01,הצפון,978,כעביה-טבאש-חג'אג'רה,226,94,132,2,224,152,222,2,10%
2014-01,הצפון,1263,כפר ורדים,57,21,36,25,32,7,56,1,2%
2014-01,הצפון,507,כפר יאסיף,518,216,302,6,512,416,508,16,10%
2014-01,הצפון,508,כפר כמא,72,32,40,3,69,30,70,0,4%
2014-01,הצפון,509,כפר כנא,1176,472,704,21,1155,1027,1119,26,13%
2014-01,הצפון,510,כפר מנדא,961,441,520,12,949,706,946,2,13%
2014-01,הצפון,47,כפר תבור,41,18,23,5,36,3,38,0,2%
2014-01,הצפון,1139,כרמיאל,1736,697,1039,278,1458,847,1663,49,6%
2014-01,הצפון,481,מגאר,1467,612,855,10,1457,1279,1431,11,15%
2014-01,הצפון,516,מג'ד אל-כרום,572,263,309,3,569,446,566,21,9%
2014-01,הצפון,874,מגדל העמק,1046,437,609,57,989,432,932,83,7%
2014-01,הצפון,4201,מג'דל שמס,510,187,323,13,497,405,501,1,10%
2014-01,הצפון,517,מזרעה,182,70,112,6,176,137,181,12,9%
2014-01,הצפון,4203,מסעדה,217,80,137,1,216,172,216,0,13%
2014-01,הצפון,518,מעיליא,60,28,32,3,57,34,58,1,4%
2014-01,הצפון,1063,מעלות-תרשיחא,939,447,492,81,858,548,916,37,8%
2014-01,הצפון,520,משהד,280,104,176,5,275,246,274,6,9%
2014-01,הצפון,9100,נהרייה,2072,958,1114,188,1884,1197,2028,73,7%
2014-01,הצפון,522,נחף,406,190,216,6,400,325,404,9,8%
2014-01,הצפון,7300,נצרת,3273,1403,1870,83,3190,2573,3216,20,9%
2014-01,הצפון,1061,נצרת עילית,1918,841,1077,159,1759,1086,1719,107,7%
2014-01,הצפון,525,סאג'ור,123,46,77,2,121,75,121,0,7%
2014-01,הצפון,7500,סח'נין,2067,906,1161,17,2050,1762,2062,17,15%
2014-01,הצפון,4501,ע'ג'ר,94,44,50,0,94,67,94,1,9%
2014-01,הצפון,530,עיילבון,222,95,127,4,218,157,219,1,8%
2014-01,הצפון,511,עילוט,314,127,187,3,311,253,311,1,11%
2014-01,הצפון,532,עין מאהל,605,282,323,12,593,488,584,5,11%
2014-01,הצפון,7600,עכו,3202,1465,1737,105,3097,2414,3135,64,12%
2014-01,הצפון,7700,עפולה,1766,769,997,156,1610,838,1681,101,7%
2014-01,הצפון,531,עראבה,1508,634,874,22,1486,1297,1499,15,15%
2014-01,הצפון,535,פסוטה,119,54,65,5,114,86,119,2,7%
2014-01,הצפון,536,פקיעין (בוקייעה),133,71,62,6,127,87,130,3,5%
2014-01,הצפון,8000,צפת,1515,819,696,58,1457,1137,1457,32,11%
2014-01,הצפון,4100,קצרין,209,86,123,17,192,100,204,6,5%
2014-01,הצפון,2800,קריית שמונה,902,402,500,41,861,374,871,34,7%
2014-01,הצפון,543,ראמה,335,128,207,9,326,249,325,1,8%
2014-01,הצפון,26,ראש פינה,61,20,41,12,49,21,58,2,4%
2014-01,הצפון,542,ריינה,701,291,410,10,691,566,680,10,10%
2014-01,הצפון,122,רמת ישי,109,43,66,30,79,12,104,2,3%
2014-01,הצפון,913,שבלי - אום אל-גנם,266,126,140,7,259,161,263,4,10%
2014-01,הצפון,812,שלומי,261,116,145,11,250,148,256,14,7%
2014-01,הצפון,538,שעב,549,232,317,2,547,473,547,8,18%
2014-01,הצפון,8800,שפרעם,2069,811,1258,40,2029,1713,2047,38,12%
2014-01,חיפה,2710,אום אל-פחם,3829,1549,2280,18,3811,3301,3758,32,18%
2014-01,חיפה,1020,אור עקיבא,637,263,374,38,599,231,609,30,6%
2014-01,חיפה,6000,באקה אל-גרביה,752,361,391,3,749,482,745,34,6%
2014-01,חיפה,9800,בנימינה-גבעת עדה*,247,97,150,58,189,70,246,0,3%
2014-01,חיפה,1326,"בסמ""ה",438,189,249,3,435,356,433,6,11%
2014-01,חיפה,541,ג'סר א-זרקא,420,231,189,1,419,301,418,2,7%
2014-01,חיפה,628,ג'ת,285,143,142,12,273,166,284,10,5%
2014-01,חיפה,494,דאלית אל-כרמל,548,232,316,12,536,314,532,2,7%
2014-01,חיפה,9300,זכרון יעקב,273,125,148,59,214,57,273,1,3%
2014-01,חיפה,6500,חדרה,2542,1096,1446,261,2281,982,2446,69,5%
2014-01,חיפה,4000,חיפה,6838,3286,3552,1117,5721,3619,6626,160,5%
2014-01,חיפה,1247,חריש,42,20,22,6,36,14,38,0,3%
2014-01,חיפה,2100,טירת כרמל,759,364,395,19,740,449,750,23,7%
2014-01,חיפה,654,כפר קרע,446,192,254,6,440,264,434,13,5%
2014-01,חיפה,1327,מעלה עירון,947,373,574,6,941,805,939,11,16%
2014-01,חיפה,2500,נשר,483,227,256,95,388,192,475,7,4%
2014-01,חיפה,534,עספיא,339,146,193,8,331,183,321,4,6%
2014-01,חיפה,637,ערערה,628,246,382,5,623,422,611,28,8%
2014-01,חיפה,537,פוריידיס,431,217,214,8,423,280,425,2,8%
2014-01,חיפה,7800,פרדס חנה-כרכור,895,411,484,103,792,291,882,34,4%
2014-01,חיפה,6800,קריית אתא,1734,789,945,142,1592,952,1708,53,6%
2014-01,חיפה,9500,קריית ביאליק,1181,482,699,144,1037,573,1171,27,5%
2014-01,חיפה,2300,קריית טבעון,200,101,99,68,132,42,197,2,2%
2014-01,חיפה,9600,קריית ים,1585,735,850,124,1461,934,1552,61,7%
2014-01,חיפה,8200,קריית מוצקין,1096,467,629,151,945,525,1076,31,5%
2014-01,חיפה,922,רכסים,154,69,85,6,148,82,148,0,4%
2014-01,ירושלים,472,אבו גוש,279,141,138,8,271,189,279,3,9%
2014-01,ירושלים,2610,בית שמש,1365,634,731,85,1280,538,1323,38,4%
2014-01,ירושלים,3000,ירושלים,12323,5697,6626,1298,11025,7349,12097,182,4%
2014-01,ירושלים,1015,מבשרת ציון,386,190,196,63,323,158,380,9,3%
2014-01,ירושלים,1137,קריית יערים,38,19,19,5,33,17,38,0,3%
2014-01,תל אביב,2400,אור יהודה,852,403,449,33,819,265,819,42,4%
2014-01,תל אביב,565,אזור,193,102,91,22,171,34,191,3,3%
2014-01,תל אביב,6100,בני ברק,2337,1183,1154,93,2244,1341,2260,32,4%
2014-01,תל אביב,6200,בת ים,3372,1619,1753,386,2986,1268,3247,95,5%
2014-01,תל אביב,6300,גבעתיים,780,350,430,265,515,114,773,10,3%
2014-01,תל אביב,6400,הרצלייה,1115,493,622,220,895,44,1095,40,2%
2014-01,תל אביב,6600,חולון,3299,1523,1776,410,2889,867,3213,83,3%
2014-01,תל אביב,2620,קריית אונו,418,196,222,93,325,40,415,4,2%
2014-01,תל אביב,8600,רמת גן,2263,1064,1199,579,1684,468,2222,28,3%
2014-01,תל אביב,2650,רמת השרון,414,191,223,113,301,5,409,5,2%
2014-01,תל אביב,5000,תל אביב -יפו,8168,3952,4216,2101,6067,2428,8008,130,3%
2014-02,אזור יהודה והשומרון,3760,אורנית,112,43,69,40,72,3,111,0,2%
2014-02,אזור יהודה והשומרון,3750,אלפי מנשה,97,48,49,18,79,1,97,1,2%
2014-02,אזור יהודה והשומרון,3560,אלקנה,33,15,18,13,20,1,33,0,2%
2014-02,אזור יהודה והשומרון,3650,אפרת,98,50,48,30,68,6,98,0,2%
2014-02,אזור יהודה והשומרון,3570,אריאל,378,170,208,57,321,84,373,4,4%
2014-02,אזור יהודה והשומרון,3574,בית אל,58,22,36,12,46,14,58,2,2%
2014-02,אזור יהודה והשומרון,3652,בית אריה,63,26,37,13,50,2,63,0,2%
2014-02,אזור יהודה והשומרון,3780,ביתר עילית,533,240,293,6,527,215,529,2,4%
2014-02,אזור יהודה והשומרון,3730,גבעת זאב,177,84,93,39,138,38,176,2,2%
2014-02,אזור יהודה והשומרון,3769,הר אדר,35,19,16,11,24,4,34,0,2%
2014-02,אזור יהודה והשומרון,3797,מודיעין עילית,401,156,245,27,374,78,393,17,3%
2014-02,אזור יהודה והשומרון,3616,מעלה אדומים,667,287,380,46,621,219,659,21,3%
2014-02,אזור יהודה והשומרון,3660,עמנואל,80,47,33,1,79,52,78,0,7%
2014-02,אזור יהודה והשומרון,3557,קדומים,28,14,14,9,19,8,28,0,2%
2014-02,אזור יהודה והשומרון,3611,קריית ארבע,112,62,50,12,100,62,110,4,3%
2014-02,אזור יהודה והשומרון,3640,קרני שומרון,89,50,39,14,75,11,87,2,2%
2014-02,הדרום,31,אופקים,1272,557,715,77,1195,838,1235,45,10%
2014-02,הדרום,2600,אילת,1611,731,880,42,1569,567,1585,50,5%
2014-02,הדרום,70,אשדוד,6790,2884,3906,691,6099,3436,6647,184,6%
2014-02,הדרום,7100,אשקלון,4244,1823,2421,326,3918,2263,3944,114,6%
2014-02,הדרום,9000,באר שבע,7274,3286,3988,802,6472,4328,7032,162,7%
2014-02,הדרום,2200,דימונה,2066,933,1133,118,1948,1363,1999,42,11%
2014-02,הדרום,1303,חורה,826,360,466,2,824,754,816,0,20%
2014-02,הדרום,831,ירוחם,467,229,238,14,453,271,446,29,10%
2014-02,הדרום,1059,כסיפה,1033,429,604,3,1030,917,1019,5,22%
2014-02,הדרום,1271,להבים,53,23,30,25,28,5,53,1,2%
2014-02,הדרום,1060,לקיה,1002,442,560,1,1001,937,997,0,23%
2014-02,הדרום,1268,מיתר,67,28,39,19,48,5,64,3,2%
2014-02,הדרום,99,מצפה רמון,285,124,161,10,275,176,270,12,11%
2014-02,הדרום,246,נתיבות,1038,484,554,43,995,527,998,25,7%
2014-02,הדרום,666,עומר,62,25,37,17,45,7,62,1,2%
2014-02,הדרום,2560,ערד,905,402,503,91,814,434,863,53,7%
2014-02,הדרום,1192,ערערה-בנגב,1013,434,579,3,1010,926,1005,3,24%
2014-02,הדרום,2630,קריית גת,2198,905,1293,117,2081,1292,2139,43,8%
2014-02,הדרום,1034,קריית מלאכי,1299,585,714,25,1274,758,1249,55,11%
2014-02,הדרום,1161,רהט,3320,1431,1889,7,3313,2802,3286,75,17%
2014-02,הדרום,1286,שגב-שלום,564,222,342,3,561,485,558,1,21%
2014-02,הדרום,1031,שדרות,1101,523,578,41,1060,647,1061,16,8%
2014-02,הדרום,1054,תל שבע,1243,611,632,1,1242,1138,1229,4,25%
2014-02,המרכז,182,אבן יהודה,182,81,101,63,119,19,179,0,3%
2014-02,המרכז,41,אליכין,67,36,31,7,60,18,63,2,3%
2014-02,המרכז,1309,אלעד,384,189,195,16,368,96,376,5,3%
2014-02,המרכז,2530,באר יעקב,268,114,154,56,212,54,265,2,3%
2014-02,המרכז,466,בית דגן,109,66,43,15,94,38,108,4,3%
2014-02,המרכז,1066,"בני עי""ש",193,89,104,20,173,67,191,5,5%
2014-02,המרכז,681,גבעת שמואל,306,148,158,83,223,68,302,3,3%
2014-02,המרכז,2550,גדרה,369,144,225,61,308,108,361,1,3%
2014-02,המרכז,627,ג'לג'וליה,99,49,50,2,97,49,99,2,3%
2014-02,המרכז,166,גן יבנה,367,147,220,41,326,92,363,8,3%
2014-02,המרכז,229,גני תקווה,196,85,111,57,139,18,195,2,2%
2014-02,המרכז,9700,הוד השרון,687,302,385,202,485,64,675,10,2%
2014-02,המרכז,1290,זמר,180,60,120,1,179,129,176,3,6%
2014-02,המרכז,2730,טייבה,1999,877,1122,12,1987,1701,1888,31,11%
2014-02,המרכז,2720,טירה,361,178,183,6,355,177,351,10,3%
2014-02,המרכז,2660,יבנה,936,446,490,93,843,351,920,21,4%
2014-02,המרכז,9400,יהוד,532,222,310,71,461,79,519,13,3%
2014-02,המרכז,1224,כוכב יאיר,87,30,57,37,50,0,87,1,2%
2014-02,המרכז,633,כפר ברא,33,21,12,1,32,17,32,1,2%
2014-02,המרכז,168,כפר יונה,332,157,175,57,275,62,328,6,3%
2014-02,המרכז,6900,כפר סבא,1285,593,692,338,947,177,1263,15,2%
2014-02,המרכז,634,כפר קאסם,264,137,127,3,261,142,259,2,3%
2014-02,המרכז,7000,לוד,2180,1019,1161,153,2027,1181,2155,47,6%
2014-02,המרכז,1200,מודיעין-מכבים-רעות*,1018,463,555,311,707,62,994,14,2%
2014-02,המרכז,28,מזכרת בתיה,141,65,76,29,112,32,139,2,2%
2014-02,המרכז,7200,נס ציונה,725,327,398,152,573,206,718,11,3%
2014-02,המרכז,7400,נתניה,4459,2082,2377,580,3879,1599,4363,107,4%
2014-02,המרכז,587,סביון*,25,6,19,9,16,0,25,0,1%
2014-02,המרכז,171,פרדסייה,86,40,46,10,76,10,85,0,2%
2014-02,המרכז,7900,פתח תקווה,4163,1843,2320,798,3365,1092,4088,41,3%
2014-02,המרכז,195,קדימה-צורן,246,105,141,63,183,41,243,2,2%
2014-02,המרכז,638,קלנסווה,778,312,466,3,775,653,734,15,8%
2014-02,המרכז,469,קריית עקרון,331,166,165,21,310,143,326,7,6%
2014-02,המרכז,2640,ראש העין,769,391,378,80,689,169,757,16,3%
2014-02,המרכז,8300,ראשון לציון,4346,1991,2355,714,3632,1365,4317,84,3%
2014-02,המרכז,8400,רחובות,2630,1169,1461,497,2133,1002,2560,45,4%
2014-02,המרכז,8500,רמלה,1823,864,959,103,1720,749,1761,48,5%
2014-02,המרכז,8700,רעננה,828,414,414,268,560,72,823,6,2%
2014-02,המרכז,1304,שוהם,188,90,98,77,111,8,187,0,2%
2014-02,המרכז,154,תל מונד,149,59,90,54,95,17,149,0,2%
2014-02,הצפון,473,אבו סנאן,714,293,421,5,709,584,710,14,12%
2014-02,הצפון,478,אכסאל,536,240,296,15,521,457,528,3,9%
2014-02,הצפון,529,אעבלין,639,264,375,8,631,525,633,6,11%
2014-02,הצפון,482,בועיינה-נוג'ידאת,449,183,266,4,445,352,431,1,11%
2014-02,הצפון,4001,בוקעאתא,429,176,253,3,426,353,410,0,15%
2014-02,הצפון,998,ביר אל-מכסור,432,168,264,2,430,333,429,3,12%
2014-02,הצפון,480,בית ג'ן,397,120,277,10,387,304,385,2,7%
2014-02,הצפון,9200,בית שאן,864,375,489,10,854,420,836,66,8%
2014-02,הצפון,944,בסמת טבעון,221,111,110,5,216,159,216,3,7%
2014-02,הצפון,483,בענה,391,156,235,5,386,326,390,6,12%
2014-02,הצפון,1292,ג'דיידה-מכר,1466,641,825,8,1458,1237,1450,34,16%
2014-02,הצפון,485,ג'ולס,226,70,156,1,225,157,226,5,8%
2014-02,הצפון,487,ג'ש (גוש חלב),71,35,36,3,68,38,71,4,4%
2014-02,הצפון,489,דבורייה,403,181,222,11,392,321,402,2,9%
2014-02,הצפון,490,דייר אל-אסד,406,171,235,7,399,323,399,10,8%
2014-02,הצפון,492,דייר חנא,664,302,362,11,653,491,663,4,14%
2014-02,הצפון,975,זרזיר,308,151,157,2,306,214,293,5,10%
2014-02,הצפון,496,חורפיש,104,41,63,6,98,61,101,2,4%
2014-02,הצפון,2034,חצור הגלילית,321,139,182,14,307,148,296,17,6%
2014-02,הצפון,6700,טבריה,1864,843,1021,67,1797,1110,1617,48,7%
2014-02,הצפון,962,טובא-זנגרייה,375,168,207,3,372,255,364,6,12%
2014-02,הצפון,498,טורעאן,537,197,340,10,527,463,513,5,9%
2014-02,הצפון,8900,טמרה,2021,874,1147,20,2001,1764,1999,18,14%
2014-02,הצפון,1295,יאנוח-ג'ת,162,60,102,4,158,102,159,1,6%
2014-02,הצפון,46,יבנאל,171,117,54,6,165,129,147,2,9%
2014-02,הצפון,499,יפיע,668,312,356,12,656,519,649,2,8%
2014-02,הצפון,240,יקנעם עילית,531,225,306,49,482,164,520,28,4%
2014-02,הצפון,502,ירכא,560,231,329,1,559,447,557,11,10%
2014-02,הצפון,504,כאבול,692,290,402,11,681,597,690,9,14%
2014-02,הצפון,505,כאוכב אבו אל-היג'א,221,97,124,5,216,192,219,1,13%
2014-02,הצפון,1296,כסרא-סמיע,236,97,139,5,231,166,232,2,7%
2014-02,הצפון,978,כעביה-טבאש-חג'אג'רה,240,103,137,2,238,154,235,1,10%
2014-02,הצפון,1263,כפר ורדים,68,31,37,28,40,5,68,0,2%
2014-02,הצפון,507,כפר יאסיף,502,204,298,6,496,398,494,13,10%
2014-02,הצפון,508,כפר כמא,72,31,41,6,66,31,71,0,4%
2014-02,הצפון,509,כפר כנא,1148,470,678,22,1126,1007,1098,14,12%
2014-02,הצפון,510,כפר מנדא,1016,474,542,12,1004,720,989,0,13%
2014-02,הצפון,47,כפר תבור,37,21,16,4,33,2,37,0,2%
2014-02,הצפון,1139,כרמיאל,1719,702,1017,285,1434,842,1650,66,6%
2014-02,הצפון,481,מגאר,1457,608,849,9,1448,1263,1426,5,15%
2014-02,הצפון,516,מג'ד אל-כרום,554,249,305,4,550,436,548,12,8%
2014-02,הצפון,874,מגדל העמק,1014,420,594,68,946,424,900,97,7%
2014-02,הצפון,4201,מג'דל שמס,508,186,322,11,497,401,500,0,10%
2014-02,הצפון,517,מזרעה,172,67,105,4,168,137,171,5,9%
2014-02,הצפון,4203,מסעדה,216,80,136,3,213,175,213,0,13%
2014-02,הצפון,518,מעיליא,58,26,32,6,52,31,55,0,3%
2014-02,הצפון,1063,מעלות-תרשיחא,927,449,478,79,848,523,909,36,8%
2014-02,הצפון,520,משהד,285,108,177,6,279,250,275,2,9%
2014-02,הצפון,9100,נהרייה,2043,942,1101,181,1862,1214,1997,86,6%
2014-02,הצפון,522,נחף,415,192,223,7,408,334,411,12,8%
2014-02,הצפון,7300,נצרת,3291,1432,1859,81,3210,2580,3226,10,9%
2014-02,הצפון,1061,נצרת עילית,1841,837,1004,147,1694,1014,1678,101,7%
2014-02,הצפון,525,סאג'ור,127,48,79,3,124,75,124,3,7%
2014-02,הצפון,7500,סח'נין,2071,912,1159,14,2057,1755,2062,11,15%
2014-02,הצפון,4501,ע'ג'ר,97,46,51,1,96,68,97,0,9%
2014-02,הצפון,530,עיילבון,216,90,126,2,214,153,213,3,8%
2014-02,הצפון,511,עילוט,320,127,193,3,317,261,312,2,11%
2014-02,הצפון,532,עין מאהל,587,272,315,10,577,476,572,3,11%
2014-02,הצפון,7600,עכו,3158,1445,1713,113,3045,2397,3086,43,12%
2014-02,הצפון,7700,עפולה,1703,747,956,142,1561,813,1629,76,7%
2014-02,הצפון,531,עראבה,1543,653,890,25,1518,1308,1536,11,15%
2014-02,הצפון,535,פסוטה,123,58,65,6,117,84,123,2,7%
2014-02,הצפון,536,פקיעין (בוקייעה),136,77,59,5,131,85,130,4,5%
2014-02,הצפון,8000,צפת,1469,781,688,66,1403,1114,1410,30,10%
2014-02,הצפון,4100,קצרין,210,84,126,14,196,100,204,4,5%
2014-02,הצפון,2800,קריית שמונה,867,385,482,37,830,381,838,25,6%
2014-02,הצפון,543,ראמה,334,131,203,9,325,250,327,1,8%
2014-02,הצפון,26,ראש פינה,63,22,41,12,51,21,62,0,4%
2014-02,הצפון,542,ריינה,687,292,395,10,677,556,673,4,10%
2014-02,הצפון,122,רמת ישי,100,38,62,29,71,14,95,1,2%
2014-02,הצפון,913,שבלי - אום אל-גנם,259,117,142,5,254,166,253,4,10%
2014-02,הצפון,812,שלומי,244,112,132,10,234,141,236,15,7%
2014-02,הצפון,538,שעב,548,227,321,1,547,475,545,3,18%
2014-02,הצפון,8800,שפרעם,2073,791,1282,38,2035,1732,2053,25,12%
2014-02,חיפה,2710,אום אל-פחם,3838,1575,2263,21,3817,3312,3770,29,18%
2014-02,חיפה,1020,אור עקיבא,614,266,348,36,578,214,591,21,6%
2014-02,חיפה,6000,באקה אל-גרביה,800,384,416,6,794,498,792,23,7%
2014-02,חיפה,9800,בנימינה-גבעת עדה*,238,93,145,56,182,67,237,4,3%
2014-02,חיפה,1326,"בסמ""ה",439,189,250,2,437,361,433,1,11%
2014-02,חיפה,541,ג'סר א-זרקא,436,242,194,1,435,314,433,4,7%
2014-02,חיפה,628,ג'ת,275,134,141,13,262,163,274,2,5%
2014-02,חיפה,494,דאלית אל-כרמל,535,227,308,11,524,314,521,6,7%
2014-02,חיפה,9300,זכרון יעקב,264,125,139,57,207,59,264,3,2%
2014-02,חיפה,6500,חדרה,2427,1021,1406,248,2179,961,2336,74,5%
2014-02,חיפה,4000,חיפה,6682,3234,3448,1084,5598,3552,6476,169,5%
2014-02,חיפה,1247,חריש,56,28,28,10,46,20,48,1,3%
2014-02,חיפה,2100,טירת כרמל,730,360,370,17,713,438,723,27,7%
2014-02,חיפה,654,כפר קרע,458,205,253,7,451,262,450,7,5%
2014-02,חיפה,1327,מעלה עירון,948,368,580,3,945,811,941,6,16%
2014-02,חיפה,2500,נשר,471,232,239,87,384,186,459,8,4%
2014-02,חיפה,534,עספיא,324,150,174,8,316,181,310,3,6%
2014-02,חיפה,637,ערערה,618,238,380,7,611,413,603,20,7%
2014-02,חיפה,537,פוריידיס,426,224,202,7,419,284,419,2,8%
2014-02,חיפה,7800,פרדס חנה-כרכור,848,389,459,106,742,283,839,32,4%
2014-02,חיפה,6800,קריית אתא,1641,755,886,143,1498,914,1612,37,5%
2014-02,חיפה,9500,קריית ביאליק,1132,481,651,138,994,547,1121,30,5%
2014-02,חיפה,2300,קריית טבעון,185,93,92,58,127,41,183,0,2%
2014-02,חיפה,9600,קריית ים,1579,743,836,124,1455,923,1553,35,7%
2014-02,חיפה,8200,קריית מוצקין,1084,475,609,137,947,507,1065,22,5%
2014-02,חיפה,922,רכסים,154,69,85,8,146,82,146,4,4%
2014-02,ירושלים,472,אבו גוש,266,130,136,6,260,190,265,3,9%
2014-02,ירושלים,2610,בית שמש,1277,570,707,82,1195,525,1237,40,4%
2014-02,ירושלים,3000,ירושלים,12181,5636,6545,1260,10921,7389,11971,175,4%
2014-02,ירושלים,1015,מבשרת ציון,366,178,188,57,309,152,360,6,3%
2014-02,ירושלים,1137,קריית יערים,34,16,18,4,30,18,32,1,2%
2014-02,תל אביב,2400,אור יהודה,819,390,429,23,796,255,783,36,4%
2014-02,תל אביב,565,אזור,186,97,89,27,159,35,183,2,3%
2014-02,תל אביב,6100,בני ברק,2224,1127,1097,79,2145,1277,2144,24,4%
2014-02,תל אביב,6200,בת ים,3272,1562,1710,397,2875,1253,3146,106,4%
2014-02,תל אביב,6300,גבעתיים,737,333,404,254,483,107,730,3,2%
2014-02,תל אביב,6400,הרצלייה,1103,470,633,211,892,37,1084,37,2%
2014-02,תל אביב,6600,חולון,3233,1498,1735,404,2829,870,3137,59,3%
2014-02,תל אביב,2620,קריית אונו,403,200,203,96,307,40,401,3,2%
2014-02,תל אביב,8600,רמת גן,2181,1012,1169,557,1624,467,2140,25,3%
2014-02,תל אביב,2650,רמת השרון,385,178,207,113,272,5,384,2,2%
2014-02,תל אביב,5000,תל אביב -יפו,7883,3868,4015,2083,5800,2412,7719,97,3%
2014-03,אזור יהודה והשומרון,3760,אורנית,109,44,65,42,67,2,108,0,2%
2014-03,אזור יהודה והשומרון,3750,אלפי מנשה,92,43,49,13,79,1,92,4,2%
2014-03,אזור יהודה והשומרון,3560,אלקנה,37,19,18,14,23,1,36,0,2%
2014-03,אזור יהודה והשומרון,3650,אפרת,116,60,56,28,88,14,116,1,3%
2014-03,אזור יהודה והשומרון,3570,אריאל,378,174,204,55,323,85,372,7,4%
2014-03,אזור יהודה והשומרון,3574,בית אל,56,24,32,13,43,16,56,0,2%
2014-03,אזור יהודה והשומרון,3652,בית אריה,63,27,36,14,49,5,62,1,2%
2014-03,אזור יהודה והשומרון,3780,ביתר עילית,498,229,269,7,491,212,493,1,4%
2014-03,אזור יהודה והשומרון,3730,גבעת זאב,171,79,92,39,132,39,171,2,2%
2014-03,אזור יהודה והשומרון,3769,הר אדר,36,16,20,10,26,4,35,0,2%
2014-03,אזור יהודה והשומרון,3797,מודיעין עילית,396,155,241,26,370,84,387,7,3%
2014-03,אזור יהודה והשומרון,3616,מעלה אדומים,634,261,373,54,580,219,621,16,3%
2014-03,אזור יהודה והשומרון,3660,עמנואל,84,48,36,0,84,54,82,0,7%
2014-03,אזור יהודה והשומרון,3557,קדומים,31,14,17,10,21,9,31,0,2%
2014-03,אזור יהודה והשומרון,3611,קריית ארבע,127,63,64,12,115,64,123,2,4%
2014-03,אזור יהודה והשומרון,3640,קרני שומרון,76,36,40,20,56,10,75,2,2%
2014-03,הדרום,31,אופקים,1248,561,687,74,1174,814,1203,47,9%
2014-03,הדרום,2600,אילת,1516,708,808,38,1478,562,1490,54,4%
2014-03,הדרום,70,אשדוד,6734,2831,3903,713,6021,3419,6573,210,6%
2014-03,הדרום,7100,אשקלון,4212,1808,2404,305,3907,2271,3901,122,6%
2014-03,הדרום,9000,באר שבע,7193,3273,3920,770,6423,4325,6937,204,7%
2014-03,הדרום,2200,דימונה,2138,968,1170,120,2018,1358,2061,57,11%
2014-03,הדרום,1303,חורה,831,366,465,2,829,755,820,1,20%
2014-03,הדרום,831,ירוחם,474,240,234,14,460,271,449,25,10%
2014-03,הדרום,1059,כסיפה,1039,424,615,1,1038,923,1029,3,22%
2014-03,הדרום,1271,להבים,41,20,21,19,22,4,41,0,1%
2014-03,הדרום,1060,לקיה,993,432,561,3,990,929,986,0,23%
2014-03,הדרום,1268,מיתר,64,27,37,15,49,5,62,0,1%
2014-03,הדרום,99,מצפה רמון,249,100,149,13,236,164,235,11,10%
2014-03,הדרום,246,נתיבות,975,449,526,41,934,520,942,49,7%
2014-03,הדרום,666,עומר,58,21,37,16,42,6,56,0,1%
2014-03,הדרום,2560,ערד,898,408,490,98,800,438,857,33,7%
2014-03,הדרום,1192,ערערה-בנגב,1014,432,582,4,1010,930,1008,5,24%
2014-03,הדרום,2630,קריית גת,2178,899,1279,132,2046,1273,2121,56,7%
2014-03,הדרום,1034,קריית מלאכי,1276,572,704,24,1252,737,1230,86,10%
2014-03,הדרום,1161,רהט,3286,1392,1894,5,3281,2803,3249,42,17%
2014-03,הדרום,1286,שגב-שלום,564,212,352,3,561,488,559,1,21%
2014-03,הדרום,1031,שדרות,1099,516,583,48,1051,659,1060,26,8%
2014-03,הדרום,1054,תל שבע,1234,603,631,1,1233,1137,1224,5,25%
2014-03,המרכז,182,אבן יהודה,172,81,91,62,110,19,169,3,3%
2014-03,המרכז,41,אליכין,59,27,32,6,53,17,55,4,3%
2014-03,המרכז,1309,אלעד,389,198,191,16,373,96,380,5,3%
2014-03,המרכז,2530,באר יעקב,278,116,162,48,230,59,275,5,3%
2014-03,המרכז,466,בית דגן,99,60,39,12,87,36,98,2,3%
2014-03,המרכז,1066,"בני עי""ש",197,94,103,24,173,70,196,2,5%
2014-03,המרכז,681,גבעת שמואל,310,154,156,81,229,71,305,3,3%
2014-03,המרכז,2550,גדרה,377,147,230,67,310,112,370,9,3%
2014-03,המרכז,627,ג'לג'וליה,92,43,49,2,90,50,90,4,2%
2014-03,המרכז,166,גן יבנה,369,154,215,44,325,93,361,14,3%
2014-03,המרכז,229,גני תקווה,196,81,115,54,142,21,194,0,2%
2014-03,המרכז,9700,הוד השרון,672,296,376,208,464,62,662,8,2%
2014-03,המרכז,1290,זמר,182,61,121,2,180,131,179,2,6%
2014-03,המרכז,2730,טייבה,1923,836,1087,10,1913,1641,1817,28,10%
2014-03,המרכז,2720,טירה,371,178,193,8,363,175,361,12,3%
2014-03,המרכז,2660,יבנה,944,451,493,99,845,356,922,42,4%
2014-03,המרכז,9400,יהוד,544,232,312,77,467,79,531,13,3%
2014-03,המרכז,1224,כוכב יאיר,85,28,57,43,42,0,85,0,2%
2014-03,המרכז,633,כפר ברא,35,24,11,1,34,16,35,1,3%
2014-03,המרכז,168,כפר יונה,329,152,177,59,270,63,325,6,3%
2014-03,המרכז,6900,כפר סבא,1262,591,671,333,929,177,1241,15,2%
2014-03,המרכז,634,כפר קאסם,247,120,127,5,242,134,241,6,3%
2014-03,המרכז,7000,לוד,2160,1014,1146,150,2010,1204,2123,53,6%
2014-03,המרכז,1200,מודיעין-מכבים-רעות*,980,418,562,309,671,58,956,20,2%
2014-03,המרכז,28,מזכרת בתיה,152,70,82,31,121,31,149,2,2%
2014-03,המרכז,7200,נס ציונה,716,320,396,152,564,218,706,8,3%
2014-03,המרכז,7400,נתניה,4536,2108,2428,592,3944,1638,4422,123,4%
2014-03,המרכז,587,סביון*,25,6,19,9,16,0,24,0,1%
2014-03,המרכז,171,פרדסייה,78,39,39,8,70,9,77,1,2%
2014-03,המרכז,7900,פתח תקווה,4140,1795,2345,827,3313,1082,4070,81,3%
2014-03,המרכז,195,קדימה-צורן,237,111,126,68,169,39,234,0,2%
2014-03,המרכז,638,קלנסווה,758,317,441,4,754,628,716,13,8%
2014-03,המרכז,469,קריית עקרון,329,164,165,20,309,141,322,10,5%
2014-03,המרכז,2640,ראש העין,754,379,375,72,682,173,738,13,3%
2014-03,המרכז,8300,ראשון לציון,4411,1994,2417,688,3723,1383,4379,120,3%
2014-03,המרכז,8400,רחובות,2615,1153,1462,495,2120,981,2542,63,4%
2014-03,המרכז,8500,רמלה,1839,910,929,104,1735,754,1774,50,5%
2014-03,המרכז,8700,רעננה,821,401,420,277,544,72,814,7,2%
2014-03,המרכז,1304,שוהם,180,81,99,68,112,11,179,0,2%
2014-03,המרכז,154,תל מונד,145,57,88,54,91,18,144,1,2%
2014-03,הצפון,473,אבו סנאן,700,287,413,5,695,566,697,11,12%
2014-03,הצפון,478,אכסאל,527,230,297,16,511,451,522,5,9%
2014-03,הצפון,529,אעבלין,632,258,374,9,623,531,626,13,11%
2014-03,הצפון,482,בועיינה-נוג'ידאת,457,185,272,5,452,344,449,8,12%
2014-03,הצפון,4001,בוקעאתא,424,170,254,3,421,352,414,9,15%
2014-03,הצפון,998,ביר אל-מכסור,442,175,267,2,440,336,440,8,12%
2014-03,הצפון,480,בית ג'ן,442,134,308,12,430,316,424,3,8%
2014-03,הצפון,9200,בית שאן,818,363,455,14,804,417,786,64,8%
2014-03,הצפון,944,בסמת טבעון,224,113,111,5,219,155,220,0,7%
2014-03,הצפון,483,בענה,395,159,236,5,390,330,394,9,12%
2014-03,הצפון,1292,ג'דיידה-מכר,1468,635,833,8,1460,1236,1450,25,16%
2014-03,הצפון,485,ג'ולס,254,73,181,0,254,158,254,20,9%
2014-03,הצפון,487,ג'ש (גוש חלב),72,39,33,3,69,38,72,1,4%
2014-03,הצפון,489,דבורייה,400,176,224,13,387,326,397,2,9%
2014-03,הצפון,490,דייר אל-אסד,399,160,239,8,391,312,397,10,8%
2014-03,הצפון,492,דייר חנא,672,310,362,12,660,496,670,2,14%
2014-03,הצפון,975,זרזיר,304,144,160,2,302,215,291,10,9%
2014-03,הצפון,496,חורפיש,111,43,68,6,105,64,108,2,4%
2014-03,הצפון,2034,חצור הגלילית,346,158,188,13,333,151,322,16,7%
2014-03,הצפון,6700,טבריה,1842,840,1002,62,1780,1129,1588,76,7%
2014-03,הצפון,962,טובא-זנגרייה,377,182,195,3,374,251,366,1,12%
2014-03,הצפון,498,טורעאן,552,197,355,9,543,468,533,10,9%
2014-03,הצפון,8900,טמרה,2024,871,1153,13,2011,1787,1997,19,14%
2014-03,הצפון,1295,יאנוח-ג'ת,166,61,105,3,163,100,163,5,6%
2014-03,הצפון,46,יבנאל,165,110,55,8,157,125,139,2,9%
2014-03,הצפון,499,יפיע,669,308,361,13,656,523,655,12,8%
2014-03,הצפון,240,יקנעם עילית,549,233,316,56,493,164,539,30,5%
2014-03,הצפון,502,ירכא,572,233,339,1,571,446,567,8,10%
2014-03,הצפון,504,כאבול,699,294,405,11,688,606,691,5,14%
2014-03,הצפון,505,כאוכב אבו אל-היג'א,219,98,121,4,215,190,219,1,13%
2014-03,הצפון,1296,כסרא-סמיע,231,88,143,5,226,160,228,1,7%
2014-03,הצפון,978,כעביה-טבאש-חג'אג'רה,229,102,127,6,223,146,224,4,10%
2014-03,הצפון,1263,כפר ורדים,62,28,34,25,37,6,60,0,2%
2014-03,הצפון,507,כפר יאסיף,490,209,281,5,485,391,481,8,9%
2014-03,הצפון,508,כפר כמא,79,31,48,4,75,32,79,0,5%
2014-03,הצפון,509,כפר כנא,1174,466,708,23,1151,1011,1126,18,13%
2014-03,הצפון,510,כפר מנדא,1016,465,551,13,1003,714,999,4,14%
2014-03,הצפון,47,כפר תבור,33,19,14,6,27,3,32,0,1%
2014-03,הצפון,1139,כרמיאל,1754,715,1039,299,1455,838,1684,58,6%
2014-03,הצפון,481,מגאר,1507,609,898,11,1496,1266,1487,8,16%
2014-03,הצפון,516,מג'ד אל-כרום,556,252,304,5,551,439,549,18,8%
2014-03,הצפון,874,מגדל העמק,1052,458,594,77,975,422,938,81,7%
2014-03,הצפון,4201,מג'דל שמס,521,189,332,9,512,407,511,0,11%
2014-03,הצפון,517,מזרעה,179,75,104,5,174,145,174,2,9%
2014-03,הצפון,4203,מסעדה,218,81,137,3,215,175,213,5,13%
2014-03,הצפון,518,מעיליא,67,34,33,7,60,32,66,2,4%
2014-03,הצפון,1063,מעלות-תרשיחא,919,442,477,87,832,510,899,45,7%
2014-03,הצפון,520,משהד,277,104,173,6,271,243,273,2,9%
2014-03,הצפון,9100,נהרייה,2044,958,1086,189,1855,1211,1993,81,6%
2014-03,הצפון,522,נחף,410,189,221,8,402,322,405,11,8%
2014-03,הצפון,7300,נצרת,3310,1439,1871,82,3228,2602,3239,61,9%
2014-03,הצפון,1061,נצרת עילית,1828,825,1003,146,1682,1026,1656,112,7%
2014-03,הצפון,525,סאג'ור,144,50,94,5,139,86,140,1,8%
2014-03,הצפון,7500,סח'נין,2109,933,1176,16,2093,1783,2102,18,15%
2014-03,הצפון,4501,ע'ג'ר,100,49,51,0,100,70,100,0,10%
2014-03,הצפון,530,עיילבון,221,88,133,2,219,154,217,2,8%
2014-03,הצפון,511,עילוט,322,130,192,2,320,261,320,2,11%
2014-03,הצפון,532,עין מאהל,601,275,326,10,591,492,579,3,11%
2014-03,הצפון,7600,עכו,3256,1471,1785,123,3133,2451,3163,68,12%
2014-03,הצפון,7700,עפולה,1786,770,1016,140,1646,844,1704,88,7%
2014-03,הצפון,531,עראבה,1567,665,902,26,1541,1325,1554,15,15%
2014-03,הצפון,535,פסוטה,121,57,64,8,113,81,121,0,7%
2014-03,הצפון,536,פקיעין (בוקייעה),136,75,61,5,131,87,133,1,5%
2014-03,הצפון,8000,צפת,1460,809,651,63,1397,1120,1390,26,10%
2014-03,הצפון,4100,קצרין,214,94,120,14,200,91,210,6,5%
2014-03,הצפון,2800,קריית שמונה,882,390,492,39,843,390,844,40,6%
2014-03,הצפון,543,ראמה,336,127,209,10,326,249,328,3,8%
2014-03,הצפון,26,ראש פינה,59,22,37,11,48,20,57,2,4%
2014-03,הצפון,542,ריינה,684,289,395,11,673,548,664,8,10%
2014-03,הצפון,122,רמת ישי,104,37,67,32,72,13,97,1,2%
2014-03,הצפון,913,שבלי - אום אל-גנם,260,122,138,7,253,164,256,1,10%
2014-03,הצפון,812,שלומי,252,112,140,12,240,142,248,11,7%
2014-03,הצפון,538,שעב,559,232,327,1,558,486,554,7,18%
2014-03,הצפון,8800,שפרעם,2135,823,1312,35,2100,1764,2110,40,12%
2014-03,חיפה,2710,אום אל-פחם,3847,1597,2250,19,3828,3322,3767,25,18%
2014-03,חיפה,1020,אור עקיבא,624,268,356,34,590,219,601,25,6%
2014-03,חיפה,6000,באקה אל-גרביה,764,359,405,7,757,495,754,19,6%
2014-03,חיפה,9800,בנימינה-גבעת עדה*,244,98,146,57,187,68,243,3,3%
2014-03,חיפה,1326,"בסמ""ה",434,185,249,2,432,357,426,2,11%
2014-03,חיפה,541,ג'סר א-זרקא,452,252,200,1,451,315,448,3,8%
2014-03,חיפה,628,ג'ת,287,143,144,14,273,172,281,10,5%
2014-03,חיפה,494,דאלית אל-כרמל,539,233,306,11,528,312,524,5,7%
2014-03,חיפה,9300,זכרון יעקב,255,115,140,57,198,60,253,0,2%
2014-03,חיפה,6500,חדרה,2458,1044,1414,269,2189,986,2353,73,5%
2014-03,חיפה,4000,חיפה,6735,3253,3482,1095,5640,3588,6486,160,5%
2014-03,חיפה,1247,חריש,44,24,20,10,34,16,42,1,3%
2014-03,חיפה,2100,טירת כרמל,740,367,373,17,723,439,732,28,7%
2014-03,חיפה,654,כפר קרע,459,199,260,6,453,276,450,6,5%
2014-03,חיפה,1327,מעלה עירון,959,373,586,4,955,808,948,7,16%
2014-03,חיפה,2500,נשר,455,226,229,79,376,184,447,6,4%
2014-03,חיפה,534,עספיא,340,152,188,7,333,184,329,5,6%
2014-03,חיפה,637,ערערה,612,227,385,6,606,418,592,29,7%
2014-03,חיפה,537,פוריידיס,416,224,192,5,411,277,411,0,7%
2014-03,חיפה,7800,פרדס חנה-כרכור,877,399,478,108,769,293,864,30,4%
2014-03,חיפה,6800,קריית אתא,1680,781,899,147,1533,940,1650,48,6%
2014-03,חיפה,9500,קריית ביאליק,1144,501,643,139,1005,563,1130,21,5%
2014-03,חיפה,2300,קריית טבעון,186,97,89,61,125,43,183,1,2%
2014-03,חיפה,9600,קריית ים,1609,744,865,140,1469,937,1575,58,7%
2014-03,חיפה,8200,קריית מוצקין,1114,492,622,151,963,518,1093,36,5%
2014-03,חיפה,922,רכסים,146,66,80,8,138,84,132,6,4%
2014-03,ירושלים,472,אבו גוש,270,133,137,7,263,194,269,1,9%
2014-03,ירושלים,2610,בית שמש,1284,571,713,102,1182,514,1242,36,4%
2014-03,ירושלים,3000,ירושלים,12192,5638,6554,1310,10882,7440,11971,172,4%
2014-03,ירושלים,1015,מבשרת ציון,385,189,196,71,314,154,377,6,3%
2014-03,ירושלים,1137,קריית יערים,37,18,19,8,29,19,36,0,3%
2014-03,תל אביב,2400,אור יהודה,810,392,418,25,785,249,778,24,4%
2014-03,תל אביב,565,אזור,193,101,92,24,169,32,190,2,3%
2014-03,תל אביב,6100,בני ברק,2279,1133,1145,73,2206,1285,2184,36,4%
2014-03,תל אביב,6200,בת ים,3211,1492,1719,362,2849,1230,3093,119,4%
2014-03,תל אביב,6300,גבעתיים,720,318,402,268,452,99,708,9,2%
2014-03,תל אביב,6400,הרצלייה,1068,455,613,202,866,40,1041,30,2%
2014-03,תל אביב,6600,חולון,3172,1478,1694,391,2781,851,3097,57,3%
2014-03,תל אביב,2620,קריית אונו,415,192,223,107,308,48,408,2,2%
2014-03,תל אביב,8600,רמת גן,2145,974,1171,563,1582,443,2102,29,3%
2014-03,תל אביב,2650,רמת השרון,385,164,221,101,284,10,381,4,2%
2014-03,תל אביב,5000,תל אביב -יפו,7750,3791,3959,2126,5624,2371,7613,119,3%
2014-04,אזור יהודה והשומרון,3760,אורנית,113,48,65,44,69,2,110,0,2%
2014-04,אזור יהודה והשומרון,3750,אלפי מנשה,83,40,43,14,69,0,83,0,2%
2014-04,אזור יהודה והשומרון,3560,אלקנה,32,15,17,12,20,2,32,0,2%
2014-04,אזור יהודה והשומרון,3650,אפרת,114,64,50,36,78,8,112,1,3%
2014-04,אזור יהודה והשומרון,3570,אריאל,350,166,184,47,303,85,339,10,3%
2014-04,אזור יהודה והשומרון,3574,בית אל,51,20,31,13,38,16,51,2,2%
2014-04,אזור יהודה והשומרון,3652,בית אריה,58,26,32,12,46,5,58,1,2%
2014-04,אזור יהודה והשומרון,3780,ביתר עילית,476,229,247,7,469,212,467,7,4%
2014-04,אזור יהודה והשומרון,3730,גבעת זאב,172,78,94,39,133,39,170,2,2%
2014-04,אזור יהודה והשומרון,3769,הר אדר,33,14,19,8,25,4,32,0,2%
2014-04,אזור יהודה והשומרון,3797,מודיעין עילית,376,139,237,21,355,84,365,4,3%
2014-04,אזור יהודה והשומרון,3616,מעלה אדומים,599,241,358,49,550,213,589,12,3%
2014-04,אזור יהודה והשומרון,3660,עמנואל,79,50,29,1,78,53,77,1,7%
2014-04,אזור יהודה והשומרון,3557,קדומים,29,11,18,10,19,8,29,0,2%
2014-04,אזור יהודה והשומרון,3611,קריית ארבע,111,59,52,11,100,65,108,1,3%
2014-04,אזור יהודה והשומרון,3640,קרני שומרון,79,36,43,23,56,9,78,0,2%
2014-04,הדרום,31,אופקים,1167,517,650,69,1098,781,1144,33,9%
2014-04,הדרום,2600,אילת,1301,613,688,35,1266,540,1276,32,4%
2014-04,הדרום,70,אשדוד,6414,2673,3741,686,5728,3333,6265,151,6%
2014-04,הדרום,7100,אשקלון,4142,1757,2385,281,3861,2238,3817,89,6%
2014-04,הדרום,9000,באר שבע,6869,3142,3727,704,6165,4184,6641,117,6%
2014-04,הדרום,2200,דימונה,2051,927,1124,108,1943,1365,1985,25,11%
2014-04,הדרום,1303,חורה,838,358,480,2,836,757,825,3,20%
2014-04,הדרום,831,ירוחם,458,222,236,14,444,269,438,15,10%
2014-04,הדרום,1059,כסיפה,1038,405,633,0,1038,933,1028,1,22%
2014-04,הדרום,1271,להבים,36,18,18,17,19,3,36,0,1%
2014-04,הדרום,1060,לקיה,990,432,558,3,987,929,982,2,23%
2014-04,הדרום,1268,מיתר,55,25,30,12,43,6,53,0,1%
2014-04,הדרום,99,מצפה רמון,236,89,147,12,224,161,225,4,9%
2014-04,הדרום,246,נתיבות,982,445,537,38,944,522,949,22,7%
2014-04,הדרום,666,עומר,52,22,30,16,36,6,52,0,1%
2014-04,הדרום,2560,ערד,835,380,455,94,741,417,800,23,7%
2014-04,הדרום,1192,ערערה-בנגב,1011,426,585,4,1007,921,1004,1,24%
2014-04,הדרום,2630,קריית גת,2067,851,1216,117,1950,1245,2022,45,7%
2014-04,הדרום,1034,קריית מלאכי,1185,531,654,25,1160,705,1144,52,10%
2014-04,הדרום,1161,רהט,3284,1364,1920,6,3278,2784,3253,26,17%
2014-04,הדרום,1286,שגב-שלום,560,208,352,3,557,496,556,1,21%
2014-04,הדרום,1031,שדרות,1078,487,591,43,1035,652,1045,13,8%
2014-04,הדרום,1054,תל שבע,1214,583,631,3,1211,1127,1204,3,24%
2014-04,המרכז,182,אבן יהודה,164,80,84,61,103,17,161,2,2%
2014-04,המרכז,41,אליכין,62,28,34,6,56,22,57,0,3%
2014-04,המרכז,1309,אלעד,392,199,193,18,374,92,384,3,3%
2014-04,המרכז,2530,באר יעקב,265,113,152,42,223,58,263,0,3%
2014-04,המרכז,466,בית דגן,106,63,43,11,95,38,105,2,3%
2014-04,המרכז,1066,"בני עי""ש",182,92,90,27,155,66,181,3,5%
2014-04,המרכז,681,גבעת שמואל,292,140,152,73,219,68,286,1,2%
2014-04,המרכז,2550,גדרה,369,146,223,70,299,113,362,4,3%
2014-04,המרכז,627,ג'לג'וליה,85,36,49,2,83,47,81,2,2%
2014-04,המרכז,166,גן יבנה,321,122,199,37,284,85,317,7,3%
2014-04,המרכז,229,גני תקווה,193,80,113,58,135,24,192,0,2%
2014-04,המרכז,9700,הוד השרון,632,288,344,199,433,59,624,10,2%
2014-04,המרכז,1290,זמר,177,61,116,3,174,128,174,2,6%
2014-04,המרכז,2730,טייבה,1815,791,1024,8,1807,1568,1694,33,10%
2014-04,המרכז,2720,טירה,322,152,170,8,314,166,313,9,3%
2014-04,המרכז,2660,יבנה,875,411,464,97,778,346,861,16,4%
2014-04,המרכז,9400,יהוד,513,221,292,85,428,73,494,8,3%
2014-04,המרכז,1224,כוכב יאיר,76,26,50,40,36,1,76,0,1%
2014-04,המרכז,633,כפר ברא,28,16,12,1,27,16,28,1,2%
2014-04,המרכז,168,כפר יונה,322,152,170,62,260,65,319,1,3%
2014-04,המרכז,6900,כפר סבא,1215,570,645,335,880,173,1196,5,2%
2014-04,המרכז,634,כפר קאסם,229,111,118,4,225,125,225,8,3%
2014-04,המרכז,7000,לוד,2118,994,1124,151,1967,1199,2082,39,6%
2014-04,המרכז,1200,מודיעין-מכבים-רעות*,923,397,526,298,625,62,903,21,2%
2014-04,המרכז,28,מזכרת בתיה,155,74,81,34,121,34,152,4,2%
2014-04,המרכז,7200,נס ציונה,691,323,368,152,539,203,685,5,3%
2014-04,המרכז,7400,נתניה,4239,1939,2300,530,3709,1608,4144,98,4%
2014-04,המרכז,587,סביון*,21,8,13,8,13,0,21,0,1%
2014-04,המרכז,171,פרדסייה,72,33,39,11,61,10,72,0,2%
2014-04,המרכז,7900,פתח תקווה,3892,1715,2177,799,3093,1041,3838,46,3%
2014-04,המרכז,195,קדימה-צורן,231,112,119,63,168,39,229,2,2%
2014-04,המרכז,638,קלנסווה,727,304,423,3,724,596,684,9,8%
2014-04,המרכז,469,קריית עקרון,321,164,157,20,301,142,316,10,5%
2014-04,המרכז,2640,ראש העין,715,355,360,57,658,171,703,10,3%
2014-04,המרכז,8300,ראשון לציון,4204,1913,2291,648,3556,1347,4179,78,3%
2014-04,המרכז,8400,רחובות,2486,1108,1378,463,2023,962,2419,25,4%
2014-04,המרכז,8500,רמלה,1663,784,879,90,1573,726,1611,43,4%
2014-04,המרכז,8700,רעננה,792,389,403,265,527,72,786,8,2%
2014-04,המרכז,1304,שוהם,168,74,94,68,100,11,167,1,2%
2014-04,המרכז,154,תל מונד,134,57,77,48,86,17,133,0,2%
2014-04,הצפון,473,אבו סנאן,688,283,405,6,682,559,685,10,12%
2014-04,הצפון,478,אכסאל,510,225,285,14,496,449,503,1,9%
2014-04,הצפון,529,אעבלין,608,240,368,9,599,513,605,2,11%
2014-04,הצפון,482,בועיינה-נוג'ידאת,438,172,266,5,433,336,431,4,11%
2014-04,הצפון,4001,בוקעאתא,432,173,259,2,430,359,417,2,15%
2014-04,הצפון,998,ביר אל-מכסור,437,179,258,1,436,330,435,3,12%
2014-04,הצפון,480,בית ג'ן,412,125,287,13,399,299,401,1,8%
2014-04,הצפון,9200,בית שאן,787,359,428,13,774,405,764,52,8%
2014-04,הצפון,944,בסמת טבעון,221,110,111,4,217,158,218,5,7%
2014-04,הצפון,483,בענה,365,147,218,3,362,307,364,12,11%
2014-04,הצפון,1292,ג'דיידה-מכר,1413,605,808,8,1405,1174,1398,23,15%
2014-04,הצפון,485,ג'ולס,235,69,166,0,235,156,235,2,8%
2014-04,הצפון,487,ג'ש (גוש חלב),67,34,33,2,65,37,67,3,4%
2014-04,הצפון,489,דבורייה,388,167,221,13,375,312,385,2,9%
2014-04,הצפון,490,דייר אל-אסד,377,154,223,4,373,295,375,11,7%
2014-04,הצפון,492,דייר חנא,677,309,368,11,666,503,675,1,14%
2014-04,הצפון,975,זרזיר,291,137,154,2,289,206,282,10,9%
2014-04,הצפון,496,חורפיש,98,36,62,7,91,64,95,0,4%
2014-04,הצפון,2034,חצור הגלילית,293,138,155,14,279,135,274,5,6%
2014-04,הצפון,6700,טבריה,1694,783,911,67,1627,1072,1473,47,7%
2014-04,הצפון,962,טובא-זנגרייה,363,173,190,3,360,246,352,1,12%
2014-04,הצפון,498,טורעאן,508,183,325,5,503,436,493,4,9%
2014-04,הצפון,8900,טמרה,1997,858,1139,14,1983,1777,1973,15,14%
2014-04,הצפון,1295,יאנוח-ג'ת,155,57,98,3,152,97,154,3,6%
2014-04,הצפון,46,יבנאל,157,102,55,7,150,127,131,1,8%
2014-04,הצפון,499,יפיע,647,290,357,13,634,516,636,6,8%
2014-04,הצפון,240,יקנעם עילית,512,216,296,52,460,158,505,22,4%
2014-04,הצפון,502,ירכא,563,232,331,0,563,434,558,4,10%
2014-04,הצפון,504,כאבול,681,278,403,8,673,600,676,7,14%
2014-04,הצפון,505,כאוכב אבו אל-היג'א,220,102,118,4,216,188,216,4,13%
2014-04,הצפון,1296,כסרא-סמיע,201,76,125,3,198,142,199,3,6%
2014-04,הצפון,978,כעביה-טבאש-חג'אג'רה,214,92,122,4,210,150,206,2,9%
2014-04,הצפון,1263,כפר ורדים,62,35,27,27,35,4,61,0,2%
2014-04,הצפון,507,כפר יאסיף,482,207,275,4,478,375,472,5,9%
2014-04,הצפון,508,כפר כמא,74,31,43,3,71,30,71,0,4%
2014-04,הצפון,509,כפר כנא,1127,444,683,21,1106,975,1094,16,12%
2014-04,הצפון,510,כפר מנדא,990,455,535,12,978,699,972,11,13%
2014-04,הצפון,47,כפר תבור,35,22,13,6,29,3,33,1,2%
2014-04,הצפון,1139,כרמיאל,1665,680,985,272,1393,814,1599,44,6%
2014-04,הצפון,481,מגאר,1552,614,938,10,1542,1321,1519,8,16%
2014-04,הצפון,516,מג'ד אל-כרום,524,238,286,5,519,416,520,15,8%
2014-04,הצפון,874,מגדל העמק,930,406,524,71,859,407,837,67,6%
2014-04,הצפון,4201,מג'דל שמס,510,183,327,9,501,403,499,2,10%
2014-04,הצפון,517,מזרעה,171,68,103,3,168,141,169,6,9%
2014-04,הצפון,4203,מסעדה,214,76,138,3,211,174,208,5,12%
2014-04,הצפון,518,מעיליא,57,30,27,5,52,28,55,1,3%
2014-04,הצפון,1063,מעלות-תרשיחא,869,419,450,89,780,491,856,22,7%
2014-04,הצפון,520,משהד,281,103,178,5,276,233,269,3,8%
2014-04,הצפון,9100,נהרייה,1954,903,1051,186,1768,1184,1905,71,6%
2014-04,הצפון,522,נחף,397,186,211,10,387,312,394,10,8%
2014-04,הצפון,7300,נצרת,3212,1402,1810,78,3134,2557,3135,18,9%
2014-04,הצפון,1061,נצרת עילית,1707,792,915,143,1564,1001,1548,64,7%
2014-04,הצפון,525,סאג'ור,142,50,92,3,139,86,140,4,8%
2014-04,הצפון,7500,סח'נין,2057,903,1154,14,2043,1752,2051,15,15%
2014-04,הצפון,4501,ע'ג'ר,98,45,53,0,98,73,97,1,9%
2014-04,הצפון,530,עיילבון,212,83,129,2,210,153,210,4,8%
2014-04,הצפון,511,עילוט,316,126,190,1,315,257,313,2,11%
2014-04,הצפון,532,עין מאהל,574,266,308,9,565,476,554,6,11%
2014-04,הצפון,7600,עכו,3158,1437,1721,127,3031,2394,3073,38,12%
2014-04,הצפון,7700,עפולה,1673,697,976,126,1547,821,1604,63,6%
2014-04,הצפון,531,עראבה,1534,641,893,23,1511,1311,1522,14,15%
2014-04,הצפון,535,פסוטה,122,53,69,8,114,83,122,6,7%
2014-04,הצפון,536,פקיעין (בוקייעה),124,65,59,4,120,85,120,1,4%
2014-04,הצפון,8000,צפת,1387,768,619,61,1326,1087,1326,13,10%
2014-04,הצפון,4100,קצרין,210,91,119,13,197,91,206,4,5%
2014-04,הצפון,2800,קריית שמונה,829,373,456,37,792,372,798,43,6%
2014-04,הצפון,543,ראמה,341,136,205,7,334,248,333,5,9%
2014-04,הצפון,26,ראש פינה,55,21,34,8,47,20,54,0,3%
2014-04,הצפון,542,ריינה,653,277,376,6,647,527,641,4,9%
2014-04,הצפון,122,רמת ישי,96,35,61,28,68,11,90,3,2%
2014-04,הצפון,913,שבלי - אום אל-גנם,238,109,129,7,231,158,235,2,9%
2014-04,הצפון,812,שלומי,243,105,138,14,229,135,238,12,7%
2014-04,הצפון,538,שעב,545,220,325,1,544,477,543,3,18%
2014-04,הצפון,8800,שפרעם,2085,810,1275,30,2055,1736,2056,24,12%
2014-04,חיפה,2710,אום אל-פחם,3810,1555,2255,19,3791,3297,3734,21,18%
2014-04,חיפה,1020,אור עקיבא,603,254,349,35,568,211,580,12,6%
2014-04,חיפה,6000,באקה אל-גרביה,732,330,402,5,727,483,727,11,6%
2014-04,חיפה,9800,בנימינה-גבעת עדה*,212,86,126,54,158,67,211,1,3%
2014-04,חיפה,1326,"בסמ""ה",437,189,248,2,435,352,432,0,11%
2014-04,חיפה,541,ג'סר א-זרקא,459,254,205,1,458,322,456,3,8%
2014-04,חיפה,628,ג'ת,270,129,141,11,259,169,266,8,5%
2014-04,חיפה,494,דאלית אל-כרמל,519,223,296,10,509,306,502,2,6%
2014-04,חיפה,9300,זכרון יעקב,232,104,128,52,180,54,231,1,2%
2014-04,חיפה,6500,חדרה,2392,1006,1386,267,2125,962,2301,57,5%
2014-04,חיפה,4000,חיפה,6368,3067,3301,1051,5317,3485,6149,113,4%
2014-04,חיפה,1247,חריש,34,18,16,6,28,8,32,0,2%
2014-04,חיפה,2100,טירת כרמל,709,339,370,14,695,422,695,14,7%
2014-04,חיפה,654,כפר קרע,449,189,260,7,442,267,439,4,5%
2014-04,חיפה,1327,מעלה עירון,937,357,580,6,931,793,927,4,16%
2014-04,חיפה,2500,נשר,436,217,219,77,359,174,428,3,3%
2014-04,חיפה,534,עספיא,319,136,183,9,310,178,305,7,6%
2014-04,חיפה,637,ערערה,607,228,379,5,602,422,587,11,7%
2014-04,חיפה,537,פוריידיס,421,222,199,3,418,277,416,0,7%
2014-04,חיפה,7800,פרדס חנה-כרכור,832,363,469,121,711,278,826,18,4%
2014-04,חיפה,6800,קריית אתא,1624,728,896,128,1496,939,1592,25,5%
2014-04,חיפה,9500,קריית ביאליק,1046,460,586,134,912,540,1031,19,5%
2014-04,חיפה,2300,קריית טבעון,179,88,91,57,122,41,176,3,2%
2014-04,חיפה,9600,קריית ים,1524,698,826,132,1392,903,1498,40,7%
2014-04,חיפה,8200,קריית מוצקין,1057,459,598,143,914,516,1044,20,5%
2014-04,חיפה,922,רכסים,136,63,73,8,128,78,130,1,4%
2014-04,ירושלים,472,אבו גוש,256,125,131,5,251,182,256,4,8%
2014-04,ירושלים,2610,בית שמש,1260,588,672,91,1169,512,1206,29,4%
2014-04,ירושלים,3000,ירושלים,11642,5317,6325,1184,10458,7295,11455,143,4%
2014-04,ירושלים,1015,מבשרת ציון,369,177,192,69,300,158,361,7,3%
2014-04,ירושלים,1137,קריית יערים,35,19,16,5,30,16,34,0,3%
2014-04,תל אביב,2400,אור יהודה,778,372,406,30,748,250,749,14,4%
2014-04,תל אביב,565,אזור,159,91,68,23,136,36,156,4,2%
2014-04,תל אביב,6100,בני ברק,2199,1093,1105,67,2132,1231,2119,19,4%
2014-04,תל אביב,6200,בת ים,2972,1406,1566,344,2628,1183,2882,66,4%
2014-04,תל אביב,6300,גבעתיים,692,314,378,251,441,91,686,3,2%
2014-04,תל אביב,6400,הרצלייה,991,422,569,176,815,31,973,26,2%
2014-04,תל אביב,6600,חולון,2961,1405,1556,349,2612,828,2905,39,3%
2014-04,תל אביב,2620,קריית אונו,378,182,196,96,282,51,372,1,2%
2014-04,תל אביב,8600,רמת גן,1994,903,1091,521,1473,441,1955,19,3%
2014-04,תל אביב,2650,רמת השרון,359,148,211,92,267,4,356,2,2%
2014-04,תל אביב,5000,תל אביב -יפו,7298,3619,3679,2013,5285,2289,7161,83,3%
2014-05,אזור יהודה והשומרון,3760,אורנית,111,47,64,40,71,3,109,0,2%
2014-05,אזור יהודה והשומרון,3750,אלפי מנשה,84,40,44,16,68,1,84,0,2%
2014-05,אזור יהודה והשומרון,3560,אלקנה,32,15,17,15,17,1,32,0,2%
2014-05,אזור יהודה והשומרון,3650,אפרת,114,64,50,40,74,8,114,1,3%
2014-05,אזור יהודה והשומרון,3570,אריאל,364,169,195,47,317,85,354,11,3%
2014-05,אזור יהודה והשומרון,3574,בית אל,49,21,28,10,39,16,49,1,2%
2014-05,אזור יהודה והשומרון,3652,בית אריה,57,27,30,11,46,4,57,1,2%
2014-05,אזור יהודה והשומרון,3780,ביתר עילית,472,226,246,6,466,191,466,2,4%
2014-05,אזור יהודה והשומרון,3730,גבעת זאב,196,91,105,42,154,39,196,0,3%
2014-05,אזור יהודה והשומרון,3769,הר אדר,36,13,23,12,24,4,36,1,2%
2014-05,אזור יהודה והשומרון,3797,מודיעין עילית,389,149,240,20,369,90,377,7,3%
2014-05,אזור יהודה והשומרון,3616,מעלה אדומים,597,267,330,48,549,207,590,17,3%
2014-05,אזור יהודה והשומרון,3660,עמנואל,75,45,30,0,75,54,73,0,6%
2014-05,אזור יהודה והשומרון,3557,קדומים,32,15,17,8,24,7,32,0,2%
2014-05,אזור יהודה והשומרון,3611,קריית ארבע,113,59,54,10,103,66,109,0,3%
2014-05,אזור יהודה והשומרון,3640,קרני שומרון,89,37,52,27,62,10,87,2,2%
2014-05,הדרום,31,אופקים,1226,542,684,67,1159,782,1202,43,9%
2014-05,הדרום,2600,אילת,1292,620,672,34,1258,537,1250,54,4%
2014-05,הדרום,70,אשדוד,6653,2754,3899,725,5928,3333,6479,213,6%
2014-05,הדרום,7100,אשקלון,4209,1802,2407,294,3915,2225,3871,121,6%
2014-05,הדרום,9000,באר שבע,7117,3214,3903,717,6400,4245,6859,245,7%
2014-05,הדרום,2200,דימונה,2019,903,1116,100,1919,1354,1956,69,11%
2014-05,הדרום,1303,חורה,828,353,475,2,826,760,817,5,20%
2014-05,הדרום,831,ירוחם,467,226,241,14,453,271,439,48,10%
2014-05,הדרום,1059,כסיפה,1033,403,630,1,1032,936,1021,4,22%
2014-05,הדרום,1271,להבים,42,20,22,17,25,3,42,0,1%
2014-05,הדרום,1060,לקיה,999,445,554,4,995,936,988,1,23%
2014-05,הדרום,1268,מיתר,64,30,34,14,50,6,62,1,1%
2014-05,הדרום,99,מצפה רמון,247,89,158,10,237,168,239,2,10%
2014-05,הדרום,246,נתיבות,1023,469,554,44,979,526,986,31,7%
2014-05,הדרום,666,עומר,63,28,35,19,44,9,62,1,2%
2014-05,הדרום,2560,ערד,853,371,482,88,765,423,819,36,7%
2014-05,הדרום,1192,ערערה-בנגב,1024,427,597,5,1019,942,1017,0,24%
2014-05,הדרום,2630,קריית גת,2136,867,1269,127,2009,1244,2069,63,7%
2014-05,הדרום,1034,קריית מלאכי,1240,565,675,23,1217,711,1195,95,10%
2014-05,הדרום,1161,רהט,3369,1372,1997,7,3362,2756,3331,51,17%
2014-05,הדרום,1286,שגב-שלום,578,211,367,2,576,509,572,1,21%
2014-05,הדרום,1031,שדרות,1089,483,606,49,1040,661,1049,16,8%
2014-05,הדרום,1054,תל שבע,1223,580,643,2,1221,1130,1211,4,24%
2014-05,המרכז,182,אבן יהודה,165,78,87,62,103,19,164,2,2%
2014-05,המרכז,41,אליכין,64,28,36,6,58,18,62,1,3%
2014-05,המרכז,1309,אלעד,386,191,195,20,366,97,371,4,3%
2014-05,המרכז,2530,באר יעקב,281,120,161,48,233,60,279,3,3%
2014-05,המרכז,466,בית דגן,103,58,45,11,92,40,103,2,3%
2014-05,המרכז,1066,"בני עי""ש",181,90,91,30,151,71,179,6,5%
2014-05,המרכז,681,גבעת שמואל,300,146,154,67,233,73,293,2,2%
2014-05,המרכז,2550,גדרה,368,157,211,73,295,119,358,5,3%
2014-05,המרכז,627,ג'לג'וליה,77,32,45,2,75,44,76,0,2%
2014-05,המרכז,166,גן יבנה,342,139,203,42,300,87,339,9,3%
2014-05,המרכז,229,גני תקווה,192,80,112,60,132,24,189,2,2%
2014-05,המרכז,9700,הוד השרון,631,281,350,196,435,62,623,5,2%
2014-05,המרכז,1290,זמר,176,55,121,2,174,128,173,10,6%
2014-05,המרכז,2730,טייבה,1784,768,1016,11,1773,1543,1660,26,10%
2014-05,המרכז,2720,טירה,325,150,175,5,320,167,313,4,3%
2014-05,המרכז,2660,יבנה,899,447,452,96,803,330,883,44,4%
2014-05,המרכז,9400,יהוד,510,222,288,88,422,73,491,12,3%
2014-05,המרכז,1224,כוכב יאיר,75,25,50,41,34,1,75,1,1%
2014-05,המרכז,633,כפר ברא,23,13,10,1,22,15,23,1,2%
2014-05,המרכז,168,כפר יונה,319,150,169,62,257,65,316,4,3%
2014-05,המרכז,6900,כפר סבא,1259,590,669,349,910,169,1231,22,2%
2014-05,המרכז,634,כפר קאסם,241,114,127,5,236,131,233,1,3%
2014-05,המרכז,7000,לוד,2136,1037,1099,149,1987,1166,2109,49,6%
2014-05,המרכז,1200,מודיעין-מכבים-רעות*,923,389,534,318,605,63,898,19,2%
2014-05,המרכז,28,מזכרת בתיה,152,73,79,37,115,31,149,1,2%
2014-05,המרכז,7200,נס ציונה,695,328,367,156,539,208,687,11,3%
2014-05,המרכז,7400,נתניה,4397,2039,2358,566,3831,1604,4294,126,4%
2014-05,המרכז,587,סביון*,22,10,12,8,14,0,21,0,1%
2014-05,המרכז,171,פרדסייה,66,29,37,15,51,8,66,0,2%
2014-05,המרכז,7900,פתח תקווה,3998,1766,2232,845,3153,1065,3933,70,3%
2014-05,המרכז,195,קדימה-צורן,245,117,128,68,177,39,241,1,2%
2014-05,המרכז,638,קלנסווה,688,284,404,3,685,572,641,16,7%
2014-05,המרכז,469,קריית עקרון,329,168,161,21,308,147,321,17,5%
2014-05,המרכז,2640,ראש העין,721,344,377,70,651,162,706,18,3%
2014-05,המרכז,8300,ראשון לציון,4309,1929,2380,659,3650,1349,4278,103,3%
2014-05,המרכז,8400,רחובות,2539,1153,1386,471,2068,977,2466,51,4%
2014-05,המרכז,8500,רמלה,1744,850,894,90,1654,726,1694,45,5%
2014-05,המרכז,8700,רעננה,823,379,444,279,544,74,812,16,2%
2014-05,המרכז,1304,שוהם,175,82,93,67,108,10,174,2,2%
2014-05,המרכז,154,תל מונד,146,60,86,56,90,17,144,1,2%
2014-05,הצפון,473,אבו סנאן,666,279,387,7,659,544,663,13,11%
2014-05,הצפון,478,אכסאל,509,225,284,10,499,443,504,2,9%
2014-05,הצפון,529,אעבלין,617,248,369,7,610,519,612,10,11%
2014-05,הצפון,482,בועיינה-נוג'ידאת,409,169,240,5,404,335,397,7,10%
2014-05,הצפון,4001,בוקעאתא,437,177,260,2,435,363,423,4,15%
2014-05,הצפון,998,ביר אל-מכסור,427,176,251,3,424,321,425,1,12%
2014-05,הצפון,480,בית ג'ן,438,135,303,14,424,303,425,3,8%
2014-05,הצפון,9200,בית שאן,796,367,429,13,783,412,766,77,8%
2014-05,הצפון,944,בסמת טבעון,217,111,106,3,214,158,212,0,7%
2014-05,הצפון,483,בענה,368,151,217,3,365,306,365,11,11%
2014-05,הצפון,1292,ג'דיידה-מכר,1366,591,775,9,1357,1143,1352,43,15%
2014-05,הצפון,485,ג'ולס,235,70,165,0,235,162,235,3,8%
2014-05,הצפון,487,ג'ש (גוש חלב),76,34,42,3,73,42,75,0,5%
2014-05,הצפון,489,דבורייה,386,170,216,13,373,304,384,3,9%
2014-05,הצפון,490,דייר אל-אסד,381,158,223,5,376,298,378,12,7%
2014-05,הצפון,492,דייר חנא,671,300,371,8,663,512,669,10,14%
2014-05,הצפון,975,זרזיר,287,131,156,2,285,203,280,9,9%
2014-05,הצפון,496,חורפיש,103,40,63,7,96,61,100,0,4%
2014-05,הצפון,2034,חצור הגלילית,301,132,169,15,286,136,285,18,6%
2014-05,הצפון,6700,טבריה,1720,789,931,70,1650,1049,1492,52,7%
2014-05,הצפון,962,טובא-זנגרייה,408,184,224,5,403,258,393,2,13%
2014-05,הצפון,498,טורעאן,495,182,313,4,491,434,482,5,9%
2014-05,הצפון,8900,טמרה,1991,841,1150,12,1979,1774,1969,13,14%
2014-05,הצפון,1295,יאנוח-ג'ת,158,58,100,6,152,96,157,1,6%
2014-05,הצפון,46,יבנאל,165,107,58,9,156,134,136,1,9%
2014-05,הצפון,499,יפיע,635,282,353,14,621,514,628,9,8%
2014-05,הצפון,240,יקנעם עילית,507,224,283,49,458,154,500,26,4%
2014-05,הצפון,502,ירכא,566,240,326,1,565,429,560,10,10%
2014-05,הצפון,504,כאבול,683,280,403,8,675,599,677,8,14%
2014-05,הצפון,505,כאוכב אבו אל-היג'א,215,100,115,3,212,185,212,6,12%
2014-05,הצפון,1296,כסרא-סמיע,206,79,127,3,203,147,201,2,6%
2014-05,הצפון,978,כעביה-טבאש-חג'אג'רה,208,83,125,3,205,144,198,3,9%
2014-05,הצפון,1263,כפר ורדים,59,29,30,28,31,4,58,2,2%
2014-05,הצפון,507,כפר יאסיף,464,196,268,4,460,373,456,9,9%
2014-05,הצפון,508,כפר כמא,68,32,36,3,65,29,65,1,4%
2014-05,הצפון,509,כפר כנא,1123,442,681,21,1102,950,1084,17,12%
2014-05,הצפון,510,כפר מנדא,956,430,526,11,945,697,931,35,13%
2014-05,הצפון,47,כפר תבור,33,21,12,4,29,4,31,1,1%
2014-05,הצפון,1139,כרמיאל,1690,680,1010,283,1407,824,1605,70,6%
2014-05,הצפון,481,מגאר,1533,601,932,11,1522,1295,1507,6,16%
2014-05,הצפון,516,מג'ד אל-כרום,529,232,297,6,523,422,524,18,8%
2014-05,הצפון,874,מגדל העמק,986,445,541,73,913,417,884,78,7%
2014-05,הצפון,4201,מג'דל שמס,506,181,325,10,496,400,494,5,10%
2014-05,הצפון,517,מזרעה,172,70,102,3,169,136,170,3,9%
2014-05,הצפון,4203,מסעדה,219,78,141,3,216,176,213,4,13%
2014-05,הצפון,518,מעיליא,60,28,32,8,52,33,58,4,4%
2014-05,הצפון,1063,מעלות-תרשיחא,905,436,469,92,813,507,888,35,7%
2014-05,הצפון,520,משהד,296,112,184,5,291,241,283,6,9%
2014-05,הצפון,9100,נהרייה,1994,905,1089,193,1801,1193,1940,67,6%
2014-05,הצפון,522,נחף,399,186,213,9,390,309,397,15,8%
2014-05,הצפון,7300,נצרת,3169,1373,1796,78,3091,2554,3109,42,9%
2014-05,הצפון,1061,נצרת עילית,1796,843,953,144,1652,1014,1599,111,7%
2014-05,הצפון,525,סאג'ור,141,52,89,4,137,85,139,2,8%
2014-05,הצפון,7500,סח'נין,2035,890,1145,11,2024,1756,2028,12,15%
2014-05,הצפון,4501,ע'ג'ר,91,38,53,0,91,68,91,1,9%
2014-05,הצפון,530,עיילבון,195,78,117,2,193,139,193,3,7%
2014-05,הצפון,511,עילוט,317,132,185,0,317,258,310,4,11%
2014-05,הצפון,532,עין מאהל,561,263,298,7,554,465,542,8,10%
2014-05,הצפון,7600,עכו,3230,1497,1733,121,3109,2450,3133,48,12%
2014-05,הצפון,7700,עפולה,1733,712,1021,131,1602,825,1649,87,7%
2014-05,הצפון,531,עראבה,1503,625,878,21,1482,1294,1494,18,15%
2014-05,הצפון,535,פסוטה,120,57,63,7,113,79,119,3,7%
2014-05,הצפון,536,פקיעין (בוקייעה),133,66,67,4,129,91,129,6,5%
2014-05,הצפון,8000,צפת,1435,790,645,64,1371,1111,1371,42,10%
2014-05,הצפון,4100,קצרין,220,95,125,14,206,95,218,9,6%
2014-05,הצפון,2800,קריית שמונה,853,379,474,32,821,384,811,45,6%
2014-05,הצפון,543,ראמה,345,126,219,9,336,253,338,4,9%
2014-05,הצפון,26,ראש פינה,54,21,33,7,47,22,52,2,3%
2014-05,הצפון,542,ריינה,671,288,383,8,663,531,652,15,10%
2014-05,הצפון,122,רמת ישי,101,36,65,32,69,13,94,0,2%
2014-05,הצפון,913,שבלי - אום אל-גנם,220,103,117,6,214,152,215,2,8%
2014-05,הצפון,812,שלומי,271,114,157,17,254,145,264,13,7%
2014-05,הצפון,538,שעב,547,214,333,2,545,472,545,16,18%
2014-05,הצפון,8800,שפרעם,2085,806,1279,27,2058,1737,2057,56,12%
2014-05,חיפה,2710,אום אל-פחם,3791,1565,2226,15,3776,3269,3718,48,18%
2014-05,חיפה,1020,אור עקיבא,616,258,358,40,576,214,591,23,6%
2014-05,חיפה,6000,באקה אל-גרביה,740,323,417,9,731,480,735,36,6%
2014-05,חיפה,9800,בנימינה-גבעת עדה*,216,88,128,56,160,65,215,0,3%
2014-05,חיפה,1326,"בסמ""ה",422,178,244,2,420,349,416,7,10%
2014-05,חיפה,541,ג'סר א-זרקא,479,250,229,2,477,320,475,3,8%
2014-05,חיפה,628,ג'ת,255,119,136,11,244,167,252,6,5%
2014-05,חיפה,494,דאלית אל-כרמל,542,228,314,11,531,312,520,8,7%
2014-05,חיפה,9300,זכרון יעקב,236,108,128,63,173,54,235,2,2%
2014-05,חיפה,6500,חדרה,2456,1058,1398,282,2174,948,2349,61,5%
2014-05,חיפה,4000,חיפה,6483,3114,3369,1130,5353,3536,6229,186,4%
2014-05,חיפה,1247,חריש,34,14,20,4,30,8,32,0,2%
2014-05,חיפה,2100,טירת כרמל,730,352,378,15,715,430,714,24,7%
2014-05,חיפה,654,כפר קרע,439,183,256,10,429,258,432,21,5%
2014-05,חיפה,1327,מעלה עירון,952,358,594,5,947,799,942,7,16%
2014-05,חיפה,2500,נשר,469,219,250,83,386,180,456,7,4%
2014-05,חיפה,534,עספיא,321,145,176,7,314,176,307,2,6%
2014-05,חיפה,637,ערערה,611,229,382,5,606,417,595,23,7%
2014-05,חיפה,537,פוריידיס,414,222,192,1,413,277,409,2,7%
2014-05,חיפה,7800,פרדס חנה-כרכור,861,393,468,111,750,282,852,25,4%
2014-05,חיפה,6800,קריית אתא,1644,747,897,131,1513,914,1618,59,5%
2014-05,חיפה,9500,קריית ביאליק,1066,461,605,133,933,548,1053,38,5%
2014-05,חיפה,2300,קריית טבעון,185,97,88,62,123,37,180,1,2%
2014-05,חיפה,9600,קריית ים,1543,710,833,135,1408,905,1505,41,7%
2014-05,חיפה,8200,קריית מוצקין,1027,447,580,137,890,506,1014,28,4%
2014-05,חיפה,922,רכסים,129,59,70,4,125,77,122,0,4%
2014-05,ירושלים,472,אבו גוש,258,129,129,3,255,179,257,2,8%
2014-05,ירושלים,2610,בית שמש,1257,573,684,98,1159,530,1215,53,4%
2014-05,ירושלים,3000,ירושלים,12056,5542,6514,1285,10771,7420,11814,167,4%
2014-05,ירושלים,1015,מבשרת ציון,387,185,202,77,310,163,379,5,3%
2014-05,ירושלים,1137,קריית יערים,35,16,19,4,31,16,35,0,3%
2014-05,תל אביב,2400,אור יהודה,788,383,405,36,752,250,757,35,4%
2014-05,תל אביב,565,אזור,175,96,79,22,153,39,170,5,3%
2014-05,תל אביב,6100,בני ברק,2235,1120,1114,69,2166,1239,2143,42,4%
2014-05,תל אביב,6200,בת ים,3060,1452,1608,379,2681,1186,2961,87,4%
2014-05,תל אביב,6300,גבעתיים,706,320,386,261,445,86,700,9,2%
2014-05,תל אביב,6400,הרצלייה,994,407,587,192,802,32,983,37,2%
2014-05,תל אביב,6600,חולון,3016,1455,1561,357,2659,857,2943,68,3%
2014-05,תל אביב,2620,קריית אונו,389,184,205,112,277,48,383,3,2%
2014-05,תל אביב,8600,רמת גן,2050,916,1134,584,1466,447,2012,21,3%
2014-05,תל אביב,2650,רמת השרון,385,158,227,103,282,5,379,5,2%
2014-05,תל אביב,5000,תל אביב -יפו,7605,3819,3786,2245,5360,2316,7461,128,3%
2014-06,אזור יהודה והשומרון,3760,אורנית,114,44,70,39,75,2,113,1,2%
2014-06,אזור יהודה והשומרון,3750,אלפי מנשה,83,34,49,22,61,1,83,0,2%
2014-06,אזור יהודה והשומרון,3560,אלקנה,35,17,18,19,16,1,35,0,2%
2014-06,אזור יהודה והשומרון,3650,אפרת,110,62,48,34,76,8,110,0,3%
2014-06,אזור יהודה והשומרון,3570,אריאל,349,168,181,45,304,81,341,14,3%
2014-06,אזור יהודה והשומרון,3574,בית אל,52,22,30,13,39,18,52,3,2%
2014-06,אזור יהודה והשומרון,3652,בית אריה,62,27,35,10,52,4,60,2,2%
2014-06,אזור יהודה והשומרון,3780,ביתר עילית,493,236,257,8,485,202,486,5,4%
2014-06,אזור יהודה והשומרון,3730,גבעת זאב,190,94,96,33,157,40,189,2,3%
2014-06,אזור יהודה והשומרון,3769,הר אדר,26,9,17,11,15,2,26,1,1%
2014-06,אזור יהודה והשומרון,3797,מודיעין עילית,428,148,280,18,410,85,415,9,3%
2014-06,אזור יהודה והשומרון,3616,מעלה אדומים,649,293,356,55,594,213,643,17,3%
2014-06,אזור יהודה והשומרון,3660,עמנואל,80,48,32,0,80,57,76,4,7%
2014-06,אזור יהודה והשומרון,3557,קדומים,36,16,20,11,25,7,36,0,2%
2014-06,אזור יהודה והשומרון,3611,קריית ארבע,110,64,46,7,103,58,107,4,3%
2014-06,אזור יהודה והשומרון,3640,קרני שומרון,77,38,39,24,53,10,75,3,2%
2014-06,הדרום,31,אופקים,1231,528,703,63,1168,773,1203,45,9%
2014-06,הדרום,2600,אילת,1267,600,667,28,1239,534,1235,51,4%
2014-06,הדרום,70,אשדוד,6620,2743,3876,711,5909,3316,6426,218,6%
2014-06,הדרום,7100,אשקלון,4278,1806,2472,278,4000,2224,3916,107,6%
2014-06,הדרום,9000,באר שבע,7127,3195,3932,736,6391,4251,6826,232,7%
2014-06,הדרום,2200,דימונה,2060,905,1155,100,1960,1353,1981,50,11%
2014-06,הדרום,1303,חורה,829,355,474,1,828,760,819,4,20%
2014-06,הדרום,831,ירוחם,456,215,241,15,441,261,429,34,9%
2014-06,הדרום,1059,כסיפה,1048,404,644,3,1045,939,1039,4,22%
2014-06,הדרום,1271,להבים,45,19,26,15,30,3,45,0,1%
2014-06,הדרום,1060,לקיה,988,437,551,3,985,923,977,2,23%
2014-06,הדרום,1268,מיתר,62,30,32,10,52,6,60,3,1%
2014-06,הדרום,99,מצפה רמון,262,100,162,9,253,179,241,5,10%
2014-06,הדרום,246,נתיבות,1055,467,588,45,1010,537,1010,35,7%
2014-06,הדרום,666,עומר,54,26,28,16,38,5,54,1,1%
2014-06,הדרום,2560,ערד,856,378,478,95,761,416,824,59,7%
2014-06,הדרום,1192,ערערה-בנגב,1049,436,613,6,1043,956,1039,1,25%
2014-06,הדרום,2630,קריית גת,2166,887,1279,128,2038,1243,2084,79,7%
2014-06,הדרום,1034,קריית מלאכי,1216,572,644,19,1197,684,1173,79,10%
2014-06,הדרום,1161,רהט,3321,1356,1965,6,3315,2749,3278,47,17%
2014-06,הדרום,1286,שגב-שלום,601,215,386,4,597,520,591,1,22%
2014-06,הדרום,1031,שדרות,1089,488,601,50,1039,652,1047,27,8%
2014-06,הדרום,1054,תל שבע,1221,580,641,2,1219,1140,1209,3,24%
2014-06,המרכז,182,אבן יהודה,161,76,85,66,95,19,159,0,2%
2014-06,המרכז,41,אליכין,65,34,31,6,59,17,63,1,3%
2014-06,המרכז,1309,אלעד,373,180,193,20,353,85,364,3,3%
2014-06,המרכז,2530,באר יעקב,293,131,162,53,240,56,289,2,3%
2014-06,המרכז,466,בית דגן,111,63,48,13,98,39,110,3,3%
2014-06,המרכז,1066,"בני עי""ש",171,90,81,27,144,73,170,1,4%
2014-06,המרכז,681,גבעת שמואל,300,146,154,54,246,71,292,3,2%
2014-06,המרכז,2550,גדרה,379,156,223,84,295,118,371,4,3%
2014-06,המרכז,627,ג'לג'וליה,87,36,51,3,84,47,84,2,2%
2014-06,המרכז,166,גן יבנה,339,143,196,55,284,82,335,12,3%
2014-06,המרכז,229,גני תקווה,187,80,107,62,125,27,184,2,2%
2014-06,המרכז,9700,הוד השרון,629,278,351,221,408,62,623,14,2%
2014-06,המרכז,1290,זמר,193,60,133,2,191,128,189,11,6%
2014-06,המרכז,2730,טייבה,1748,749,999,6,1742,1505,1610,32,9%
2014-06,המרכז,2720,טירה,321,156,165,5,316,161,317,12,3%
2014-06,המרכז,2660,יבנה,865,437,428,82,783,317,848,20,4%
2014-06,המרכז,9400,יהוד,511,217,294,93,418,75,495,11,3%
2014-06,המרכז,1224,כוכב יאיר,76,28,48,40,36,0,75,0,1%
2014-06,המרכז,633,כפר ברא,22,10,12,0,22,13,22,0,2%
2014-06,המרכז,168,כפר יונה,326,142,184,65,261,72,321,9,3%
2014-06,המרכז,6900,כפר סבא,1237,576,661,360,877,164,1215,21,2%
2014-06,המרכז,634,כפר קאסם,247,123,124,4,243,130,242,3,3%
2014-06,המרכז,7000,לוד,2125,1001,1124,149,1976,1182,2092,49,6%
2014-06,המרכז,1200,מודיעין-מכבים-רעות*,921,382,539,323,598,64,896,24,2%
2014-06,המרכז,28,מזכרת בתיה,172,83,89,40,132,33,169,3,2%
2014-06,המרכז,7200,נס ציונה,704,330,374,159,545,201,698,2,3%
2014-06,המרכז,7400,נתניה,4366,2053,2313,576,3790,1587,4275,88,4%
2014-06,המרכז,587,סביון*,21,11,10,8,13,1,21,0,1%
2014-06,המרכז,171,פרדסייה,69,29,40,18,51,8,69,0,2%
2014-06,המרכז,7900,פתח תקווה,4009,1776,2233,863,3146,1069,3942,41,3%
2014-06,המרכז,195,קדימה-צורן,246,111,135,66,180,39,242,1,2%
2014-06,המרכז,638,קלנסווה,685,283,402,5,680,576,640,9,7%
2014-06,המרכז,469,קריית עקרון,311,163,148,23,288,142,306,4,5%
2014-06,המרכז,2640,ראש העין,696,333,363,78,618,162,682,17,3%
2014-06,המרכז,8300,ראשון לציון,4334,1931,2403,629,3705,1343,4294,95,3%
2014-06,המרכז,8400,רחובות,2619,1171,1448,472,2147,970,2547,49,4%
2014-06,המרכז,8500,רמלה,1778,860,918,104,1674,742,1712,53,5%
2014-06,המרכז,8700,רעננה,798,384,414,273,525,69,794,4,2%
2014-06,המרכז,1304,שוהם,168,82,86,70,98,10,167,1,2%
2014-06,המרכז,154,תל מונד,145,62,83,58,87,16,144,2,2%
2014-06,הצפון,473,אבו סנאן,660,282,378,8,652,527,656,12,11%
2014-06,הצפון,478,אכסאל,518,233,285,11,507,449,512,1,9%
2014-06,הצפון,529,אעבלין,609,247,362,6,603,518,607,15,11%
2014-06,הצפון,482,בועיינה-נוג'ידאת,405,166,239,5,400,338,394,8,10%
2014-06,הצפון,4001,בוקעאתא,427,176,251,2,425,362,411,5,15%
2014-06,הצפון,998,ביר אל-מכסור,439,182,257,4,435,335,436,15,12%
2014-06,הצפון,480,בית ג'ן,438,131,307,14,424,303,421,2,8%
2014-06,הצפון,9200,בית שאן,804,370,434,12,792,407,780,71,8%
2014-06,הצפון,944,בסמת טבעון,216,110,106,1,215,161,209,3,7%
2014-06,הצפון,483,בענה,357,153,204,3,354,302,354,12,11%
2014-06,הצפון,1292,ג'דיידה-מכר,1364,598,766,8,1356,1127,1345,20,15%
2014-06,הצפון,485,ג'ולס,230,70,160,0,230,156,229,8,8%
2014-06,הצפון,487,ג'ש (גוש חלב),71,34,37,2,69,41,69,3,4%
2014-06,הצפון,489,דבורייה,380,165,215,13,367,306,377,3,9%
2014-06,הצפון,490,דייר אל-אסד,375,153,222,4,371,300,373,9,7%
2014-06,הצפון,492,דייר חנא,675,308,367,7,668,508,673,5,14%
2014-06,הצפון,975,זרזיר,298,143,155,4,294,202,289,8,9%
2014-06,הצפון,496,חורפיש,111,46,65,8,103,63,109,2,4%
2014-06,הצפון,2034,חצור הגלילית,308,140,168,14,294,138,288,15,6%
2014-06,הצפון,6700,טבריה,1711,783,928,75,1636,1059,1483,58,7%
2014-06,הצפון,962,טובא-זנגרייה,411,179,232,3,408,252,399,2,13%
2014-06,הצפון,498,טורעאן,511,184,327,5,506,446,489,6,9%
2014-06,הצפון,8900,טמרה,2005,831,1174,10,1995,1784,1981,16,14%
2014-06,הצפון,1295,יאנוח-ג'ת,173,70,103,6,167,96,172,4,6%
2014-06,הצפון,46,יבנאל,150,96,54,6,144,126,120,1,8%
2014-06,הצפון,499,יפיע,644,288,356,15,629,515,632,6,8%
2014-06,הצפון,240,יקנעם עילית,540,244,296,58,482,153,531,28,5%
2014-06,הצפון,502,ירכא,578,241,337,1,577,427,569,16,10%
2014-06,הצפון,504,כאבול,682,289,393,8,674,594,676,6,14%
2014-06,הצפון,505,כאוכב אבו אל-היג'א,217,100,117,3,214,187,214,2,12%
2014-06,הצפון,1296,כסרא-סמיע,216,85,131,3,213,150,210,6,6%
2014-06,הצפון,978,כעביה-טבאש-חג'אג'רה,202,78,124,3,199,144,196,3,9%
2014-06,הצפון,1263,כפר ורדים,70,30,40,27,43,5,69,0,2%
2014-06,הצפון,507,כפר יאסיף,466,200,266,5,461,366,458,11,9%
2014-06,הצפון,508,כפר כמא,64,27,37,3,61,25,64,0,4%
2014-06,הצפון,509,כפר כנא,1141,472,669,21,1120,968,1085,13,12%
2014-06,הצפון,510,כפר מנדא,999,457,542,14,985,729,963,17,13%
2014-06,הצפון,47,כפר תבור,33,19,14,6,27,3,30,1,1%
2014-06,הצפון,1139,כרמיאל,1715,691,1024,302,1413,828,1630,66,6%
2014-06,הצפון,481,מגאר,1546,603,943,11,1535,1320,1510,17,16%
2014-06,הצפון,516,מג'ד אל-כרום,537,237,300,6,531,424,533,11,8%
2014-06,הצפון,874,מגדל העמק,999,442,557,76,923,436,876,75,7%
2014-06,הצפון,4201,מג'דל שמס,491,177,314,9,482,400,476,5,10%
2014-06,הצפון,517,מזרעה,172,69,103,3,169,142,167,5,9%
2014-06,הצפון,4203,מסעדה,215,73,142,2,213,176,210,5,13%
2014-06,הצפון,518,מעיליא,67,35,32,9,58,30,65,0,4%
2014-06,הצפון,1063,מעלות-תרשיחא,927,458,469,94,833,505,912,36,8%
2014-06,הצפון,520,משהד,282,103,179,5,277,234,274,6,9%
2014-06,הצפון,9100,נהרייה,1981,911,1070,213,1768,1158,1925,82,6%
2014-06,הצפון,522,נחף,397,180,217,12,385,305,393,13,8%
2014-06,הצפון,7300,נצרת,3284,1425,1859,82,3202,2608,3193,30,9%
2014-06,הצפון,1061,נצרת עילית,1796,834,962,152,1644,1011,1591,120,7%
2014-06,הצפון,525,סאג'ור,126,44,82,6,120,79,124,2,7%
2014-06,הצפון,7500,סח'נין,2072,909,1163,13,2059,1788,2062,11,15%
2014-06,הצפון,4501,ע'ג'ר,100,45,55,2,98,67,100,0,10%
2014-06,הצפון,530,עיילבון,190,74,116,2,188,140,188,0,7%
2014-06,הצפון,511,עילוט,329,140,189,1,328,264,320,0,11%
2014-06,הצפון,532,עין מאהל,561,265,296,8,553,464,538,3,10%
2014-06,הצפון,7600,עכו,3299,1533,1766,123,3176,2448,3186,55,12%
2014-06,הצפון,7700,עפולה,1715,711,1004,131,1584,817,1619,82,7%
2014-06,הצפון,531,עראבה,1515,632,883,19,1496,1295,1505,8,15%
2014-06,הצפון,535,פסוטה,119,54,65,6,113,81,118,4,7%
2014-06,הצפון,536,פקיעין (בוקייעה),143,74,69,4,139,93,138,4,5%
2014-06,הצפון,8000,צפת,1484,811,673,59,1425,1114,1413,40,11%
2014-06,הצפון,4100,קצרין,218,97,121,13,205,95,214,10,5%
2014-06,הצפון,2800,קריית שמונה,894,418,476,31,863,358,859,26,7%
2014-06,הצפון,543,ראמה,332,118,214,8,324,241,324,4,8%
2014-06,הצפון,26,ראש פינה,65,30,35,11,54,22,63,2,4%
2014-06,הצפון,542,ריינה,673,289,384,7,666,534,647,14,10%
2014-06,הצפון,122,רמת ישי,97,37,60,30,67,12,91,3,2%
2014-06,הצפון,913,שבלי - אום אל-גנם,230,102,128,6,224,155,227,3,9%
2014-06,הצפון,812,שלומי,251,108,143,18,233,144,245,7,7%
2014-06,הצפון,538,שעב,547,219,328,3,544,471,545,3,18%
2014-06,הצפון,8800,שפרעם,2073,812,1261,29,2044,1728,2041,42,12%
2014-06,חיפה,2710,אום אל-פחם,3826,1581,2245,15,3811,3289,3739,29,18%
2014-06,חיפה,1020,אור עקיבא,612,262,350,48,564,207,588,20,6%
2014-06,חיפה,6000,באקה אל-גרביה,777,365,412,9,768,473,770,23,7%
2014-06,חיפה,9800,בנימינה-גבעת עדה*,213,97,116,54,159,62,212,0,3%
2014-06,חיפה,1326,"בסמ""ה",435,192,243,2,433,354,427,3,11%
2014-06,חיפה,541,ג'סר א-זרקא,484,248,236,2,482,329,480,1,8%
2014-06,חיפה,628,ג'ת,288,156,132,8,280,166,288,4,5%
2014-06,חיפה,494,דאלית אל-כרמל,529,220,309,10,519,305,509,10,6%
2014-06,חיפה,9300,זכרון יעקב,233,114,119,68,165,57,232,0,2%
2014-06,חיפה,6500,חדרה,2440,1060,1380,280,2160,952,2321,57,5%
2014-06,חיפה,4000,חיפה,6485,3124,3361,1192,5293,3494,6226,172,4%
2014-06,חיפה,1247,חריש,44,18,26,6,38,8,40,1,3%
2014-06,חיפה,2100,טירת כרמל,734,351,383,17,717,439,713,27,7%
2014-06,חיפה,654,כפר קרע,443,187,256,8,435,262,436,10,5%
2014-06,חיפה,1327,מעלה עירון,945,364,581,5,940,795,933,8,16%
2014-06,חיפה,2500,נשר,481,240,241,81,400,188,472,10,4%
2014-06,חיפה,534,עספיא,345,157,188,9,336,182,329,2,6%
2014-06,חיפה,637,ערערה,618,246,372,5,613,415,600,21,7%
2014-06,חיפה,537,פוריידיס,419,221,198,1,418,282,414,0,7%
2014-06,חיפה,7800,פרדס חנה-כרכור,860,388,472,105,755,277,852,22,4%
2014-06,חיפה,6800,קריית אתא,1656,746,910,135,1521,914,1625,57,5%
2014-06,חיפה,9500,קריית ביאליק,1047,446,601,131,916,532,1032,37,5%
2014-06,חיפה,2300,קריית טבעון,203,104,99,73,130,42,199,2,2%
2014-06,חיפה,9600,קריית ים,1545,703,842,148,1397,916,1507,61,7%
2014-06,חיפה,8200,קריית מוצקין,1039,449,590,148,891,509,1020,30,4%
2014-06,חיפה,922,רכסים,137,63,74,4,133,77,127,1,4%
2014-06,ירושלים,472,אבו גוש,262,134,128,2,260,179,260,3,9%
2014-06,ירושלים,2610,בית שמש,1312,615,697,93,1219,531,1263,54,4%
2014-06,ירושלים,3000,ירושלים,12091,5569,6522,1299,10792,7398,11853,137,4%
2014-06,ירושלים,1015,מבשרת ציון,404,201,203,74,330,162,396,4,3%
2014-06,ירושלים,1137,קריית יערים,36,16,20,3,33,17,35,0,3%
2014-06,תל אביב,2400,אור יהודה,801,393,408,32,769,247,762,42,4%
2014-06,תל אביב,565,אזור,155,86,69,18,137,31,152,1,2%
2014-06,תל אביב,6100,בני ברק,2278,1097,1180,63,2215,1225,2185,38,4%
2014-06,תל אביב,6200,בת ים,3081,1440,1641,386,2695,1183,2962,88,4%
2014-06,תל אביב,6300,גבעתיים,752,342,410,281,471,88,745,6,2%
2014-06,תל אביב,6400,הרצלייה,1020,406,614,196,824,39,998,27,2%
2014-06,תל אביב,6600,חולון,3061,1442,1619,350,2711,838,2974,55,3%
2014-06,תל אביב,2620,קריית אונו,387,176,211,123,264,45,383,4,2%
2014-06,תל אביב,8600,רמת גן,2004,929,1075,587,1417,432,1967,31,3%
2014-06,תל אביב,2650,רמת השרון,379,165,214,110,269,7,373,10,2%
2014-06,תל אביב,5000,תל אביב -יפו,7502,3721,3781,2320,5182,2262,7349,104,3%
2014-07,אזור יהודה והשומרון,3760,אורנית,131,55,76,38,93,1,130,2,3%
2014-07,אזור יהודה והשומרון,3750,אלפי מנשה,104,43,61,25,79,0,103,2,2%
2014-07,אזור יהודה והשומרון,3560,אלקנה,42,21,21,20,22,1,42,0,2%
2014-07,אזור יהודה והשומרון,3650,אפרת,110,66,44,40,70,10,110,0,3%
2014-07,אזור יהודה והשומרון,3570,אריאל,373,181,192,46,327,78,366,12,3%
2014-07,אזור יהודה והשומרון,3574,בית אל,61,29,32,14,47,20,61,0,2%
2014-07,אזור יהודה והשומרון,3652,בית אריה,63,27,36,8,55,3,62,1,2%
2014-07,אזור יהודה והשומרון,3780,ביתר עילית,711,281,430,8,703,238,703,3,6%
2014-07,אזור יהודה והשומרון,3730,גבעת זאב,205,98,107,41,164,43,202,1,3%
2014-07,אזור יהודה והשומרון,3769,הר אדר,29,14,15,13,16,4,29,0,1%
2014-07,אזור יהודה והשומרון,3797,מודיעין עילית,819,168,651,18,801,84,808,4,6%
2014-07,אזור יהודה והשומרון,3616,מעלה אדומים,764,326,438,55,709,210,754,20,4%
2014-07,אזור יהודה והשומרון,3660,עמנואל,88,47,41,1,87,48,87,1,8%
2014-07,אזור יהודה והשומרון,3557,קדומים,46,25,21,13,33,7,46,1,2%
2014-07,אזור יהודה והשומרון,3611,קריית ארבע,128,77,51,8,120,64,127,2,4%
2014-07,אזור יהודה והשומרון,3640,קרני שומרון,98,49,49,33,65,12,97,2,3%
2014-07,הדרום,31,אופקים,1217,500,717,65,1152,756,1193,11,9%
2014-07,הדרום,2600,אילת,1369,599,770,31,1338,519,1342,48,4%
2014-07,הדרום,70,אשדוד,7398,2921,4476,778,6620,3396,7206,127,7%
2014-07,הדרום,7100,אשקלון,4615,1915,2700,285,4330,2302,4244,63,6%
2014-07,הדרום,9000,באר שבע,7409,3299,4110,783,6626,4337,7114,110,7%
2014-07,הדרום,2200,דימונה,2215,923,1292,107,2108,1378,2127,60,11%
2014-07,הדרום,1303,חורה,850,363,487,2,848,776,837,2,20%
2014-07,הדרום,831,ירוחם,523,243,280,15,508,276,495,33,11%
2014-07,הדרום,1059,כסיפה,1052,403,649,3,1049,920,1045,4,22%
2014-07,הדרום,1271,להבים,49,20,29,16,33,4,49,1,1%
2014-07,הדרום,1060,לקיה,997,441,556,5,992,922,986,2,23%
2014-07,הדרום,1268,מיתר,76,31,45,15,61,7,74,0,2%
2014-07,הדרום,99,מצפה רמון,282,111,171,8,274,173,267,12,11%
2014-07,הדרום,246,נתיבות,1245,531,714,44,1201,566,1196,22,8%
2014-07,הדרום,666,עומר,53,22,31,14,39,4,53,0,1%
2014-07,הדרום,2560,ערד,897,382,515,94,803,415,859,35,7%
2014-07,הדרום,1192,ערערה-בנגב,1062,433,629,8,1054,961,1053,2,25%
2014-07,הדרום,2630,קריית גת,1981,791,1190,114,1867,1164,1924,44,7%
2014-07,הדרום,1034,קריית מלאכי,1061,496,565,19,1042,642,1029,81,9%
2014-07,הדרום,1161,רהט,3422,1373,2049,5,3417,2761,3371,80,18%
2014-07,הדרום,1286,שגב-שלום,608,214,394,4,604,519,598,2,22%
2014-07,הדרום,1031,שדרות,1199,542,657,49,1150,663,1154,22,9%
2014-07,הדרום,1054,תל שבע,1219,567,652,2,1217,1123,1205,4,24%
2014-07,המרכז,182,אבן יהודה,171,77,94,70,101,17,169,4,3%
2014-07,המרכז,41,אליכין,83,38,45,6,77,19,80,1,4%
2014-07,המרכז,1309,אלעד,546,213,333,20,526,92,535,6,4%
2014-07,המרכז,2530,באר יעקב,325,127,198,54,271,58,320,6,4%
2014-07,המרכז,466,בית דגן,105,57,48,10,95,36,104,0,3%
2014-07,המרכז,1066,"בני עי""ש",197,95,102,26,171,76,194,2,5%
2014-07,המרכז,681,גבעת שמואל,315,152,163,48,267,72,305,6,3%
2014-07,המרכז,2550,גדרה,442,185,257,94,348,117,435,7,4%
2014-07,המרכז,627,ג'לג'וליה,79,37,42,2,77,44,77,0,2%
2014-07,המרכז,166,גן יבנה,400,166,234,61,339,87,394,6,3%
2014-07,המרכז,229,גני תקווה,194,83,111,62,132,23,194,1,2%
2014-07,המרכז,9700,הוד השרון,685,321,364,214,471,68,674,11,2%
2014-07,המרכז,1290,זמר,168,50,118,2,166,123,167,1,6%
2014-07,המרכז,2730,טייבה,1750,735,1015,8,1742,1471,1625,28,9%
2014-07,המרכז,2720,טירה,305,145,160,8,297,159,298,5,3%
2014-07,המרכז,2660,יבנה,800,396,404,81,719,313,785,10,3%
2014-07,המרכז,9400,יהוד,550,222,328,90,460,70,525,15,3%
2014-07,המרכז,1224,כוכב יאיר,88,33,55,42,46,0,87,0,2%
2014-07,המרכז,633,כפר ברא,19,8,11,0,19,13,19,0,1%
2014-07,המרכז,168,כפר יונה,332,139,193,76,256,69,327,3,3%
2014-07,המרכז,6900,כפר סבא,1331,599,732,368,963,160,1312,23,2%
2014-07,המרכז,634,כפר קאסם,246,113,133,3,243,131,239,1,3%
2014-07,המרכז,7000,לוד,2296,1035,1261,155,2141,1193,2263,48,6%
2014-07,המרכז,1200,מודיעין-מכבים-רעות*,1050,401,649,296,754,70,1022,16,2%
2014-07,המרכז,28,מזכרת בתיה,190,79,111,38,152,37,188,1,3%
2014-07,המרכז,7200,נס ציונה,740,331,409,156,584,197,733,7,3%
2014-07,המרכז,7400,נתניה,4867,2112,2755,630,4237,1623,4738,105,5%
2014-07,המרכז,587,סביון*,22,10,12,8,14,1,22,0,1%
2014-07,המרכז,171,פרדסייה,67,29,38,19,48,6,67,0,2%
2014-07,המרכז,7900,פתח תקווה,4323,1812,2511,905,3418,1062,4246,59,3%
2014-07,המרכז,195,קדימה-צורן,278,127,151,76,202,43,272,2,3%
2014-07,המרכז,638,קלנסווה,670,278,392,6,664,561,628,13,7%
2014-07,המרכז,469,קריית עקרון,356,174,182,23,333,141,349,5,6%
2014-07,המרכז,2640,ראש העין,787,345,442,87,700,166,765,24,3%
2014-07,המרכז,8300,ראשון לציון,4600,2014,2586,602,3998,1374,4555,84,3%
2014-07,המרכז,8400,רחובות,2987,1225,1762,547,2440,975,2918,30,4%
2014-07,המרכז,8500,רמלה,1970,898,1072,123,1847,746,1902,44,5%
2014-07,המרכז,8700,רעננה,910,396,514,287,623,75,902,6,2%
2014-07,המרכז,1304,שוהם,179,79,100,66,113,11,179,0,2%
2014-07,המרכז,154,תל מונד,171,70,101,64,107,19,171,0,3%
2014-07,הצפון,473,אבו סנאן,660,278,382,9,651,522,652,21,11%
2014-07,הצפון,478,אכסאל,523,232,291,13,510,448,515,6,9%
2014-07,הצפון,529,אעבלין,630,250,380,7,623,526,626,10,11%
2014-07,הצפון,482,בועיינה-נוג'ידאת,401,165,236,3,398,335,388,8,10%
2014-07,הצפון,4001,בוקעאתא,425,172,253,3,422,362,410,0,15%
2014-07,הצפון,998,ביר אל-מכסור,442,176,266,5,437,331,439,1,12%
2014-07,הצפון,480,בית ג'ן,403,121,282,7,396,294,392,1,7%
2014-07,הצפון,9200,בית שאן,917,417,500,12,905,431,885,54,9%
2014-07,הצפון,944,בסמת טבעון,222,105,117,1,221,163,217,2,7%
2014-07,הצפון,483,בענה,367,144,223,4,363,306,363,11,11%
2014-07,הצפון,1292,ג'דיידה-מכר,1379,594,785,11,1368,1119,1356,39,15%
2014-07,הצפון,485,ג'ולס,236,69,167,1,235,156,236,1,8%
2014-07,הצפון,487,ג'ש (גוש חלב),78,38,40,3,75,42,75,1,5%
2014-07,הצפון,489,דבורייה,401,165,236,12,389,308,399,2,9%
2014-07,הצפון,490,דייר אל-אסד,392,160,232,6,386,306,391,9,8%
2014-07,הצפון,492,דייר חנא,673,299,374,9,664,505,670,1,14%
2014-07,הצפון,975,זרזיר,297,140,157,4,293,200,289,4,9%
2014-07,הצפון,496,חורפיש,116,51,65,9,107,65,113,4,4%
2014-07,הצפון,2034,חצור הגלילית,334,153,181,15,319,148,315,12,7%
2014-07,הצפון,6700,טבריה,1858,791,1067,87,1771,1078,1607,54,7%
2014-07,הצפון,962,טובא-זנגרייה,391,163,228,4,387,254,377,1,12%
2014-07,הצפון,498,טורעאן,574,197,377,10,564,457,546,9,10%
2014-07,הצפון,8900,טמרה,2054,820,1234,15,2039,1780,2023,19,14%
2014-07,הצפון,1295,יאנוח-ג'ת,161,58,103,9,152,92,158,5,6%
2014-07,הצפון,46,יבנאל,166,107,59,8,158,132,130,1,8%
2014-07,הצפון,499,יפיע,664,284,380,19,645,523,652,3,8%
2014-07,הצפון,240,יקנעם עילית,563,241,322,57,506,148,551,29,5%
2014-07,הצפון,502,ירכא,547,240,307,1,546,425,538,8,9%
2014-07,הצפון,504,כאבול,701,287,414,11,690,594,693,1,14%
2014-07,הצפון,505,כאוכב אבו אל-היג'א,222,97,125,7,215,191,216,2,13%
2014-07,הצפון,1296,כסרא-סמיע,215,95,120,3,212,161,205,3,6%
2014-07,הצפון,978,כעביה-טבאש-חג'אג'רה,182,69,113,2,180,139,176,5,8%
2014-07,הצפון,1263,כפר ורדים,74,25,49,25,49,4,74,0,2%
2014-07,הצפון,507,כפר יאסיף,456,197,259,5,451,351,449,7,9%
2014-07,הצפון,508,כפר כמא,75,28,47,3,72,27,75,0,5%
2014-07,הצפון,509,כפר כנא,1194,472,722,27,1167,979,1128,40,13%
2014-07,הצפון,510,כפר מנדא,965,424,541,11,954,694,942,1,13%
2014-07,הצפון,47,כפר תבור,38,18,20,6,32,2,37,0,2%
2014-07,הצפון,1139,כרמיאל,1772,710,1062,304,1468,822,1674,70,6%
2014-07,הצפון,481,מגאר,1546,593,953,14,1532,1335,1509,13,16%
2014-07,הצפון,516,מג'ד אל-כרום,566,234,332,8,558,436,563,13,9%
2014-07,הצפון,874,מגדל העמק,1098,472,626,76,1022,424,987,79,7%
2014-07,הצפון,4201,מג'דל שמס,479,177,302,8,471,397,469,3,10%
2014-07,הצפון,517,מזרעה,175,70,105,2,173,142,171,8,9%
2014-07,הצפון,4203,מסעדה,213,69,144,2,211,178,208,0,12%
2014-07,הצפון,518,מעיליא,62,30,32,10,52,28,61,0,4%
2014-07,הצפון,1063,מעלות-תרשיחא,998,477,520,93,905,496,971,33,8%
2014-07,הצפון,520,משהד,299,112,187,4,295,247,287,8,9%
2014-07,הצפון,9100,נהרייה,2066,929,1137,212,1854,1174,2008,75,6%
2014-07,הצפון,522,נחף,404,188,216,10,394,311,399,17,8%
2014-07,הצפון,7300,נצרת,3334,1417,1917,84,3250,2608,3264,18,9%
2014-07,הצפון,1061,נצרת עילית,1931,883,1048,167,1764,1023,1699,121,7%
2014-07,הצפון,525,סאג'ור,122,43,79,3,119,80,121,0,7%
2014-07,הצפון,7500,סח'נין,2114,912,1202,25,2089,1791,2100,14,15%
2014-07,הצפון,4501,ע'ג'ר,102,46,56,2,100,67,102,1,10%
2014-07,הצפון,530,עיילבון,196,72,124,2,194,137,193,0,7%
2014-07,הצפון,511,עילוט,359,146,213,3,356,266,353,1,12%
2014-07,הצפון,532,עין מאהל,561,276,285,6,555,457,537,6,10%
2014-07,הצפון,7600,עכו,3383,1536,1847,138,3245,2419,3279,57,12%
2014-07,הצפון,7700,עפולה,1838,730,1108,132,1706,813,1742,101,7%
2014-07,הצפון,531,עראבה,1553,627,926,22,1531,1328,1538,3,15%
2014-07,הצפון,535,פסוטה,133,53,80,8,125,79,133,8,8%
2014-07,הצפון,536,פקיעין (בוקייעה),146,77,69,5,141,93,142,6,5%
2014-07,הצפון,8000,צפת,1594,852,742,70,1524,1069,1513,55,11%
2014-07,הצפון,4100,קצרין,240,111,129,17,223,99,237,7,6%
2014-07,הצפון,2800,קריית שמונה,957,448,509,36,921,353,925,20,7%
2014-07,הצפון,543,ראמה,320,116,204,10,310,230,315,3,8%
2014-07,הצפון,26,ראש פינה,70,32,38,8,62,22,68,1,4%
2014-07,הצפון,542,ריינה,693,287,406,8,685,538,669,8,10%
2014-07,הצפון,122,רמת ישי,110,42,68,32,78,13,106,0,3%
2014-07,הצפון,913,שבלי - אום אל-גנם,241,98,143,9,232,161,236,3,9%
2014-07,הצפון,812,שלומי,263,111,152,21,242,137,258,10,7%
2014-07,הצפון,538,שעב,546,218,328,5,541,469,543,6,18%
2014-07,הצפון,8800,שפרעם,2090,803,1287,33,2057,1712,2064,34,12%
2014-07,חיפה,2710,אום אל-פחם,3896,1563,2333,25,3871,3255,3812,26,18%
2014-07,חיפה,1020,אור עקיבא,645,274,371,43,602,205,619,17,6%
2014-07,חיפה,6000,באקה אל-גרביה,730,327,403,11,719,470,726,25,6%
2014-07,חיפה,9800,בנימינה-גבעת עדה*,214,99,115,48,166,60,213,0,3%
2014-07,חיפה,1326,"בסמ""ה",433,186,247,4,429,354,425,4,11%
2014-07,חיפה,541,ג'סר א-זרקא,470,240,230,0,470,325,464,4,8%
2014-07,חיפה,628,ג'ת,256,116,140,6,250,162,255,6,5%
2014-07,חיפה,494,דאלית אל-כרמל,559,230,329,7,552,305,536,3,7%
2014-07,חיפה,9300,זכרון יעקב,266,120,146,69,197,58,264,0,2%
2014-07,חיפה,6500,חדרה,2664,1134,1530,291,2373,971,2528,65,5%
2014-07,חיפה,4000,חיפה,6743,3238,3505,1222,5521,3521,6464,156,5%
2014-07,חיפה,1247,חריש,66,30,36,6,60,12,64,2,4%
2014-07,חיפה,2100,טירת כרמל,751,363,388,17,734,440,732,21,7%
2014-07,חיפה,654,כפר קרע,455,194,261,7,448,263,449,10,5%
2014-07,חיפה,1327,מעלה עירון,955,367,588,6,949,787,942,3,16%
2014-07,חיפה,2500,נשר,494,246,248,85,409,189,482,13,4%
2014-07,חיפה,534,עספיא,369,169,200,10,359,187,349,9,6%
2014-07,חיפה,637,ערערה,618,247,371,5,613,422,597,10,7%
2014-07,חיפה,537,פוריידיס,420,211,209,4,416,270,415,2,7%
2014-07,חיפה,7800,פרדס חנה-כרכור,911,412,499,121,790,285,896,23,4%
2014-07,חיפה,6800,קריית אתא,1807,772,1035,144,1663,932,1774,55,6%
2014-07,חיפה,9500,קריית ביאליק,1069,451,618,128,941,548,1050,43,5%
2014-07,חיפה,2300,קריית טבעון,208,102,106,72,136,44,203,2,2%
2014-07,חיפה,9600,קריית ים,1561,716,845,155,1406,896,1530,40,7%
2014-07,חיפה,8200,קריית מוצקין,1129,497,632,157,972,530,1106,32,5%
2014-07,חיפה,922,רכסים,212,67,145,8,204,75,207,0,6%
2014-07,ירושלים,472,אבו גוש,253,133,120,4,249,178,252,2,8%
2014-07,ירושלים,2610,בית שמש,1569,639,930,90,1479,526,1526,51,5%
2014-07,ירושלים,3000,ירושלים,13164,5766,7398,1402,11762,7379,12903,137,4%
2014-07,ירושלים,1015,מבשרת ציון,412,200,212,74,338,165,406,4,3%
2014-07,ירושלים,1137,קריית יערים,49,19,30,5,44,16,48,1,4%
2014-07,תל אביב,2400,אור יהודה,925,449,476,34,891,249,886,41,5%
2014-07,תל אביב,565,אזור,181,88,93,15,166,32,179,2,3%
2014-07,תל אביב,6100,בני ברק,2921,1133,1787,59,2862,1203,2818,23,5%
2014-07,תל אביב,6200,בת ים,3257,1546,1711,413,2844,1174,3124,87,4%
2014-07,תל אביב,6300,גבעתיים,805,352,453,315,490,87,800,5,3%
2014-07,תל אביב,6400,הרצלייה,1139,428,711,215,924,44,1111,41,2%
2014-07,תל אביב,6600,חולון,3299,1515,1784,357,2942,839,3210,74,3%
2014-07,תל אביב,2620,קריית אונו,398,178,220,122,276,51,392,4,2%
2014-07,תל אביב,8600,רמת גן,2138,948,1190,616,1522,438,2103,24,3%
2014-07,תל אביב,2650,רמת השרון,406,165,241,108,298,3,404,6,2%
2014-07,תל אביב,5000,תל אביב -יפו,7740,3823,3917,2383,5357,2277,7564,108,3%
2014-08,אזור יהודה והשומרון,3760,אורנית,126,50,76,39,87,1,125,0,3%
2014-08,אזור יהודה והשומרון,3750,אלפי מנשה,116,46,70,32,84,1,115,1,3%
2014-08,אזור יהודה והשומרון,3560,אלקנה,49,24,25,20,29,2,49,0,3%
2014-08,אזור יהודה והשומרון,3650,אפרת,110,62,48,36,74,6,110,1,3%
2014-08,אזור יהודה והשומרון,3570,אריאל,369,175,194,48,321,73,361,11,3%
2014-08,אזור יהודה והשומרון,3574,בית אל,59,29,30,14,45,16,59,2,2%
2014-08,אזור יהודה והשומרון,3652,בית אריה,69,26,43,8,61,3,68,3,3%
2014-08,אזור יהודה והשומרון,3780,ביתר עילית,767,285,482,8,759,246,760,6,6%
2014-08,אזור יהודה והשומרון,3730,גבעת זאב,234,109,125,41,193,45,229,1,3%
2014-08,אזור יהודה והשומרון,3769,הר אדר,31,16,15,11,20,4,31,0,2%
2014-08,אזור יהודה והשומרון,3797,מודיעין עילית,852,160,692,17,835,76,843,3,6%
2014-08,אזור יהודה והשומרון,3616,מעלה אדומים,768,314,454,53,715,199,752,20,4%
2014-08,אזור יהודה והשומרון,3660,עמנואל,106,53,53,1,105,48,104,0,9%
2014-08,אזור יהודה והשומרון,3557,קדומים,43,27,16,13,30,7,43,0,2%
2014-08,אזור יהודה והשומרון,3611,קריית ארבע,140,82,58,6,134,69,135,2,4%
2014-08,אזור יהודה והשומרון,3640,קרני שומרון,95,48,47,29,66,11,95,0,3%
2014-08,הדרום,31,אופקים,1445,587,858,75,1370,791,1409,26,11%
2014-08,הדרום,2600,אילת,1406,598,808,34,1372,502,1381,42,4%
2014-08,הדרום,70,אשדוד,7869,3093,4776,802,7067,3332,7640,131,7%
2014-08,הדרום,7100,אשקלון,4898,2008,2890,279,4619,2234,4522,67,7%
2014-08,הדרום,9000,באר שבע,7774,3411,4362,837,6937,4255,7457,128,7%
2014-08,הדרום,2200,דימונה,2212,905,1307,106,2106,1368,2134,50,12%
2014-08,הדרום,1303,חורה,857,364,493,3,854,770,843,1,21%
2014-08,הדרום,831,ירוחם,540,250,290,15,525,282,501,33,11%
2014-08,הדרום,1059,כסיפה,1058,403,655,3,1055,927,1051,3,22%
2014-08,הדרום,1271,להבים,50,19,31,17,33,3,49,1,1%
2014-08,הדרום,1060,לקיה,1031,463,568,5,1026,930,1016,1,24%
2014-08,הדרום,1268,מיתר,88,33,55,20,68,8,85,2,2%
2014-08,הדרום,99,מצפה רמון,293,107,186,9,284,172,278,20,11%
2014-08,הדרום,246,נתיבות,1416,590,826,50,1366,580,1362,36,10%
2014-08,הדרום,666,עומר,65,28,37,23,42,4,65,0,2%
2014-08,הדרום,2560,ערד,952,401,551,92,860,425,912,34,7%
2014-08,הדרום,1192,ערערה-בנגב,1081,451,630,7,1074,961,1073,3,25%
2014-08,הדרום,2630,קריית גת,2349,906,1443,135,2214,1204,2277,20,8%
2014-08,הדרום,1034,קריית מלאכי,1295,591,704,22,1273,688,1250,32,11%
2014-08,הדרום,1161,רהט,3540,1474,2066,9,3531,2787,3485,39,18%
2014-08,הדרום,1286,שגב-שלום,613,217,396,5,608,509,605,1,22%
2014-08,הדרום,1031,שדרות,1243,545,698,55,1188,656,1196,25,9%
2014-08,הדרום,1054,תל שבע,1269,595,674,3,1266,1159,1252,1,25%
2014-08,המרכז,182,אבן יהודה,166,78,88,69,97,16,165,4,2%
2014-08,המרכז,41,אליכין,87,36,51,6,81,19,83,1,4%
2014-08,המרכז,1309,אלעד,607,215,392,12,595,92,600,1,5%
2014-08,המרכז,2530,באר יעקב,329,124,205,52,277,52,326,7,4%
2014-08,המרכז,466,בית דגן,109,61,48,7,102,36,109,1,3%
2014-08,המרכז,1066,"בני עי""ש",201,100,101,27,174,74,197,2,5%
2014-08,המרכז,681,גבעת שמואל,308,155,153,42,266,67,301,0,3%
2014-08,המרכז,2550,גדרה,479,194,285,100,379,122,465,6,4%
2014-08,המרכז,627,ג'לג'וליה,85,37,48,2,83,47,81,2,2%
2014-08,המרכז,166,גן יבנה,466,183,283,71,395,87,460,4,4%
2014-08,המרכז,229,גני תקווה,215,89,126,61,154,24,212,0,3%
2014-08,המרכז,9700,הוד השרון,688,311,377,202,486,72,682,6,2%
2014-08,המרכז,1290,זמר,182,59,123,2,180,120,180,6,6%
2014-08,המרכז,2730,טייבה,1757,734,1023,11,1746,1448,1625,33,9%
2014-08,המרכז,2720,טירה,323,146,177,11,312,156,311,5,3%
2014-08,המרכז,2660,יבנה,1028,492,536,94,934,336,1010,5,4%
2014-08,המרכז,9400,יהוד,519,204,315,80,439,71,506,15,3%
2014-08,המרכז,1224,כוכב יאיר,98,40,58,43,55,0,96,0,2%
2014-08,המרכז,633,כפר ברא,20,10,10,0,20,11,20,0,1%
2014-08,המרכז,168,כפר יונה,347,134,213,69,278,67,342,5,3%
2014-08,המרכז,6900,כפר סבא,1339,601,738,370,969,152,1321,10,2%
2014-08,המרכז,634,כפר קאסם,264,128,136,3,261,133,254,4,3%
2014-08,המרכז,7000,לוד,2362,1054,1308,153,2209,1182,2328,34,7%
2014-08,המרכז,1200,מודיעין-מכבים-רעות*,1115,439,676,278,837,62,1095,17,3%
2014-08,המרכז,28,מזכרת בתיה,238,91,147,56,182,36,237,2,3%
2014-08,המרכז,7200,נס ציונה,796,356,440,160,636,202,791,7,3%
2014-08,המרכז,7400,נתניה,4980,2125,2855,632,4348,1568,4869,93,5%
2014-08,המרכז,587,סביון*,26,15,11,10,16,1,26,0,1%
2014-08,המרכז,171,פרדסייה,66,32,34,19,47,5,66,0,2%
2014-08,המרכז,7900,פתח תקווה,4492,1872,2620,885,3607,1102,4414,58,4%
2014-08,המרכז,195,קדימה-צורן,281,113,168,78,203,43,277,2,3%
2014-08,המרכז,638,קלנסווה,683,295,388,8,675,566,638,7,7%
2014-08,המרכז,469,קריית עקרון,403,184,219,25,378,143,396,11,7%
2014-08,המרכז,2640,ראש העין,868,361,507,94,774,162,847,11,4%
2014-08,המרכז,8300,ראשון לציון,4736,2038,2698,561,4175,1350,4682,99,3%
2014-08,המרכז,8400,רחובות,3112,1200,1912,546,2566,969,3037,47,4%
2014-08,המרכז,8500,רמלה,2007,913,1094,120,1887,749,1937,51,5%
2014-08,המרכז,8700,רעננה,900,379,521,288,612,71,895,8,2%
2014-08,המרכז,1304,שוהם,172,76,96,61,111,10,172,1,2%
2014-08,המרכז,154,תל מונד,185,73,112,68,117,19,184,2,3%
2014-08,הצפון,473,אבו סנאן,652,277,375,8,644,521,643,15,11%
2014-08,הצפון,478,אכסאל,531,237,294,12,519,456,523,1,9%
2014-08,הצפון,529,אעבלין,639,256,383,4,635,528,633,5,11%
2014-08,הצפון,482,בועיינה-נוג'ידאת,404,171,233,8,396,339,391,3,10%
2014-08,הצפון,4001,בוקעאתא,430,175,255,3,427,361,409,1,15%
2014-08,הצפון,998,ביר אל-מכסור,446,177,269,5,441,341,443,4,12%
2014-08,הצפון,480,בית ג'ן,404,130,274,5,399,298,393,1,7%
2014-08,הצפון,9200,בית שאן,937,431,506,17,920,434,899,54,9%
2014-08,הצפון,944,בסמת טבעון,221,107,114,1,220,159,216,4,7%
2014-08,הצפון,483,בענה,376,144,232,4,372,314,373,12,11%
2014-08,הצפון,1292,ג'דיידה-מכר,1382,597,785,12,1370,1111,1355,49,15%
2014-08,הצפון,485,ג'ולס,234,70,164,1,233,155,234,3,8%
2014-08,הצפון,487,ג'ש (גוש חלב),72,38,34,1,71,42,69,2,4%
2014-08,הצפון,489,דבורייה,405,165,240,12,393,303,402,1,9%
2014-08,הצפון,490,דייר אל-אסד,399,156,243,6,393,305,397,10,8%
2014-08,הצפון,492,דייר חנא,668,297,371,9,659,502,663,2,14%
2014-08,הצפון,975,זרזיר,300,147,153,3,297,195,285,12,9%
2014-08,הצפון,496,חורפיש,115,56,59,6,109,63,114,1,4%
2014-08,הצפון,2034,חצור הגלילית,306,132,174,13,293,146,286,12,6%
2014-08,הצפון,6700,טבריה,1849,776,1073,92,1757,1025,1624,65,7%
2014-08,הצפון,962,טובא-זנגרייה,381,163,218,4,377,260,369,8,12%
2014-08,הצפון,498,טורעאן,591,222,369,14,577,467,545,7,10%
2014-08,הצפון,8900,טמרה,2064,827,1237,14,2050,1778,2033,23,14%
2014-08,הצפון,1295,יאנוח-ג'ת,157,55,102,10,147,92,156,2,6%
2014-08,הצפון,46,יבנאל,172,110,62,10,162,124,140,2,9%
2014-08,הצפון,499,יפיע,664,280,384,13,651,531,653,2,8%
2014-08,הצפון,240,יקנעם עילית,565,239,326,59,506,143,554,31,5%
2014-08,הצפון,502,ירכא,556,245,311,1,555,425,545,7,9%
2014-08,הצפון,504,כאבול,697,284,413,10,687,591,690,4,14%
2014-08,הצפון,505,כאוכב אבו אל-היג'א,222,93,129,9,213,188,217,0,13%
2014-08,הצפון,1296,כסרא-סמיע,199,81,118,2,197,144,193,3,6%
2014-08,הצפון,978,כעביה-טבאש-חג'אג'רה,176,65,111,4,172,137,172,1,8%
2014-08,הצפון,1263,כפר ורדים,80,35,45,38,42,5,80,1,3%
2014-08,הצפון,507,כפר יאסיף,448,195,253,4,444,348,438,9,9%
2014-08,הצפון,508,כפר כמא,73,28,45,4,69,27,73,2,4%
2014-08,הצפון,509,כפר כנא,1209,493,716,24,1185,999,1134,25,13%
2014-08,הצפון,510,כפר מנדא,964,410,554,8,956,700,946,21,13%
2014-08,הצפון,47,כפר תבור,39,17,22,10,29,2,37,0,2%
2014-08,הצפון,1139,כרמיאל,1767,715,1052,298,1469,797,1673,63,6%
2014-08,הצפון,481,מגאר,1546,607,939,14,1532,1333,1505,13,16%
2014-08,הצפון,516,מג'ד אל-כרום,579,241,338,7,572,430,574,14,9%
2014-08,הצפון,874,מגדל העמק,1098,460,638,70,1028,418,993,72,7%
2014-08,הצפון,4201,מג'דל שמס,471,166,305,8,463,402,459,7,10%
2014-08,הצפון,517,מזרעה,178,68,110,1,177,148,171,5,9%
2014-08,הצפון,4203,מסעדה,208,71,137,2,206,178,201,4,12%
2014-08,הצפון,518,מעיליא,55,26,29,8,47,27,54,1,3%
2014-08,הצפון,1063,מעלות-תרשיחא,893,427,466,94,799,480,874,34,7%
2014-08,הצפון,520,משהד,293,115,178,4,289,240,282,1,9%
2014-08,הצפון,9100,נהרייה,2054,930,1124,197,1857,1174,1980,87,6%
2014-08,הצפון,522,נחף,409,193,216,9,400,315,402,13,8%
2014-08,הצפון,7300,נצרת,3364,1427,1937,83,3281,2629,3286,19,9%
2014-08,הצפון,1061,נצרת עילית,1945,892,1053,174,1771,974,1754,117,7%
2014-08,הצפון,525,סאג'ור,115,41,74,4,111,73,114,0,6%
2014-08,הצפון,7500,סח'נין,2125,903,1222,27,2098,1795,2111,7,15%
2014-08,הצפון,4501,ע'ג'ר,109,51,58,3,106,69,108,0,10%
2014-08,הצפון,530,עיילבון,190,75,115,1,189,132,188,2,7%
2014-08,הצפון,511,עילוט,364,147,217,3,361,267,360,1,13%
2014-08,הצפון,532,עין מאהל,542,254,288,7,535,444,522,3,10%
2014-08,הצפון,7600,עכו,3362,1528,1834,138,3224,2398,3251,63,12%
2014-08,הצפון,7700,עפולה,1867,755,1112,126,1741,804,1765,77,7%
2014-08,הצפון,531,עראבה,1555,631,924,22,1533,1321,1543,7,15%
2014-08,הצפון,535,פסוטה,121,48,73,7,114,76,121,4,7%
2014-08,הצפון,536,פקיעין (בוקייעה),147,76,71,6,141,90,144,4,5%
2014-08,הצפון,8000,צפת,1548,801,747,66,1482,1048,1476,41,11%
2014-08,הצפון,4100,קצרין,229,105,124,16,213,97,225,9,6%
2014-08,הצפון,2800,קריית שמונה,900,406,494,38,862,372,863,25,7%
2014-08,הצפון,543,ראמה,318,118,200,11,307,230,313,2,8%
2014-08,הצפון,26,ראש פינה,69,31,38,11,58,22,67,1,4%
2014-08,הצפון,542,ריינה,703,290,413,10,693,546,670,13,10%
2014-08,הצפון,122,רמת ישי,109,42,67,34,75,15,106,0,3%
2014-08,הצפון,913,שבלי - אום אל-גנם,266,109,157,10,256,171,262,0,10%
2014-08,הצפון,812,שלומי,261,108,153,17,244,141,255,5,7%
2014-08,הצפון,538,שעב,543,218,325,5,538,464,542,2,18%
2014-08,הצפון,8800,שפרעם,2105,804,1301,34,2071,1704,2076,34,12%
2014-08,חיפה,2710,אום אל-פחם,3972,1604,2368,28,3944,3303,3879,31,18%
2014-08,חיפה,1020,אור עקיבא,607,245,362,46,561,201,588,16,6%
2014-08,חיפה,6000,באקה אל-גרביה,741,333,408,8,733,451,734,24,6%
2014-08,חיפה,9800,בנימינה-גבעת עדה*,208,98,110,40,168,61,207,1,3%
2014-08,חיפה,1326,"בסמ""ה",441,194,247,4,437,352,436,6,11%
2014-08,חיפה,541,ג'סר א-זרקא,499,257,242,1,498,326,495,0,8%
2014-08,חיפה,628,ג'ת,258,122,136,9,249,155,255,9,5%
2014-08,חיפה,494,דאלית אל-כרמל,551,218,333,9,542,297,531,5,7%
2014-08,חיפה,9300,זכרון יעקב,278,118,160,76,202,55,275,1,3%
2014-08,חיפה,6500,חדרה,2666,1097,1569,285,2381,943,2532,62,5%
2014-08,חיפה,4000,חיפה,6784,3238,3546,1215,5569,3483,6507,193,5%
2014-08,חיפה,1247,חריש,62,28,34,4,58,16,60,0,4%
2014-08,חיפה,2100,טירת כרמל,761,367,394,17,744,428,740,15,7%
2014-08,חיפה,654,כפר קרע,451,193,258,8,443,270,442,12,5%
2014-08,חיפה,1327,מעלה עירון,972,370,602,8,964,790,960,6,16%
2014-08,חיפה,2500,נשר,496,239,257,90,406,191,483,8,4%
2014-08,חיפה,534,עספיא,365,169,196,15,350,174,352,8,6%
2014-08,חיפה,637,ערערה,628,262,366,5,623,421,612,19,8%
2014-08,חיפה,537,פוריידיס,448,228,220,3,445,282,443,8,8%
2014-08,חיפה,7800,פרדס חנה-כרכור,923,421,502,124,799,288,915,31,5%
2014-08,חיפה,6800,קריית אתא,1822,767,1055,152,1670,917,1787,44,6%
2014-08,חיפה,9500,קריית ביאליק,1061,446,615,121,940,528,1045,41,5%
2014-08,חיפה,2300,קריית טבעון,211,111,100,71,140,44,204,1,2%
2014-08,חיפה,9600,קריית ים,1570,721,849,153,1417,866,1537,49,7%
2014-08,חיפה,8200,קריית מוצקין,1091,458,633,145,946,514,1068,32,5%
2014-08,חיפה,922,רכסים,220,71,149,6,214,78,213,1,6%
2014-08,ירושלים,472,אבו גוש,259,133,126,5,254,177,258,6,8%
2014-08,ירושלים,2610,בית שמש,1631,629,1002,75,1556,511,1589,34,5%
2014-08,ירושלים,3000,ירושלים,13666,5965,7701,1406,12260,7432,13412,124,4%
2014-08,ירושלים,1015,מבשרת ציון,433,204,229,74,359,167,426,4,3%
2014-08,ירושלים,1137,קריית יערים,51,18,33,6,45,17,51,0,4%
2014-08,תל אביב,2400,אור יהודה,948,419,529,28,920,235,906,38,5%
2014-08,תל אביב,565,אזור,183,93,90,18,165,34,179,1,3%
2014-08,תל אביב,6100,בני ברק,3109,1092,2016,57,3052,1172,3005,21,5%
2014-08,תל אביב,6200,בת ים,3247,1509,1738,420,2827,1178,3110,97,4%
2014-08,תל אביב,6300,גבעתיים,830,362,468,327,503,85,825,9,3%
2014-08,תל אביב,6400,הרצלייה,1226,452,774,232,994,38,1196,48,2%
2014-08,תל אביב,6600,חולון,3321,1512,1809,329,2992,847,3236,70,3%
2014-08,תל אביב,2620,קריית אונו,413,185,228,126,287,53,407,3,2%
2014-08,תל אביב,8600,רמת גן,2188,952,1236,629,1559,443,2150,25,3%
2014-08,תל אביב,2650,רמת השרון,430,169,261,121,309,2,427,1,2%
2014-08,תל אביב,5000,תל אביב -יפו,7838,3902,3936,2335,5503,2237,7667,142,3%
2014-09,אזור יהודה והשומרון,3760,אורנית,120,45,75,41,79,1,119,0,3%
2014-09,אזור יהודה והשומרון,3750,אלפי מנשה,106,40,66,33,73,2,106,2,2%
2014-09,אזור יהודה והשומרון,3560,אלקנה,44,21,23,17,27,1,44,0,2%
2014-09,אזור יהודה והשומרון,3650,אפרת,130,72,58,42,88,6,126,1,3%
2014-09,אזור יהודה והשומרון,3570,אריאל,371,174,197,52,319,71,363,9,3%
2014-09,אזור יהודה והשומרון,3574,בית אל,58,28,30,14,44,20,57,1,2%
2014-09,אזור יהודה והשומרון,3652,בית אריה,63,24,39,8,55,3,63,0,2%
2014-09,אזור יהודה והשומרון,3780,ביתר עילית,692,276,416,8,684,255,686,7,6%
2014-09,אזור יהודה והשומרון,3730,גבעת זאב,231,95,136,42,189,45,227,5,3%
2014-09,אזור יהודה והשומרון,3769,הר אדר,34,18,16,12,22,3,34,0,2%
2014-09,אזור יהודה והשומרון,3797,מודיעין עילית,640,146,494,17,623,89,627,7,5%
2014-09,אזור יהודה והשומרון,3616,מעלה אדומים,696,301,395,55,641,199,684,20,3%
2014-09,אזור יהודה והשומרון,3660,עמנואל,84,47,37,1,83,46,84,5,7%
2014-09,אזור יהודה והשומרון,3557,קדומים,45,20,25,15,30,7,43,1,2%
2014-09,אזור יהודה והשומרון,3611,קריית ארבע,138,74,64,10,128,65,133,4,4%
2014-09,אזור יהודה והשומרון,3640,קרני שומרון,92,46,46,28,64,11,90,1,2%
2014-09,הדרום,31,אופקים,1497,599,898,77,1420,794,1448,45,11%
2014-09,הדרום,2600,אילת,1428,637,791,38,1390,508,1401,54,4%
2014-09,הדרום,70,אשדוד,7052,2837,4215,771,6281,3325,6831,233,6%
2014-09,הדרום,7100,אשקלון,4662,1885,2777,263,4399,2266,4270,112,6%
2014-09,הדרום,9000,באר שבע,7376,3200,4175,803,6573,4232,7077,184,7%
2014-09,הדרום,2200,דימונה,2141,903,1238,115,2026,1361,2052,44,11%
2014-09,הדרום,1303,חורה,846,350,496,5,841,771,835,2,20%
2014-09,הדרום,831,ירוחם,509,238,271,14,495,273,476,19,10%
2014-09,הדרום,1059,כסיפה,1035,399,636,4,1031,926,1028,3,22%
2014-09,הדרום,1271,להבים,55,23,32,20,35,4,54,2,2%
2014-09,הדרום,1060,לקיה,1017,457,560,5,1012,930,1003,5,23%
2014-09,הדרום,1268,מיתר,72,30,42,24,48,7,68,1,2%
2014-09,הדרום,99,מצפה רמון,285,110,175,10,275,172,272,16,11%
2014-09,הדרום,246,נתיבות,1325,528,797,51,1274,569,1267,68,9%
2014-09,הדרום,666,עומר,68,27,41,22,46,4,65,0,2%
2014-09,הדרום,2560,ערד,920,399,521,82,838,422,884,38,7%
2014-09,הדרום,1192,ערערה-בנגב,1094,463,631,5,1089,978,1081,1,26%
2014-09,הדרום,2630,קריית גת,2516,972,1544,124,2392,1210,2433,68,8%
2014-09,הדרום,1034,קריית מלאכי,1390,624,766,21,1369,681,1340,65,11%
2014-09,הדרום,1161,רהט,3386,1384,2002,4,3382,2819,3348,31,17%
2014-09,הדרום,1286,שגב-שלום,609,219,390,4,605,520,600,2,22%
2014-09,הדרום,1031,שדרות,1209,521,688,57,1152,653,1159,23,9%
2014-09,הדרום,1054,תל שבע,1255,587,668,4,1251,1167,1238,6,25%
2014-09,המרכז,182,אבן יהודה,171,84,87,64,107,16,170,1,3%
2014-09,המרכז,41,אליכין,80,37,43,5,75,18,76,0,4%
2014-09,המרכז,1309,אלעד,559,210,349,11,548,87,550,3,4%
2014-09,המרכז,2530,באר יעקב,316,113,203,55,261,57,310,2,3%
2014-09,המרכז,466,בית דגן,105,56,49,7,98,35,105,1,3%
2014-09,המרכז,1066,"בני עי""ש",197,100,97,29,168,72,195,2,5%
2014-09,המרכז,681,גבעת שמואל,321,164,157,37,284,68,314,1,3%
2014-09,המרכז,2550,גדרה,443,181,262,91,352,115,435,12,4%
2014-09,המרכז,627,ג'לג'וליה,91,42,49,4,87,53,87,2,2%
2014-09,המרכז,166,גן יבנה,439,160,279,79,360,95,436,10,4%
2014-09,המרכז,229,גני תקווה,196,86,110,62,134,23,196,0,2%
2014-09,המרכז,9700,הוד השרון,666,283,383,203,463,70,660,9,2%
2014-09,המרכז,1290,זמר,180,58,122,3,177,114,179,2,6%
2014-09,המרכז,2730,טייבה,1725,742,983,15,1710,1419,1581,40,9%
2014-09,המרכז,2720,טירה,349,156,193,15,334,157,339,6,3%
2014-09,המרכז,2660,יבנה,1078,504,574,108,970,328,1053,36,5%
2014-09,המרכז,9400,יהוד,495,204,291,73,422,71,485,18,3%
2014-09,המרכז,1224,כוכב יאיר,94,39,55,40,54,0,92,0,2%
2014-09,המרכז,633,כפר ברא,18,8,10,0,18,9,18,0,1%
2014-09,המרכז,168,כפר יונה,357,144,213,69,288,68,349,8,3%
2014-09,המרכז,6900,כפר סבא,1311,575,736,367,944,161,1298,22,2%
2014-09,המרכז,634,כפר קאסם,253,123,130,6,247,130,246,4,3%
2014-09,המרכז,7000,לוד,2307,1045,1262,155,2152,1191,2266,40,6%
2014-09,המרכז,1200,מודיעין-מכבים-רעות*,1014,414,600,259,755,64,990,13,2%
2014-09,המרכז,28,מזכרת בתיה,188,81,107,43,145,38,187,3,3%
2014-09,המרכז,7200,נס ציונה,729,346,383,159,570,205,723,9,3%
2014-09,המרכז,7400,נתניה,4744,2076,2668,652,4092,1530,4629,104,4%
2014-09,המרכז,587,סביון*,24,16,8,8,16,1,24,0,1%
2014-09,המרכז,171,פרדסייה,67,32,35,18,49,7,66,0,2%
2014-09,המרכז,7900,פתח תקווה,4294,1797,2497,875,3419,1106,4213,73,3%
2014-09,המרכז,195,קדימה-צורן,278,123,155,82,196,36,274,1,3%
2014-09,המרכז,638,קלנסווה,657,268,389,9,648,545,613,19,7%
2014-09,המרכז,469,קריית עקרון,317,151,166,17,300,137,313,12,5%
2014-09,המרכז,2640,ראש העין,816,350,466,88,728,158,795,15,3%
2014-09,המרכז,8300,ראשון לציון,4626,1958,2668,528,4098,1353,4591,108,3%
2014-09,המרכז,8400,רחובות,2854,1211,1643,538,2316,970,2789,49,4%
2014-09,המרכז,8500,רמלה,1918,865,1053,126,1792,758,1836,65,5%
2014-09,המרכז,8700,רעננה,875,373,502,275,600,75,867,14,2%
2014-09,המרכז,1304,שוהם,173,81,92,59,114,9,173,0,2%
2014-09,המרכז,154,תל מונד,163,72,91,65,98,17,163,0,3%
2014-09,הצפון,473,אבו סנאן,665,273,392,7,658,522,658,22,11%
2014-09,הצפון,478,אכסאל,523,240,283,12,511,453,516,1,9%
2014-09,הצפון,529,אעבלין,634,247,387,6,628,512,626,18,11%
2014-09,הצפון,482,בועיינה-נוג'ידאת,414,176,238,14,400,345,398,1,10%
2014-09,הצפון,4001,בוקעאתא,422,163,259,3,419,356,410,1,15%
2014-09,הצפון,998,ביר אל-מכסור,433,169,264,4,429,322,431,0,12%
2014-09,הצפון,480,בית ג'ן,382,119,263,6,376,280,368,1,7%
2014-09,הצפון,9200,בית שאן,931,407,524,23,908,432,895,80,9%
2014-09,הצפון,944,בסמת טבעון,229,111,118,1,228,169,222,2,7%
2014-09,הצפון,483,בענה,365,144,221,5,360,308,362,12,11%
2014-09,הצפון,1292,ג'דיידה-מכר,1360,591,769,9,1351,1100,1341,32,15%
2014-09,הצפון,485,ג'ולס,233,67,166,1,232,155,232,7,8%
2014-09,הצפון,487,ג'ש (גוש חלב),67,37,30,1,66,39,65,1,4%
2014-09,הצפון,489,דבורייה,399,168,231,18,381,296,395,2,9%
2014-09,הצפון,490,דייר אל-אסד,397,152,245,6,391,309,396,8,8%
2014-09,הצפון,492,דייר חנא,681,301,380,9,672,516,676,4,14%
2014-09,הצפון,975,זרזיר,282,136,146,2,280,187,269,4,9%
2014-09,הצפון,496,חורפיש,117,55,62,5,112,65,115,2,4%
2014-09,הצפון,2034,חצור הגלילית,297,126,171,17,280,143,279,11,6%
2014-09,הצפון,6700,טבריה,1849,797,1052,98,1751,1002,1642,66,8%
2014-09,הצפון,962,טובא-זנגרייה,376,169,207,6,370,253,363,10,12%
2014-09,הצפון,498,טורעאן,546,205,341,12,534,444,512,14,9%
2014-09,הצפון,8900,טמרה,2019,805,1214,14,2005,1746,1978,19,14%
2014-09,הצפון,1295,יאנוח-ג'ת,158,56,102,10,148,98,156,4,6%
2014-09,הצפון,46,יבנאל,166,106,60,8,158,108,135,2,9%
2014-09,הצפון,499,יפיע,675,279,396,11,664,529,659,7,8%
2014-09,הצפון,240,יקנעם עילית,547,225,322,63,484,149,536,32,5%
2014-09,הצפון,502,ירכא,559,255,304,1,558,431,554,4,10%
2014-09,הצפון,504,כאבול,678,276,402,4,674,576,668,2,14%
2014-09,הצפון,505,כאוכב אבו אל-היג'א,221,91,130,9,212,190,216,1,13%
2014-09,הצפון,1296,כסרא-סמיע,209,90,119,2,207,148,204,2,6%
2014-09,הצפון,978,כעביה-טבאש-חג'אג'רה,192,77,115,4,188,143,187,4,8%
2014-09,הצפון,1263,כפר ורדים,82,32,50,39,43,6,81,1,3%
2014-09,הצפון,507,כפר יאסיף,455,201,254,4,451,350,445,16,9%
2014-09,הצפון,508,כפר כמא,69,27,42,4,65,27,68,0,4%
2014-09,הצפון,509,כפר כנא,1196,496,700,27,1169,981,1123,24,13%
2014-09,הצפון,510,כפר מנדא,970,421,549,11,959,722,935,21,13%
2014-09,הצפון,47,כפר תבור,36,14,22,12,24,1,36,0,2%
2014-09,הצפון,1139,כרמיאל,1753,717,1036,294,1459,791,1665,62,6%
2014-09,הצפון,481,מגאר,1545,624,921,17,1528,1346,1509,17,16%
2014-09,הצפון,516,מג'ד אל-כרום,553,237,316,7,546,409,548,11,8%
2014-09,הצפון,874,מגדל העמק,1111,443,668,80,1031,420,999,70,7%
2014-09,הצפון,4201,מג'דל שמס,475,167,308,9,466,400,461,8,10%
2014-09,הצפון,517,מזרעה,175,69,106,2,173,150,170,4,9%
2014-09,הצפון,4203,מסעדה,208,71,137,3,205,179,201,2,12%
2014-09,הצפון,518,מעיליא,53,26,27,7,46,21,53,1,3%
2014-09,הצפון,1063,מעלות-תרשיחא,892,415,477,98,794,475,876,44,7%
2014-09,הצפון,520,משהד,291,117,174,9,282,241,276,3,9%
2014-09,הצפון,9100,נהרייה,2108,969,1139,190,1918,1179,2049,72,7%
2014-09,הצפון,522,נחף,407,191,216,6,401,322,400,11,8%
2014-09,הצפון,7300,נצרת,3375,1421,1954,84,3291,2634,3289,27,9%
2014-09,הצפון,1061,נצרת עילית,1900,869,1031,182,1718,955,1708,117,7%
2014-09,הצפון,525,סאג'ור,115,40,75,2,113,71,112,0,6%
2014-09,הצפון,7500,סח'נין,2130,917,1213,27,2103,1806,2112,10,15%
2014-09,הצפון,4501,ע'ג'ר,100,44,56,3,97,67,99,1,10%
2014-09,הצפון,530,עיילבון,196,77,119,3,193,138,194,3,7%
2014-09,הצפון,511,עילוט,355,149,206,4,351,277,345,3,12%
2014-09,הצפון,532,עין מאהל,540,254,286,9,531,447,523,1,10%
2014-09,הצפון,7600,עכו,3287,1488,1799,129,3158,2413,3160,72,12%
2014-09,הצפון,7700,עפולה,1800,701,1099,127,1673,788,1707,87,7%
2014-09,הצפון,531,עראבה,1565,646,919,26,1539,1335,1553,7,15%
2014-09,הצפון,535,פסוטה,112,46,66,8,104,69,111,4,7%
2014-09,הצפון,536,פקיעין (בוקייעה),143,76,67,6,137,88,140,2,5%
2014-09,הצפון,8000,צפת,1495,779,716,71,1424,1030,1430,53,11%
2014-09,הצפון,4100,קצרין,238,99,139,19,219,101,233,8,6%
2014-09,הצפון,2800,קריית שמונה,905,417,488,44,861,372,862,44,7%
2014-09,הצפון,543,ראמה,313,123,190,14,299,233,309,3,8%
2014-09,הצפון,26,ראש פינה,61,28,33,9,52,21,59,0,4%
2014-09,הצפון,542,ריינה,694,283,411,9,685,541,666,6,10%
2014-09,הצפון,122,רמת ישי,105,43,62,27,78,15,104,0,3%
2014-09,הצפון,913,שבלי - אום אל-גנם,258,108,150,10,248,173,250,3,10%
2014-09,הצפון,812,שלומי,263,105,158,14,249,140,258,8,7%
2014-09,הצפון,538,שעב,557,222,335,6,551,478,553,2,18%
2014-09,הצפון,8800,שפרעם,2080,800,1280,28,2052,1666,2044,43,12%
2014-09,חיפה,2710,אום אל-פחם,3857,1555,2302,29,3828,3221,3786,17,18%
2014-09,חיפה,1020,אור עקיבא,644,267,377,51,593,204,619,18,6%
2014-09,חיפה,6000,באקה אל-גרביה,738,341,397,10,728,430,731,29,6%
2014-09,חיפה,9800,בנימינה-גבעת עדה*,221,102,119,42,179,62,220,5,3%
2014-09,חיפה,1326,"בסמ""ה",431,187,244,3,428,338,427,10,11%
2014-09,חיפה,541,ג'סר א-זרקא,500,254,246,1,499,323,496,2,8%
2014-09,חיפה,628,ג'ת,238,117,121,9,229,146,238,7,5%
2014-09,חיפה,494,דאלית אל-כרמל,541,214,327,7,534,289,523,6,7%
2014-09,חיפה,9300,זכרון יעקב,284,110,174,84,200,56,281,0,3%
2014-09,חיפה,6500,חדרה,2664,1089,1575,291,2373,943,2511,60,5%
2014-09,חיפה,4000,חיפה,6797,3231,3566,1216,5581,3432,6517,179,5%
2014-09,חיפה,1247,חריש,60,26,34,6,54,14,58,0,4%
2014-09,חיפה,2100,טירת כרמל,760,353,407,23,737,436,734,22,7%
2014-09,חיפה,654,כפר קרע,450,199,251,6,444,271,439,10,5%
2014-09,חיפה,1327,מעלה עירון,956,368,588,9,947,762,948,4,16%
2014-09,חיפה,2500,נשר,485,220,265,92,393,192,471,10,4%
2014-09,חיפה,534,עספיא,348,165,183,14,334,176,332,5,6%
2014-09,חיפה,637,ערערה,618,248,370,2,616,416,604,18,7%
2014-09,חיפה,537,פוריידיס,463,231,232,2,461,272,458,4,8%
2014-09,חיפה,7800,פרדס חנה-כרכור,968,420,548,141,827,274,958,28,5%
2014-09,חיפה,6800,קריית אתא,1698,749,949,151,1547,896,1668,44,6%
2014-09,חיפה,9500,קריית ביאליק,1066,439,627,125,941,547,1047,27,5%
2014-09,חיפה,2300,קריית טבעון,215,108,107,67,148,47,207,5,2%
2014-09,חיפה,9600,קריית ים,1515,688,827,151,1364,871,1480,41,7%
2014-09,חיפה,8200,קריית מוצקין,1084,446,638,157,927,498,1057,29,5%
2014-09,חיפה,922,רכסים,197,76,121,8,189,85,191,1,6%
2014-09,ירושלים,472,אבו גוש,258,129,129,6,252,181,258,1,8%
2014-09,ירושלים,2610,בית שמש,1532,573,959,70,1462,524,1488,38,5%
2014-09,ירושלים,3000,ירושלים,13368,5909,7459,1440,11928,7543,13094,138,4%
2014-09,ירושלים,1015,מבשרת ציון,422,190,232,82,340,171,412,3,3%
2014-09,ירושלים,1137,קריית יערים,47,23,24,7,40,15,47,0,4%
2014-09,תל אביב,2400,אור יהודה,885,416,469,35,850,232,844,41,4%
2014-09,תל אביב,565,אזור,186,101,85,20,166,35,182,0,3%
2014-09,תל אביב,6100,בני ברק,2719,1091,1627,50,2669,1153,2611,25,5%
2014-09,תל אביב,6200,בת ים,3242,1494,1748,397,2845,1147,3121,88,4%
2014-09,תל אביב,6300,גבעתיים,778,358,420,316,462,85,770,4,3%
2014-09,תל אביב,6400,הרצלייה,1209,468,741,236,973,39,1175,58,2%
2014-09,תל אביב,6600,חולון,3331,1525,1806,307,3024,831,3241,58,3%
2014-09,תל אביב,2620,קריית אונו,377,173,204,109,268,51,373,3,2%
2014-09,תל אביב,8600,רמת גן,2161,968,1193,642,1519,461,2123,30,3%
2014-09,תל אביב,2650,רמת השרון,440,168,272,119,321,4,438,3,2%
2014-09,תל אביב,5000,תל אביב -יפו,7740,3835,3905,2290,5450,2179,7590,137,3%
2014-10,אזור יהודה והשומרון,3760,אורנית,97,36,61,35,62,1,97,0,2%
2014-10,אזור יהודה והשומרון,3750,אלפי מנשה,85,37,48,27,58,1,85,0,2%
2014-10,אזור יהודה והשומרון,3560,אלקנה,33,16,17,14,19,1,33,0,2%
2014-10,אזור יהודה והשומרון,3650,אפרת,110,58,52,44,66,6,110,1,3%
2014-10,אזור יהודה והשומרון,3570,אריאל,313,151,162,44,269,69,307,5,3%
2014-10,אזור יהודה והשומרון,3574,בית אל,44,18,26,12,32,19,43,0,2%
2014-10,אזור יהודה והשומרון,3652,בית אריה,57,25,32,8,49,3,57,0,2%
2014-10,אזור יהודה והשומרון,3780,ביתר עילית,563,238,325,8,555,248,559,0,5%
2014-10,אזור יהודה והשומרון,3730,גבעת זאב,186,74,112,30,156,45,182,1,2%
2014-10,אזור יהודה והשומרון,3769,הר אדר,27,13,14,9,18,3,27,0,1%
2014-10,אזור יהודה והשומרון,3797,מודיעין עילית,455,120,335,13,442,78,448,1,3%
2014-10,אזור יהודה והשומרון,3616,מעלה אדומים,591,262,329,51,540,198,582,17,3%
2014-10,אזור יהודה והשומרון,3660,עמנואל,68,36,32,1,67,45,68,1,6%
2014-10,אזור יהודה והשומרון,3557,קדומים,38,18,20,15,23,5,38,0,2%
2014-10,אזור יהודה והשומרון,3611,קריית ארבע,116,60,56,8,108,63,114,1,4%
2014-10,אזור יהודה והשומרון,3640,קרני שומרון,75,41,34,22,53,11,75,0,2%
2014-10,הדרום,31,אופקים,1196,482,714,62,1134,786,1171,35,9%
2014-10,הדרום,2600,אילת,1212,544,668,32,1180,505,1193,27,4%
2014-10,הדרום,70,אשדוד,6276,2534,3742,705,5571,3307,6096,118,6%
2014-10,הדרום,7100,אשקלון,4232,1706,2526,242,3990,2258,3891,50,6%
2014-10,הדרום,9000,באר שבע,6644,2915,3729,715,5929,4172,6412,64,6%
2014-10,הדרום,2200,דימונה,1941,817,1124,108,1833,1356,1874,33,10%
2014-10,הדרום,1303,חורה,818,332,486,4,814,773,807,4,20%
2014-10,הדרום,831,ירוחם,429,191,238,13,416,266,409,12,9%
2014-10,הדרום,1059,כסיפה,1001,379,622,3,998,925,993,15,21%
2014-10,הדרום,1271,להבים,45,20,25,18,27,4,45,0,1%
2014-10,הדרום,1060,לקיה,980,434,546,2,978,928,970,10,23%
2014-10,הדרום,1268,מיתר,56,24,32,20,36,6,54,0,1%
2014-10,הדרום,99,מצפה רמון,236,90,146,7,229,169,228,7,9%
2014-10,הדרום,246,נתיבות,1135,478,657,43,1092,555,1092,44,8%
2014-10,הדרום,666,עומר,51,19,32,19,32,3,51,0,1%
2014-10,הדרום,2560,ערד,839,359,480,76,763,416,817,16,7%
2014-10,הדרום,1192,ערערה-בנגב,1070,440,630,4,1066,983,1063,14,25%
2014-10,הדרום,2630,קריית גת,2046,811,1235,100,1946,1180,1994,29,7%
2014-10,הדרום,1034,קריית מלאכי,1079,473,606,17,1062,675,1046,38,9%
2014-10,הדרום,1161,רהט,3096,1277,1819,3,3093,2799,3069,22,16%
2014-10,הדרום,1286,שגב-שלום,582,204,378,3,579,519,574,10,21%
2014-10,הדרום,1031,שדרות,1077,453,624,52,1025,646,1037,11,8%
2014-10,הדרום,1054,תל שבע,1219,559,660,4,1215,1160,1208,14,24%
2014-10,המרכז,182,אבן יהודה,138,70,68,49,89,16,138,2,2%
2014-10,המרכז,41,אליכין,65,34,31,9,56,16,62,0,3%
2014-10,המרכז,1309,אלעד,428,174,254,10,418,85,419,0,3%
2014-10,המרכז,2530,באר יעקב,262,95,167,48,214,56,259,5,3%
2014-10,המרכז,466,בית דגן,91,49,42,5,86,34,91,1,3%
2014-10,המרכז,1066,"בני עי""ש",177,86,91,26,151,71,176,5,4%
2014-10,המרכז,681,גבעת שמואל,286,150,136,30,256,67,280,0,2%
2014-10,המרכז,2550,גדרה,385,156,229,82,303,116,377,1,3%
2014-10,המרכז,627,ג'לג'וליה,77,34,43,1,76,52,76,0,2%
2014-10,המרכז,166,גן יבנה,377,135,242,68,309,96,373,5,3%
2014-10,המרכז,229,גני תקווה,165,73,92,54,111,23,165,0,2%
2014-10,המרכז,9700,הוד השרון,551,247,304,166,385,64,547,4,2%
2014-10,המרכז,1290,זמר,146,40,106,3,143,113,145,0,5%
2014-10,המרכז,2730,טייבה,1568,671,897,15,1553,1378,1462,12,8%
2014-10,המרכז,2720,טירה,259,112,147,10,249,144,255,7,2%
2014-10,המרכז,2660,יבנה,763,381,382,73,690,316,751,11,3%
2014-10,המרכז,9400,יהוד,427,162,265,61,366,71,420,3,3%
2014-10,המרכז,1224,כוכב יאיר,79,33,46,35,44,0,78,0,1%
2014-10,המרכז,633,כפר ברא,15,5,10,0,15,8,15,0,1%
2014-10,המרכז,168,כפר יונה,305,122,183,58,247,67,301,2,3%
2014-10,המרכז,6900,כפר סבא,1101,503,598,310,791,149,1092,16,2%
2014-10,המרכז,634,כפר קאסם,210,93,117,6,204,127,204,2,2%
2014-10,המרכז,7000,לוד,1987,916,1071,131,1856,1170,1959,11,6%
2014-10,המרכז,1200,מודיעין-מכבים-רעות*,814,345,469,210,604,66,810,9,2%
2014-10,המרכז,28,מזכרת בתיה,170,72,98,40,130,37,169,0,2%
2014-10,המרכז,7200,נס ציונה,621,297,324,135,486,204,617,1,3%
2014-10,המרכז,7400,נתניה,3994,1793,2201,521,3473,1478,3909,30,4%
2014-10,המרכז,587,סביון*,19,13,6,4,15,1,19,0,1%
2014-10,המרכז,171,פרדסייה,55,29,26,13,42,7,55,0,2%
2014-10,המרכז,7900,פתח תקווה,3661,1571,2090,716,2945,1080,3611,16,3%
2014-10,המרכז,195,קדימה-צורן,242,108,134,68,174,37,238,0,2%
2014-10,המרכז,638,קלנסווה,613,249,364,9,604,538,583,5,7%
2014-10,המרכז,469,קריית עקרון,276,131,145,11,265,137,274,4,5%
2014-10,המרכז,2640,ראש העין,632,293,339,77,555,159,617,10,3%
2014-10,המרכז,8300,ראשון לציון,4007,1748,2259,439,3568,1332,3986,38,3%
2014-10,המרכז,8400,רחובות,2364,1037,1327,439,1925,959,2310,11,3%
2014-10,המרכז,8500,רמלה,1584,730,854,99,1485,748,1523,28,4%
2014-10,המרכז,8700,רעננה,730,320,410,244,486,70,725,2,2%
2014-10,המרכז,1304,שוהם,149,65,84,52,97,8,149,0,1%
2014-10,המרכז,154,תל מונד,140,63,77,54,86,18,140,0,2%
2014-10,הצפון,473,אבו סנאן,611,253,358,6,605,508,607,4,11%
2014-10,הצפון,478,אכסאל,500,226,274,8,492,448,491,1,9%
2014-10,הצפון,529,אעבלין,589,234,355,5,584,504,586,8,10%
2014-10,הצפון,482,בועיינה-נוג'ידאת,395,160,235,11,384,344,381,2,10%
2014-10,הצפון,4001,בוקעאתא,396,153,243,2,394,342,387,0,14%
2014-10,הצפון,998,ביר אל-מכסור,400,148,252,1,399,323,398,0,11%
2014-10,הצפון,480,בית ג'ן,352,111,241,5,347,280,342,0,7%
2014-10,הצפון,9200,בית שאן,763,324,439,22,741,412,742,32,7%
2014-10,הצפון,944,בסמת טבעון,210,97,113,0,210,170,203,0,6%
2014-10,הצפון,483,בענה,333,126,207,4,329,305,330,1,10%
2014-10,הצפון,1292,ג'דיידה-מכר,1256,544,712,8,1248,1078,1241,6,14%
2014-10,הצפון,485,ג'ולס,200,57,143,0,200,151,200,1,7%
2014-10,הצפון,487,ג'ש (גוש חלב),58,29,29,1,57,37,56,4,3%
2014-10,הצפון,489,דבורייה,346,148,198,9,337,286,345,1,8%
2014-10,הצפון,490,דייר אל-אסד,356,129,227,3,353,308,356,1,7%
2014-10,הצפון,492,דייר חנא,634,266,368,4,630,508,631,0,13%
2014-10,הצפון,975,זרזיר,283,131,152,4,279,195,272,4,9%
2014-10,הצפון,496,חורפיש,88,37,51,3,85,57,86,1,3%
2014-10,הצפון,2034,חצור הגלילית,261,112,149,14,247,143,245,6,5%
2014-10,הצפון,6700,טבריה,1598,691,907,75,1523,1003,1412,15,7%
2014-10,הצפון,962,טובא-זנגרייה,317,143,174,4,313,251,309,0,10%
2014-10,הצפון,498,טורעאן,486,180,306,8,478,423,465,0,8%
2014-10,הצפון,8900,טמרה,1880,736,1144,12,1868,1716,1856,6,13%
2014-10,הצפון,1295,יאנוח-ג'ת,137,46,91,6,131,92,137,0,5%
2014-10,הצפון,46,יבנאל,137,88,49,5,132,108,110,0,7%
2014-10,הצפון,499,יפיע,623,255,368,13,610,514,611,2,8%
2014-10,הצפון,240,יקנעם עילית,449,183,266,56,393,141,440,20,4%
2014-10,הצפון,502,ירכא,522,227,295,1,521,424,517,3,9%
2014-10,הצפון,504,כאבול,638,251,387,5,633,571,635,2,13%
2014-10,הצפון,505,כאוכב אבו אל-היג'א,212,87,125,6,206,188,207,0,12%
2014-10,הצפון,1296,כסרא-סמיע,161,69,92,2,159,131,159,5,5%
2014-10,הצפון,978,כעביה-טבאש-חג'אג'רה,202,83,119,3,199,144,195,2,9%
2014-10,הצפון,1263,כפר ורדים,73,30,43,36,37,5,73,1,2%
2014-10,הצפון,507,כפר יאסיף,415,181,234,3,412,333,407,1,8%
2014-10,הצפון,508,כפר כמא,61,23,38,3,58,25,61,0,4%
2014-10,הצפון,509,כפר כנא,1084,444,640,22,1062,941,1045,11,12%
2014-10,הצפון,510,כפר מנדא,868,375,493,6,862,702,855,3,12%
2014-10,הצפון,47,כפר תבור,35,14,21,13,22,1,35,0,2%
2014-10,הצפון,1139,כרמיאל,1581,640,941,265,1316,794,1508,29,6%
2014-10,הצפון,481,מגאר,1478,581,897,15,1463,1339,1445,23,15%
2014-10,הצפון,516,מג'ד אל-כרום,480,185,295,6,474,403,478,4,7%
2014-10,הצפון,874,מגדל העמק,1017,412,605,76,941,437,901,52,7%
2014-10,הצפון,4201,מג'דל שמס,431,161,270,7,424,378,423,1,9%
2014-10,הצפון,517,מזרעה,167,66,101,2,165,145,163,0,8%
2014-10,הצפון,4203,מסעדה,188,68,120,3,185,168,182,0,11%
2014-10,הצפון,518,מעיליא,37,18,19,6,31,18,37,0,2%
2014-10,הצפון,1063,מעלות-תרשיחא,783,369,414,90,693,459,768,27,6%
2014-10,הצפון,520,משהד,272,107,165,9,263,233,262,2,8%
2014-10,הצפון,9100,נהרייה,1869,868,1001,162,1707,1136,1830,53,6%
2014-10,הצפון,522,נחף,346,144,202,4,342,308,343,1,7%
2014-10,הצפון,7300,נצרת,3149,1317,1832,64,3085,2640,3074,8,9%
2014-10,הצפון,1061,נצרת עילית,1604,737,867,153,1451,939,1447,45,6%
2014-10,הצפון,525,סאג'ור,100,35,65,1,99,71,97,0,6%
2014-10,הצפון,7500,סח'נין,2030,865,1165,19,2011,1811,2019,0,15%
2014-10,הצפון,4501,ע'ג'ר,85,35,50,1,84,66,85,0,8%
2014-10,הצפון,530,עיילבון,185,74,111,3,182,137,182,1,7%
2014-10,הצפון,511,עילוט,328,132,196,4,324,272,323,0,11%
2014-10,הצפון,532,עין מאהל,514,240,274,7,507,438,497,1,10%
2014-10,הצפון,7600,עכו,3038,1373,1665,114,2924,2372,2942,19,11%
2014-10,הצפון,7700,עפולה,1468,576,892,110,1358,756,1409,49,6%
2014-10,הצפון,531,עראבה,1471,598,873,16,1455,1329,1460,0,15%
2014-10,הצפון,535,פסוטה,96,41,55,7,89,68,94,0,6%
2014-10,הצפון,536,פקיעין (בוקייעה),115,60,55,5,110,87,113,1,4%
2014-10,הצפון,8000,צפת,1323,706,617,62,1261,1001,1265,20,10%
2014-10,הצפון,4100,קצרין,203,80,123,18,185,98,200,4,5%
2014-10,הצפון,2800,קריית שמונה,718,339,379,38,680,363,688,14,5%
2014-10,הצפון,543,ראמה,297,115,182,12,285,233,293,2,8%
2014-10,הצפון,26,ראש פינה,57,26,31,9,48,19,55,0,3%
2014-10,הצפון,542,ריינה,634,256,378,6,628,528,612,9,9%
2014-10,הצפון,122,רמת ישי,105,45,60,23,82,21,102,0,2%
2014-10,הצפון,913,שבלי - אום אל-גנם,215,90,125,9,206,160,207,0,8%
2014-10,הצפון,812,שלומי,231,96,135,15,216,137,227,7,6%
2014-10,הצפון,538,שעב,541,211,330,6,535,475,539,0,18%
2014-10,הצפון,8800,שפרעם,1933,730,1203,24,1909,1658,1907,13,11%
2014-10,חיפה,2710,אום אל-פחם,3581,1431,2150,22,3559,3206,3519,4,17%
2014-10,חיפה,1020,אור עקיבא,530,212,318,40,490,195,514,9,5%
2014-10,חיפה,6000,באקה אל-גרביה,597,270,327,4,593,417,593,9,5%
2014-10,חיפה,9800,בנימינה-גבעת עדה*,178,81,97,36,142,58,175,1,2%
2014-10,חיפה,1326,"בסמ""ה",384,160,224,3,381,328,381,0,10%
2014-10,חיפה,541,ג'סר א-זרקא,439,223,216,0,439,318,435,2,7%
2014-10,חיפה,628,ג'ת,204,100,104,9,195,145,203,2,4%
2014-10,חיפה,494,דאלית אל-כרמל,458,181,277,4,454,286,446,2,6%
2014-10,חיפה,9300,זכרון יעקב,257,104,153,78,179,55,255,1,2%
2014-10,חיפה,6500,חדרה,2184,922,1262,261,1923,893,2080,27,4%
2014-10,חיפה,4000,חיפה,6034,2927,3107,1064,4970,3333,5831,30,4%
2014-10,חיפה,1247,חריש,58,26,32,8,50,16,54,0,4%
2014-10,חיפה,2100,טירת כרמל,735,345,390,21,714,428,720,9,7%
2014-10,חיפה,654,כפר קרע,356,154,202,3,353,248,350,7,4%
2014-10,חיפה,1327,מעלה עירון,889,336,553,6,883,765,881,1,15%
2014-10,חיפה,2500,נשר,434,199,235,84,350,184,421,4,3%
2014-10,חיפה,534,עספיא,287,133,154,7,280,177,273,2,5%
2014-10,חיפה,637,ערערה,502,199,303,1,501,390,489,3,6%
2014-10,חיפה,537,פוריידיס,395,197,198,1,394,263,391,2,7%
2014-10,חיפה,7800,פרדס חנה-כרכור,806,357,449,124,682,264,801,12,4%
2014-10,חיפה,6800,קריית אתא,1547,691,856,134,1413,888,1518,22,5%
2014-10,חיפה,9500,קריית ביאליק,954,404,550,110,844,532,940,15,4%
2014-10,חיפה,2300,קריית טבעון,189,94,95,57,132,46,184,1,2%
2014-10,חיפה,9600,קריית ים,1403,640,763,142,1261,875,1371,12,6%
2014-10,חיפה,8200,קריית מוצקין,947,393,554,139,808,486,926,12,4%
2014-10,חיפה,922,רכסים,152,69,83,6,146,80,149,0,4%
2014-10,ירושלים,472,אבו גוש,227,108,119,4,223,181,227,0,8%
2014-10,ירושלים,2610,בית שמש,1214,479,735,61,1153,512,1184,10,4%
2014-10,ירושלים,3000,ירושלים,11879,5351,6528,1232,10647,7504,11679,50,4%
2014-10,ירושלים,1015,מבשרת ציון,376,169,207,71,305,167,367,2,3%
2014-10,ירושלים,1137,קריית יערים,38,21,17,6,32,14,38,0,3%
2014-10,תל אביב,2400,אור יהודה,689,345,344,31,658,232,665,14,4%
2014-10,תל אביב,565,אזור,154,89,65,13,141,32,152,2,2%
2014-10,תל אביב,6100,בני ברק,2202,999,1202,45,2157,1142,2111,9,4%
2014-10,תל אביב,6200,בת ים,2771,1310,1461,359,2412,1136,2683,18,4%
2014-10,תל אביב,6300,גבעתיים,679,298,381,271,408,85,671,3,2%
2014-10,תל אביב,6400,הרצלייה,916,393,523,196,720,26,905,17,2%
2014-10,תל אביב,6600,חולון,2753,1295,1458,256,2497,813,2697,23,3%
2014-10,תל אביב,2620,קריית אונו,322,148,174,91,231,50,319,0,2%
2014-10,תל אביב,8600,רמת גן,1853,845,1008,529,1324,437,1829,10,2%
2014-10,תל אביב,2650,רמת השרון,339,139,200,92,247,3,338,9,2%
2014-10,תל אביב,5000,תל אביב -יפו,6581,3286,3295,1869,4712,2126,6482,57,3%
2014-11,אזור יהודה והשומרון,3760,אורנית,114,43,71,47,67,2,114,0,2%
2014-11,אזור יהודה והשומרון,3750,אלפי מנשה,89,34,55,23,66,1,89,1,2%
2014-11,אזור יהודה והשומרון,3560,אלקנה,33,18,15,14,19,1,33,0,2%
2014-11,אזור יהודה והשומרון,3650,אפרת,112,60,52,48,64,6,112,0,3%
2014-11,אזור יהודה והשומרון,3570,אריאל,295,146,149,39,256,72,291,1,3%
2014-11,אזור יהודה והשומרון,3574,בית אל,40,17,23,10,30,20,39,0,2%
2014-11,אזור יהודה והשומרון,3652,בית אריה,56,28,28,9,47,3,56,0,2%
2014-11,אזור יהודה והשומרון,3780,ביתר עילית,563,264,299,8,555,258,559,0,5%
2014-11,אזור יהודה והשומרון,3730,גבעת זאב,190,82,108,31,159,47,187,3,2%
2014-11,אזור יהודה והשומרון,3769,הר אדר,32,16,16,12,20,4,32,0,2%
2014-11,אזור יהודה והשומרון,3797,מודיעין עילית,422,126,296,14,408,85,413,3,3%
2014-11,אזור יהודה והשומרון,3616,מעלה אדומים,595,257,338,40,555,203,587,8,3%
2014-11,אזור יהודה והשומרון,3660,עמנואל,62,34,28,2,60,47,62,0,6%
2014-11,אזור יהודה והשומרון,3557,קדומים,45,17,28,21,24,5,45,0,2%
2014-11,אזור יהודה והשומרון,3611,קריית ארבע,130,73,57,8,122,65,127,3,4%
2014-11,אזור יהודה והשומרון,3640,קרני שומרון,89,45,44,20,69,11,89,0,2%
2014-11,הדרום,31,אופקים,1181,516,665,59,1122,810,1158,11,9%
2014-11,הדרום,2600,אילת,1221,554,667,32,1189,520,1201,13,4%
2014-11,הדרום,70,אשדוד,6226,2526,3700,713,5513,3421,6050,37,6%
2014-11,הדרום,7100,אשקלון,4233,1775,2458,222,4011,2338,3869,38,6%
2014-11,הדרום,9000,באר שבע,6550,2914,3636,658,5892,4191,6304,66,6%
2014-11,הדרום,2200,דימונה,2002,871,1131,105,1897,1419,1926,19,11%
2014-11,הדרום,1303,חורה,819,341,478,2,817,762,807,4,20%
2014-11,הדרום,831,ירוחם,454,212,242,15,439,275,419,24,9%
2014-11,הדרום,1059,כסיפה,1024,403,621,1,1023,938,1017,2,22%
2014-11,הדרום,1271,להבים,41,18,23,15,26,4,41,1,1%
2014-11,הדרום,1060,לקיה,968,448,520,5,963,908,954,11,23%
2014-11,הדרום,1268,מיתר,59,22,37,15,44,6,57,0,1%
2014-11,הדרום,99,מצפה רמון,258,109,149,8,250,177,249,9,10%
2014-11,הדרום,246,נתיבות,1039,471,568,44,995,568,1007,32,7%
2014-11,הדרום,666,עומר,49,18,31,18,31,3,49,0,1%
2014-11,הדרום,2560,ערד,901,398,503,76,825,441,877,27,7%
2014-11,הדרום,1192,ערערה-בנגב,1082,448,634,3,1079,999,1073,0,25%
2014-11,הדרום,2630,קריית גת,2087,855,1232,93,1994,1250,2029,20,7%
2014-11,הדרום,1034,קריית מלאכי,1121,507,614,17,1104,706,1084,18,9%
2014-11,הדרום,1161,רהט,3059,1272,1787,4,3055,2754,3021,29,16%
2014-11,הדרום,1286,שגב-שלום,563,199,364,2,561,515,556,7,21%
2014-11,הדרום,1031,שדרות,1046,453,593,48,998,668,1003,3,8%
2014-11,הדרום,1054,תל שבע,1211,574,637,3,1208,1146,1200,3,24%
2014-11,המרכז,182,אבן יהודה,128,66,62,35,93,16,128,0,2%
2014-11,המרכז,41,אליכין,63,34,29,7,56,18,60,0,3%
2014-11,המרכז,1309,אלעד,436,184,252,8,428,85,423,0,3%
2014-11,המרכז,2530,באר יעקב,273,107,166,51,222,60,271,2,3%
2014-11,המרכז,466,בית דגן,97,53,44,3,94,33,97,0,3%
2014-11,המרכז,1066,"בני עי""ש",189,95,94,28,161,71,189,0,5%
2014-11,המרכז,681,גבעת שמואל,271,139,132,26,245,68,266,0,2%
2014-11,המרכז,2550,גדרה,370,150,220,83,287,124,363,0,3%
2014-11,המרכז,627,ג'לג'וליה,78,32,46,2,76,54,76,0,2%
2014-11,המרכז,166,גן יבנה,374,153,221,55,319,104,371,2,3%
2014-11,המרכז,229,גני תקווה,170,77,93,52,118,24,169,0,2%
2014-11,המרכז,9700,הוד השרון,574,265,309,182,392,65,569,2,2%
2014-11,המרכז,1290,זמר,158,50,108,3,155,114,157,0,5%
2014-11,המרכז,2730,טייבה,1595,681,914,12,1583,1396,1474,4,9%
2014-11,המרכז,2720,טירה,273,124,149,11,262,149,268,2,2%
2014-11,המרכז,2660,יבנה,807,405,402,73,734,336,794,2,3%
2014-11,המרכז,9400,יהוד,436,174,262,58,378,74,429,0,3%
2014-11,המרכז,1224,כוכב יאיר,89,38,51,41,48,0,87,0,2%
2014-11,המרכז,633,כפר ברא,16,5,11,0,16,9,16,0,1%
2014-11,המרכז,168,כפר יונה,297,132,165,56,241,70,293,0,3%
2014-11,המרכז,6900,כפר סבא,1175,526,649,346,829,158,1165,6,2%
2014-11,המרכז,634,כפר קאסם,211,91,120,6,205,132,203,0,2%
2014-11,המרכז,7000,לוד,2023,953,1070,129,1894,1217,2001,9,6%
2014-11,המרכז,1200,מודיעין-מכבים-רעות*,845,350,495,194,651,70,840,8,2%
2014-11,המרכז,28,מזכרת בתיה,164,73,91,42,122,37,163,0,2%
2014-11,המרכז,7200,נס ציונה,627,304,323,133,494,214,624,0,3%
2014-11,המרכז,7400,נתניה,4070,1857,2213,459,3611,1541,3984,4,4%
2014-11,המרכז,587,סביון*,16,10,6,5,11,1,16,0,1%
2014-11,המרכז,171,פרדסייה,66,29,37,9,57,8,66,0,2%
2014-11,המרכז,7900,פתח תקווה,3647,1608,2039,654,2993,1126,3591,1,3%
2014-11,המרכז,195,קדימה-צורן,238,113,125,60,178,40,233,1,2%
2014-11,המרכז,638,קלנסווה,621,252,369,8,613,543,587,2,7%
2014-11,המרכז,469,קריית עקרון,278,132,146,12,266,145,275,0,5%
2014-11,המרכז,2640,ראש העין,689,319,370,95,594,162,679,2,3%
2014-11,המרכז,8300,ראשון לציון,4215,1855,2360,446,3769,1399,4191,7,3%
2014-11,המרכז,8400,רחובות,2391,1074,1317,433,1958,1000,2333,0,3%
2014-11,המרכז,8500,רמלה,1631,760,871,99,1532,778,1567,5,4%
2014-11,המרכז,8700,רעננה,762,340,422,261,501,74,755,0,2%
2014-11,המרכז,1304,שוהם,156,71,85,59,97,8,156,0,1%
2014-11,המרכז,154,תל מונד,125,56,69,43,82,20,125,0,2%
2014-11,הצפון,473,אבו סנאן,636,262,374,5,631,523,629,0,11%
2014-11,הצפון,478,אכסאל,532,247,285,13,519,466,519,0,9%
2014-11,הצפון,529,אעבלין,594,242,352,5,589,509,592,0,11%
2014-11,הצפון,482,בועיינה-נוג'ידאת,418,176,242,7,411,361,402,0,10%
2014-11,הצפון,4001,בוקעאתא,413,166,247,2,411,349,401,0,15%
2014-11,הצפון,998,ביר אל-מכסור,415,153,262,3,412,338,411,0,11%
2014-11,הצפון,480,בית ג'ן,387,125,262,4,383,293,376,0,7%
2014-11,הצפון,9200,בית שאן,776,343,433,25,751,434,754,11,8%
2014-11,הצפון,944,בסמת טבעון,220,104,116,0,220,175,214,0,7%
2014-11,הצפון,483,בענה,367,151,216,4,363,315,363,0,11%
2014-11,הצפון,1292,ג'דיידה-מכר,1295,561,734,6,1289,1106,1278,1,14%
2014-11,הצפון,485,ג'ולס,218,66,152,0,218,157,217,2,8%
2014-11,הצפון,487,ג'ש (גוש חלב),60,33,27,2,58,39,58,0,4%
2014-11,הצפון,489,דבורייה,362,158,204,14,348,286,360,2,9%
2014-11,הצפון,490,דייר אל-אסד,392,159,233,6,386,323,391,2,8%
2014-11,הצפון,492,דייר חנא,661,291,370,9,652,518,658,0,14%
2014-11,הצפון,975,זרזיר,287,127,160,4,283,203,274,10,9%
2014-11,הצפון,496,חורפיש,92,37,55,4,88,60,89,0,3%
2014-11,הצפון,2034,חצור הגלילית,258,118,140,17,241,145,243,8,5%
2014-11,הצפון,6700,טבריה,1613,708,905,63,1550,1041,1421,10,7%
2014-11,הצפון,962,טובא-זנגרייה,342,157,185,6,336,259,333,0,11%
2014-11,הצפון,498,טורעאן,508,195,313,7,501,444,479,1,9%
2014-11,הצפון,8900,טמרה,1918,781,1137,8,1910,1739,1889,0,14%
2014-11,הצפון,1295,יאנוח-ג'ת,144,50,94,6,138,92,144,4,5%
2014-11,הצפון,46,יבנאל,141,89,52,6,135,111,117,0,7%
2014-11,הצפון,499,יפיע,668,273,395,17,651,527,650,0,8%
2014-11,הצפון,240,יקנעם עילית,423,170,253,49,374,149,417,18,4%
2014-11,הצפון,502,ירכא,545,238,307,1,544,445,539,0,9%
2014-11,הצפון,504,כאבול,660,265,395,6,654,583,655,0,13%
2014-11,הצפון,505,כאוכב אבו אל-היג'א,216,87,129,8,208,191,210,0,12%
2014-11,הצפון,1296,כסרא-סמיע,173,76,97,2,171,136,170,1,5%
2014-11,הצפון,978,כעביה-טבאש-חג'אג'רה,210,89,121,3,207,150,202,4,9%
2014-11,הצפון,1263,כפר ורדים,73,26,47,36,37,4,72,0,2%
2014-11,הצפון,507,כפר יאסיף,435,190,245,4,431,351,425,1,8%
2014-11,הצפון,508,כפר כמא,66,28,38,1,65,31,66,1,4%
2014-11,הצפון,509,כפר כנא,1117,473,644,25,1092,974,1052,0,12%
2014-11,הצפון,510,כפר מנדא,933,420,513,7,926,739,910,0,12%
2014-11,הצפון,47,כפר תבור,39,16,23,16,23,1,39,0,2%
2014-11,הצפון,1139,כרמיאל,1578,650,928,267,1311,829,1508,12,6%
2014-11,הצפון,481,מגאר,1530,605,925,15,1515,1372,1490,5,16%
2014-11,הצפון,516,מג'ד אל-כרום,531,230,301,5,526,414,528,2,8%
2014-11,הצפון,874,מגדל העמק,1099,477,622,72,1027,466,966,67,7%
2014-11,הצפון,4201,מג'דל שמס,458,164,294,7,451,391,446,2,9%
2014-11,הצפון,517,מזרעה,172,70,102,2,170,148,168,1,9%
2014-11,הצפון,4203,מסעדה,197,73,124,3,194,175,191,1,12%
2014-11,הצפון,518,מעיליא,47,26,21,4,43,20,46,0,3%
2014-11,הצפון,1063,מעלות-תרשיחא,778,375,403,83,695,470,766,11,6%
2014-11,הצפון,520,משהד,282,113,169,10,272,240,265,0,8%
2014-11,הצפון,9100,נהרייה,1885,871,1014,138,1747,1182,1837,27,6%
2014-11,הצפון,522,נחף,392,186,206,6,386,325,388,2,8%
2014-11,הצפון,7300,נצרת,3337,1431,1906,79,3258,2729,3244,0,9%
2014-11,הצפון,1061,נצרת עילית,1630,752,878,150,1480,988,1469,16,6%
2014-11,הצפון,525,סאג'ור,109,40,69,1,108,72,103,0,6%
2014-11,הצפון,7500,סח'נין,2105,901,1204,19,2086,1835,2093,0,15%
2014-11,הצפון,4501,ע'ג'ר,91,39,52,1,90,67,91,0,9%
2014-11,הצפון,530,עיילבון,186,75,111,3,183,137,182,0,7%
2014-11,הצפון,511,עילוט,348,141,207,3,345,281,340,0,12%
2014-11,הצפון,532,עין מאהל,516,251,265,6,510,436,497,0,10%
2014-11,הצפון,7600,עכו,3124,1405,1719,119,3005,2460,3021,0,11%
2014-11,הצפון,7700,עפולה,1449,582,867,111,1338,782,1405,19,6%
2014-11,הצפון,531,עראבה,1547,642,905,23,1524,1364,1527,0,15%
2014-11,הצפון,535,פסוטה,99,46,53,7,92,69,97,0,6%
2014-11,הצפון,536,פקיעין (בוקייעה),131,73,58,8,123,86,130,0,5%
2014-11,הצפון,8000,צפת,1314,718,596,57,1257,1011,1254,22,9%
2014-11,הצפון,4100,קצרין,223,93,130,16,207,99,219,1,6%
2014-11,הצפון,2800,קריית שמונה,765,346,419,29,736,381,732,50,6%
2014-11,הצפון,543,ראמה,296,118,178,8,288,237,293,0,8%
2014-11,הצפון,26,ראש פינה,54,26,28,8,46,21,52,0,3%
2014-11,הצפון,542,ריינה,650,273,377,7,643,536,629,0,9%
2014-11,הצפון,122,רמת ישי,101,43,58,19,82,21,98,3,2%
2014-11,הצפון,913,שבלי - אום אל-גנם,221,90,131,9,212,162,213,0,8%
2014-11,הצפון,812,שלומי,230,103,127,12,218,142,226,5,6%
2014-11,הצפון,538,שעב,562,225,337,7,555,484,559,0,18%
2014-11,הצפון,8800,שפרעם,1993,763,1230,17,1976,1687,1961,12,11%
2014-11,חיפה,2710,אום אל-פחם,3648,1473,2175,24,3624,3243,3580,0,17%
2014-11,חיפה,1020,אור עקיבא,530,230,300,41,489,195,516,2,5%
2014-11,חיפה,6000,באקה אל-גרביה,636,292,344,6,630,430,628,0,5%
2014-11,חיפה,9800,בנימינה-גבעת עדה*,172,75,97,30,142,60,171,0,2%
2014-11,חיפה,1326,"בסמ""ה",401,174,227,3,398,328,396,0,10%
2014-11,חיפה,541,ג'סר א-זרקא,444,228,216,0,444,322,439,0,8%
2014-11,חיפה,628,ג'ת,215,108,107,10,205,147,213,0,4%
2014-11,חיפה,494,דאלית אל-כרמל,492,205,287,6,486,297,479,0,6%
2014-11,חיפה,9300,זכרון יעקב,267,112,155,77,190,54,265,0,2%
2014-11,חיפה,6500,חדרה,2143,908,1235,234,1909,922,2036,5,4%
2014-11,חיפה,4000,חיפה,6362,3129,3233,1121,5241,3538,6118,4,4%
2014-11,חיפה,1247,חריש,64,30,34,4,60,20,62,0,4%
2014-11,חיפה,2100,טירת כרמל,749,356,393,20,729,439,730,4,7%
2014-11,חיפה,654,כפר קרע,377,164,213,2,375,254,371,0,4%
2014-11,חיפה,1327,מעלה עירון,895,334,561,5,890,775,886,1,15%
2014-11,חיפה,2500,נשר,447,210,237,79,368,194,439,0,3%
2014-11,חיפה,534,עספיא,319,153,166,5,314,182,303,0,6%
2014-11,חיפה,637,ערערה,558,237,321,2,556,398,540,0,7%
2014-11,חיפה,537,פוריידיס,419,223,196,2,417,269,414,0,7%
2014-11,חיפה,7800,פרדס חנה-כרכור,792,359,433,126,666,273,785,0,4%
2014-11,חיפה,6800,קריית אתא,1578,738,840,120,1458,936,1545,2,5%
2014-11,חיפה,9500,קריית ביאליק,976,425,551,105,871,551,963,0,5%
2014-11,חיפה,2300,קריית טבעון,175,90,85,51,124,51,169,0,2%
2014-11,חיפה,9600,קריית ים,1448,666,782,135,1313,915,1409,2,7%
2014-11,חיפה,8200,קריית מוצקין,954,395,559,135,819,508,933,2,4%
2014-11,חיפה,922,רכסים,148,73,75,4,144,81,144,0,4%
2014-11,ירושלים,472,אבו גוש,246,118,128,4,242,188,246,0,8%
2014-11,ירושלים,2610,בית שמש,1203,491,712,52,1151,544,1171,2,4%
2014-11,ירושלים,3000,ירושלים,11978,5369,6609,1228,10750,7663,11778,18,4%
2014-11,ירושלים,1015,מבשרת ציון,379,173,206,75,304,167,370,0,3%
2014-11,ירושלים,1137,קריית יערים,36,18,18,6,30,16,36,0,3%
2014-11,תל אביב,2400,אור יהודה,714,370,344,27,687,245,689,0,4%
2014-11,תל אביב,565,אזור,154,85,69,16,138,30,152,1,2%
2014-11,תל אביב,6100,בני ברק,2185,1020,1164,43,2142,1176,2087,5,4%
2014-11,תל אביב,6200,בת ים,2868,1362,1506,365,2503,1204,2769,10,4%
2014-11,תל אביב,6300,גבעתיים,695,301,394,263,432,96,689,1,2%
2014-11,תל אביב,6400,הרצלייה,949,420,529,206,743,39,938,4,2%
2014-11,תל אביב,6600,חולון,2878,1373,1505,259,2619,861,2827,0,3%
2014-11,תל אביב,2620,קריית אונו,364,150,214,103,261,57,360,0,2%
2014-11,תל אביב,8600,רמת גן,1939,875,1064,541,1398,460,1912,6,2%
2014-11,תל אביב,2650,רמת השרון,355,143,212,110,245,3,354,1,2%
2014-11,תל אביב,5000,תל אביב -יפו,6754,3344,3410,1893,4861,2217,6656,11,3%
2014-12,אזור יהודה והשומרון,3760,אורנית,129,50,79,51,78,4,129,0,3%
2014-12,אזור יהודה והשומרון,3750,אלפי מנשה,113,42,71,34,79,2,113,1,3%
2014-12,אזור יהודה והשומרון,3560,אלקנה,32,16,16,15,17,0,31,0,2%
2014-12,אזור יהודה והשומרון,3650,אפרת,128,68,60,48,80,6,128,0,3%
2014-12,אזור יהודה והשומרון,3570,אריאל,337,170,167,48,289,72,330,3,3%
2014-12,אזור יהודה והשומרון,3574,בית אל,35,14,21,8,27,16,34,0,1%
2014-12,אזור יהודה והשומרון,3652,בית אריה,67,29,38,12,55,4,67,1,3%
2014-12,אזור יהודה והשומרון,3780,ביתר עילית,598,280,318,5,593,256,591,0,5%
2014-12,אזור יהודה והשומרון,3730,גבעת זאב,211,98,113,40,171,45,208,3,3%
2014-12,אזור יהודה והשומרון,3769,הר אדר,37,17,20,14,23,4,37,0,2%
2014-12,אזור יהודה והשומרון,3797,מודיעין עילית,469,155,314,15,454,89,454,1,3%
2014-12,אזור יהודה והשומרון,3616,מעלה אדומים,662,288,374,49,613,180,650,16,3%
2014-12,אזור יהודה והשומרון,3660,עמנואל,65,39,26,2,63,48,64,0,6%
2014-12,אזור יהודה והשומרון,3557,קדומים,47,19,28,23,24,5,47,1,3%
2014-12,אזור יהודה והשומרון,3611,קריית ארבע,136,72,64,10,126,74,131,3,4%
2014-12,אזור יהודה והשומרון,3640,קרני שומרון,97,51,46,21,76,12,94,1,3%
2014-12,הדרום,31,אופקים,1213,525,688,56,1157,764,1170,41,9%
2014-12,הדרום,2600,אילת,1411,671,740,38,1373,529,1354,45,4%
2014-12,הדרום,70,אשדוד,6622,2700,3922,730,5892,3321,6386,94,6%
2014-12,הדרום,7100,אשקלון,4457,1910,2547,240,4217,2295,4018,78,6%
2014-12,הדרום,9000,באר שבע,7100,3102,3998,722,6378,4079,6768,69,7%
2014-12,הדרום,2200,דימונה,2049,902,1147,102,1947,1351,1953,48,11%
2014-12,הדרום,1303,חורה,831,351,480,5,826,741,815,5,20%
2014-12,הדרום,831,ירוחם,440,207,233,14,426,257,409,21,9%
2014-12,הדרום,1059,כסיפה,1052,432,620,0,1052,924,1035,4,22%
2014-12,הדרום,1271,להבים,43,18,25,16,27,5,42,1,1%
2014-12,הדרום,1060,לקיה,996,457,539,4,992,909,977,5,23%
2014-12,הדרום,1268,מיתר,72,29,43,14,58,8,70,0,2%
2014-12,הדרום,99,מצפה רמון,273,118,155,12,261,180,254,14,10%
2014-12,הדרום,246,נתיבות,1046,493,553,39,1007,549,996,45,7%
2014-12,הדרום,666,עומר,51,20,31,15,36,4,51,0,1%
2014-12,הדרום,2560,ערד,973,431,542,72,901,424,922,30,7%
2014-12,הדרום,1192,ערערה-בנגב,1098,477,621,3,1095,990,1085,2,26%
2014-12,הדרום,2630,קריית גת,2242,929,1312,103,2139,1150,2146,21,8%
2014-12,הדרום,1034,קריית מלאכי,1281,574,707,21,1260,698,1225,57,10%
2014-12,הדרום,1161,רהט,3243,1375,1868,6,3237,2695,3180,32,17%
2014-12,הדרום,1286,שגב-שלום,559,208,351,1,558,499,549,3,21%
2014-12,הדרום,1031,שדרות,1128,500,628,57,1071,632,1081,26,8%
2014-12,הדרום,1054,תל שבע,1219,589,630,3,1216,1130,1202,10,24%
2014-12,המרכז,182,אבן יהודה,156,74,82,44,112,18,156,2,2%
2014-12,המרכז,41,אליכין,70,38,32,8,62,17,66,2,4%
2014-12,המרכז,1309,אלעד,490,210,280,10,480,82,474,1,4%
2014-12,המרכז,2530,באר יעקב,303,114,189,53,250,56,299,0,3%
2014-12,המרכז,466,בית דגן,105,56,49,4,101,36,104,2,3%
2014-12,המרכז,1066,"בני עי""ש",194,94,100,24,170,65,191,2,5%
2014-12,המרכז,681,גבעת שמואל,291,148,143,28,263,65,282,0,2%
2014-12,המרכז,2550,גדרה,405,170,235,91,314,118,396,3,3%
2014-12,המרכז,627,ג'לג'וליה,94,42,52,3,91,60,90,0,2%
2014-12,המרכז,166,גן יבנה,415,173,242,60,355,94,408,8,4%
2014-12,המרכז,229,גני תקווה,171,74,97,53,118,24,171,0,2%
2014-12,המרכז,9700,הוד השרון,641,281,360,206,435,60,635,3,2%
2014-12,המרכז,1290,זמר,166,51,115,3,163,117,164,3,6%
2014-12,המרכז,2730,טייבה,1638,709,929,14,1624,1355,1505,13,9%
2014-12,המרכז,2720,טירה,306,150,156,13,293,148,297,5,3%
2014-12,המרכז,2660,יבנה,923,460,463,82,841,314,907,23,4%
2014-12,המרכז,9400,יהוד,476,194,282,62,414,61,464,8,3%
2014-12,המרכז,1224,כוכב יאיר,95,41,54,42,53,0,92,1,2%
2014-12,המרכז,633,כפר ברא,19,6,13,0,19,10,19,0,1%
2014-12,המרכז,168,כפר יונה,356,159,197,59,297,73,345,2,3%
2014-12,המרכז,6900,כפר סבא,1307,587,720,386,921,154,1280,9,2%
2014-12,המרכז,634,כפר קאסם,224,103,121,5,219,121,214,1,2%
2014-12,המרכז,7000,לוד,2223,1037,1186,153,2070,1213,2176,26,6%
2014-12,המרכז,1200,מודיעין-מכבים-רעות*,964,401,563,231,733,66,943,9,2%
2014-12,המרכז,28,מזכרת בתיה,179,74,105,41,138,38,177,1,3%
2014-12,המרכז,7200,נס ציונה,705,341,364,157,548,197,696,3,3%
2014-12,המרכז,7400,נתניה,4696,2142,2554,472,4224,1666,4491,76,4%
2014-12,המרכז,587,סביון*,16,7,9,5,11,1,16,0,1%
2014-12,המרכז,171,פרדסייה,78,33,45,15,63,5,78,0,2%
2014-12,המרכז,7900,פתח תקווה,4111,1856,2255,781,3330,1069,4020,17,3%
2014-12,המרכז,195,קדימה-צורן,277,126,151,60,217,41,272,1,3%
2014-12,המרכז,638,קלנסווה,634,264,370,7,627,529,587,13,7%
2014-12,המרכז,469,קריית עקרון,324,146,178,17,307,151,313,9,5%
2014-12,המרכז,2640,ראש העין,768,363,405,100,668,162,748,9,3%
2014-12,המרכז,8300,ראשון לציון,4532,1992,2540,467,4065,1337,4481,58,3%
2014-12,המרכז,8400,רחובות,2618,1163,1455,498,2120,991,2529,28,4%
2014-12,המרכז,8500,רמלה,1840,834,1006,114,1726,768,1763,26,5%
2014-12,המרכז,8700,רעננה,825,351,474,290,535,67,816,2,2%
2014-12,המרכז,1304,שוהם,186,83,103,68,118,9,186,1,2%
2014-12,המרכז,154,תל מונד,145,64,81,47,98,19,145,1,2%
2014-12,הצפון,473,אבו סנאן,669,270,399,5,664,536,657,3,11%
2014-12,הצפון,478,אכסאל,539,262,277,14,525,459,521,1,9%
2014-12,הצפון,529,אעבלין,616,248,368,5,611,505,609,9,11%
2014-12,הצפון,482,בועיינה-נוג'ידאת,452,198,254,10,442,371,424,1,11%
2014-12,הצפון,4001,בוקעאתא,421,167,254,2,419,346,396,1,14%
2014-12,הצפון,998,ביר אל-מכסור,441,167,274,3,438,336,435,1,12%
2014-12,הצפון,480,בית ג'ן,415,136,279,6,409,303,399,2,8%
2014-12,הצפון,9200,בית שאן,873,387,486,21,852,432,840,37,8%
2014-12,הצפון,944,בסמת טבעון,233,112,121,0,233,181,224,2,7%
2014-12,הצפון,483,בענה,377,153,224,9,368,312,372,6,11%
2014-12,הצפון,1292,ג'דיידה-מכר,1352,593,759,5,1347,1115,1320,11,15%
2014-12,הצפון,485,ג'ולס,230,71,159,1,229,150,227,4,8%
2014-12,הצפון,487,ג'ש (גוש חלב),67,35,32,1,66,38,64,0,4%
2014-12,הצפון,489,דבורייה,380,161,219,17,363,277,374,0,9%
2014-12,הצפון,490,דייר אל-אסד,390,155,235,6,384,312,386,2,8%
2014-12,הצפון,492,דייר חנא,675,304,371,11,664,517,667,2,14%
2014-12,הצפון,975,זרזיר,284,123,161,4,280,192,275,14,9%
2014-12,הצפון,496,חורפיש,110,44,66,5,105,62,107,0,4%
2014-12,הצפון,2034,חצור הגלילית,296,134,162,15,281,140,278,5,6%
2014-12,הצפון,6700,טבריה,1841,824,1017,78,1763,1066,1589,40,7%
2014-12,הצפון,962,טובא-זנגרייה,370,169,201,4,366,255,358,0,12%
2014-12,הצפון,498,טורעאן,541,217,324,8,533,450,501,1,9%
2014-12,הצפון,8900,טמרה,2019,834,1185,10,2009,1777,1962,19,14%
2014-12,הצפון,1295,יאנוח-ג'ת,172,68,104,8,164,95,168,3,6%
2014-12,הצפון,46,יבנאל,147,88,59,6,141,109,124,1,8%
2014-12,הצפון,499,יפיע,659,269,390,18,641,521,640,3,8%
2014-12,הצפון,240,יקנעם עילית,493,210,283,53,440,148,484,23,4%
2014-12,הצפון,502,ירכא,577,241,336,2,575,434,569,2,10%
2014-12,הצפון,504,כאבול,699,288,411,11,688,588,690,2,14%
2014-12,הצפון,505,כאוכב אבו אל-היג'א,230,95,135,8,222,195,221,2,13%
2014-12,הצפון,1296,כסרא-סמיע,209,84,125,2,207,152,199,1,6%
2014-12,הצפון,978,כעביה-טבאש-חג'אג'רה,215,94,121,3,212,145,202,5,9%
2014-12,הצפון,1263,כפר ורדים,72,29,43,31,41,8,72,0,2%
2014-12,הצפון,507,כפר יאסיף,448,193,255,4,444,349,439,4,9%
2014-12,הצפון,508,כפר כמא,63,26,37,1,62,26,61,0,4%
2014-12,הצפון,509,כפר כנא,1207,527,680,28,1179,1005,1106,1,13%
2014-12,הצפון,510,כפר מנדא,1000,458,542,6,994,746,956,4,13%
2014-12,הצפון,47,כפר תבור,44,20,24,14,30,3,43,0,2%
2014-12,הצפון,1139,כרמיאל,1680,673,1007,261,1419,802,1591,32,6%
2014-12,הצפון,481,מגאר,1526,629,897,10,1516,1336,1481,11,16%
2014-12,הצפון,516,מג'ד אל-כרום,559,246,313,3,556,418,552,14,9%
2014-12,הצפון,874,מגדל העמק,1022,442,580,70,952,423,914,76,7%
2014-12,הצפון,4201,מג'דל שמס,488,175,313,7,481,388,465,2,10%
2014-12,הצפון,517,מזרעה,187,71,116,3,184,149,179,3,9%
2014-12,הצפון,4203,מסעדה,210,77,133,3,207,177,200,1,12%
2014-12,הצפון,518,מעיליא,57,29,28,8,49,24,54,0,3%
2014-12,הצפון,1063,מעלות-תרשיחא,846,419,427,89,757,477,820,6,7%
2014-12,הצפון,520,משהד,294,134,160,9,285,241,274,2,9%
2014-12,הצפון,9100,נהרייה,2061,932,1129,154,1907,1198,1963,60,6%
2014-12,הצפון,522,נחף,408,195,213,5,403,323,403,9,8%
2014-12,הצפון,7300,נצרת,3401,1483,1918,82,3319,2721,3272,20,9%
2014-12,הצפון,1061,נצרת עילית,1848,840,1008,152,1696,1022,1621,71,7%
2014-12,הצפון,525,סאג'ור,115,45,70,0,115,71,111,0,6%
2014-12,הצפון,7500,סח'נין,2164,943,1221,30,2134,1845,2146,8,15%
2014-12,הצפון,4501,ע'ג'ר,93,38,55,1,92,61,92,0,9%
2014-12,הצפון,530,עיילבון,190,78,112,2,188,136,187,0,7%
2014-12,הצפון,511,עילוט,344,145,199,3,341,274,332,0,12%
2014-12,הצפון,532,עין מאהל,553,263,290,4,549,439,529,3,10%
2014-12,הצפון,7600,עכו,3237,1430,1807,128,3109,2445,3081,32,12%
2014-12,הצפון,7700,עפולה,1673,685,988,118,1555,762,1584,43,6%
2014-12,הצפון,531,עראבה,1582,664,918,27,1555,1364,1558,3,15%
2014-12,הצפון,535,פסוטה,104,53,51,6,98,66,101,0,6%
2014-12,הצפון,536,פקיעין (בוקייעה),145,80,65,9,136,98,142,1,5%
2014-12,הצפון,8000,צפת,1473,823,650,62,1411,1061,1383,28,10%
2014-12,הצפון,4100,קצרין,231,98,133,17,214,86,225,3,6%
2014-12,הצפון,2800,קריית שמונה,780,363,417,40,740,360,746,41,6%
2014-12,הצפון,543,ראמה,303,120,183,12,291,230,296,1,8%
2014-12,הצפון,26,ראש פינה,65,30,35,10,55,21,64,1,4%
2014-12,הצפון,542,ריינה,681,288,393,9,672,550,652,4,10%
2014-12,הצפון,122,רמת ישי,109,46,63,20,89,23,106,2,3%
2014-12,הצפון,913,שבלי - אום אל-גנם,246,104,142,6,240,151,240,2,9%
2014-12,הצפון,812,שלומי,247,106,141,12,235,143,235,3,7%
2014-12,הצפון,538,שעב,564,230,334,5,559,483,560,2,18%
2014-12,הצפון,8800,שפרעם,2089,817,1272,20,2069,1699,2027,45,11%
2014-12,חיפה,2710,אום אל-פחם,3816,1570,2246,24,3792,3222,3723,22,18%
2014-12,חיפה,1020,אור עקיבא,633,291,342,48,585,198,617,13,6%
2014-12,חיפה,6000,באקה אל-גרביה,714,347,367,8,706,426,705,20,6%
2014-12,חיפה,9800,בנימינה-גבעת עדה*,200,91,109,42,158,61,196,1,3%
2014-12,חיפה,1326,"בסמ""ה",429,181,248,5,424,327,422,1,11%
2014-12,חיפה,541,ג'סר א-זרקא,454,241,213,1,453,319,447,5,8%
2014-12,חיפה,628,ג'ת,246,130,116,10,236,143,243,3,5%
2014-12,חיפה,494,דאלית אל-כרמל,550,227,323,6,544,288,535,5,7%
2014-12,חיפה,9300,זכרון יעקב,291,120,171,82,209,51,290,0,3%
2014-12,חיפה,6500,חדרה,2316,1000,1316,260,2056,878,2165,17,4%
2014-12,חיפה,4000,חיפה,6915,3302,3613,1229,5686,3655,6466,67,5%
2014-12,חיפה,1247,חריש,68,34,34,4,64,18,64,0,4%
2014-12,חיפה,2100,טירת כרמל,784,379,405,20,764,422,758,23,7%
2014-12,חיפה,654,כפר קרע,403,166,237,1,402,253,394,9,5%
2014-12,חיפה,1327,מעלה עירון,932,351,581,5,927,777,919,1,16%
2014-12,חיפה,2500,נשר,482,216,266,87,395,196,467,2,4%
2014-12,חיפה,534,עספיא,359,176,183,4,355,186,336,3,6%
2014-12,חיפה,637,ערערה,629,262,367,3,626,403,607,6,8%
2014-12,חיפה,537,פוריידיס,469,236,233,3,466,278,461,2,8%
2014-12,חיפה,7800,פרדס חנה-כרכור,909,438,471,144,765,266,891,17,4%
2014-12,חיפה,6800,קריית אתא,1660,756,904,128,1532,920,1602,21,5%
2014-12,חיפה,9500,קריית ביאליק,1069,455,614,122,947,530,1044,11,5%
2014-12,חיפה,2300,קריית טבעון,188,93,95,56,132,42,183,1,2%
2014-12,חיפה,9600,קריית ים,1570,695,875,153,1417,932,1487,17,7%
2014-12,חיפה,8200,קריית מוצקין,1047,414,633,143,904,489,1013,13,4%
2014-12,חיפה,922,רכסים,152,72,80,4,148,85,144,0,4%
2014-12,ירושלים,472,אבו גוש,267,135,132,3,264,190,267,1,9%
2014-12,ירושלים,2610,בית שמש,1341,555,786,57,1284,531,1284,25,4%
2014-12,ירושלים,3000,ירושלים,12803,5761,7042,1326,11477,7657,12491,71,4%
2014-12,ירושלים,1015,מבשרת ציון,404,187,217,78,326,161,396,5,3%
2014-12,ירושלים,1137,קריית יערים,43,22,21,7,36,14,43,0,3%
2014-12,תל אביב,2400,אור יהודה,846,445,401,35,811,247,802,20,4%
2014-12,תל אביב,565,אזור,181,94,87,17,164,34,179,1,3%
2014-12,תל אביב,6100,בני ברק,2309,1054,1255,46,2263,1114,2200,15,4%
2014-12,תל אביב,6200,בת ים,3199,1544,1655,385,2814,1181,3024,37,4%
2014-12,תל אביב,6300,גבעתיים,777,355,422,307,470,87,769,6,3%
2014-12,תל אביב,6400,הרצלייה,1105,502,603,254,851,47,1083,14,2%
2014-12,תל אביב,6600,חולון,3258,1548,1710,297,2961,852,3157,47,3%
2014-12,תל אביב,2620,קריית אונו,404,184,220,109,295,42,400,0,2%
2014-12,תל אביב,8600,רמת גן,2101,950,1151,637,1464,412,2064,13,3%
2014-12,תל אביב,2650,רמת השרון,400,163,237,116,284,6,393,1,2%
2014-12,תל אביב,5000,תל אביב -יפו,7724,3810,3914,2267,5457,2158,7533,53,3%
2015-01,אזור יהודה והשומרון,3760,אורנית,112,44,68,37,75,4,112,1,2%
2015-01,אזור יהודה והשומרון,3750,אלפי מנשה,107,43,64,28,79,2,106,3,2%
2015-01,אזור יהודה והשומרון,3560,אלקנה,34,18,16,12,22,0,33,0,2%
2015-01,אזור יהודה והשומרון,3650,אפרת,124,62,62,42,82,8,124,1,3%
2015-01,אזור יהודה והשומרון,3570,אריאל,339,163,176,51,288,70,334,7,3%
2015-01,אזור יהודה והשומרון,3574,בית אל,36,17,19,13,23,15,36,0,1%
2015-01,אזור יהודה והשומרון,3652,בית אריה,60,27,33,10,50,4,60,1,2%
2015-01,אזור יהודה והשומרון,3780,ביתר עילית,597,298,299,5,592,281,590,1,5%
2015-01,אזור יהודה והשומרון,3730,גבעת זאב,213,99,114,35,178,40,210,2,3%
2015-01,אזור יהודה והשומרון,3769,הר אדר,37,14,23,15,22,4,37,1,2%
2015-01,אזור יהודה והשומרון,3797,מודיעין עילית,456,163,293,18,438,92,441,9,3%
2015-01,אזור יהודה והשומרון,3616,מעלה אדומים,661,285,376,42,619,186,651,22,3%
2015-01,אזור יהודה והשומרון,3660,עמנואל,60,37,23,1,59,44,58,1,5%
2015-01,אזור יהודה והשומרון,3557,קדומים,46,21,25,18,28,6,45,0,2%
2015-01,אזור יהודה והשומרון,3611,קריית ארבע,137,71,66,13,124,75,133,4,4%
2015-01,אזור יהודה והשומרון,3640,קרני שומרון,88,49,39,15,73,14,87,2,2%
2015-01,הדרום,31,אופקים,1184,506,678,60,1124,753,1147,47,9%
2015-01,הדרום,2600,אילת,1539,743,796,38,1501,531,1493,56,4%
2015-01,הדרום,70,אשדוד,6587,2756,3831,731,5856,3274,6338,168,6%
2015-01,הדרום,7100,אשקלון,4494,1958,2536,249,4245,2249,4033,119,6%
2015-01,הדרום,9000,באר שבע,7126,3142,3984,782,6344,4029,6777,174,7%
2015-01,הדרום,2200,דימונה,2071,904,1167,97,1974,1371,1961,74,11%
2015-01,הדרום,1303,חורה,801,336,465,8,793,724,787,3,19%
2015-01,הדרום,831,ירוחם,442,224,218,15,427,257,413,42,9%
2015-01,הדרום,1059,כסיפה,1058,435,623,0,1058,939,1042,8,22%
2015-01,הדרום,1271,להבים,42,17,25,18,24,5,41,0,1%
2015-01,הדרום,1060,לקיה,982,451,531,3,979,902,959,2,23%
2015-01,הדרום,1268,מיתר,77,33,44,19,58,9,76,0,2%
2015-01,הדרום,99,מצפה רמון,276,120,156,9,267,179,257,12,10%
2015-01,הדרום,246,נתיבות,1033,486,547,53,980,553,971,53,7%
2015-01,הדרום,666,עומר,60,26,34,16,44,4,60,0,1%
2015-01,הדרום,2560,ערד,1038,465,573,72,966,436,982,57,8%
2015-01,הדרום,1192,ערערה-בנגב,1092,478,614,3,1089,985,1079,3,25%
2015-01,הדרום,2630,קריית גת,2236,934,1302,98,2138,1121,2149,54,8%
2015-01,הדרום,1034,קריית מלאכי,1214,543,671,20,1194,664,1158,73,10%
2015-01,הדרום,1161,רהט,3167,1359,1808,8,3159,2682,3120,26,16%
2015-01,הדרום,1286,שגב-שלום,546,202,344,0,546,492,532,5,20%
2015-01,הדרום,1031,שדרות,1146,545,601,53,1093,657,1091,28,9%
2015-01,הדרום,1054,תל שבע,1204,589,615,1,1203,1114,1185,9,24%
2015-01,המרכז,182,אבן יהודה,156,76,80,40,116,20,155,0,2%
2015-01,המרכז,41,אליכין,69,37,32,11,58,18,66,1,4%
2015-01,המרכז,1309,אלעד,441,196,245,11,430,76,428,1,3%
2015-01,המרכז,2530,באר יעקב,312,117,195,55,257,55,304,8,3%
2015-01,המרכז,466,בית דגן,103,55,48,3,100,30,103,1,3%
2015-01,המרכז,1066,"בני עי""ש",186,87,99,24,162,66,184,1,5%
2015-01,המרכז,681,גבעת שמואל,292,159,133,29,263,61,285,1,2%
2015-01,המרכז,2550,גדרה,400,171,229,89,311,115,387,8,3%
2015-01,המרכז,627,ג'לג'וליה,104,45,59,2,102,61,96,0,3%
2015-01,המרכז,166,גן יבנה,434,174,260,61,373,92,422,10,4%
2015-01,המרכז,229,גני תקווה,194,83,111,59,135,29,193,1,2%
2015-01,המרכז,9700,הוד השרון,632,274,358,190,442,62,623,7,2%
2015-01,המרכז,1290,זמר,162,52,110,3,159,113,161,7,5%
2015-01,המרכז,2730,טייבה,1665,736,929,21,1644,1364,1524,31,9%
2015-01,המרכז,2720,טירה,307,150,157,12,295,137,296,11,3%
2015-01,המרכז,2660,יבנה,927,463,464,91,836,316,915,35,4%
2015-01,המרכז,9400,יהוד,464,190,274,50,414,65,453,8,3%
2015-01,המרכז,1224,כוכב יאיר,86,33,53,33,53,0,83,1,1%
2015-01,המרכז,633,כפר ברא,22,8,14,0,22,11,22,0,2%
2015-01,המרכז,168,כפר יונה,331,148,183,56,275,64,326,9,3%
2015-01,המרכז,6900,כפר סבא,1321,595,726,368,953,150,1298,21,2%
2015-01,המרכז,634,כפר קאסם,226,106,120,5,221,120,218,7,2%
2015-01,המרכז,7000,לוד,2188,1027,1161,138,2050,1183,2143,52,6%
2015-01,המרכז,1200,מודיעין-מכבים-רעות*,948,411,537,223,725,66,934,14,2%
2015-01,המרכז,28,מזכרת בתיה,180,84,96,45,135,42,177,2,3%
2015-01,המרכז,7200,נס ציונה,682,325,357,170,512,181,676,9,3%
2015-01,המרכז,7400,נתניה,4587,2129,2458,429,4158,1593,4444,149,4%
2015-01,המרכז,587,סביון*,16,8,8,7,9,1,15,0,1%
2015-01,המרכז,171,פרדסייה,82,33,49,15,67,6,82,0,2%
2015-01,המרכז,7900,פתח תקווה,4202,1852,2350,841,3361,1101,4097,66,3%
2015-01,המרכז,195,קדימה-צורן,277,127,150,47,230,37,272,4,3%
2015-01,המרכז,638,קלנסווה,621,261,360,6,615,512,574,8,7%
2015-01,המרכז,469,קריית עקרון,291,134,157,11,280,136,283,12,5%
2015-01,המרכז,2640,ראש העין,779,353,426,100,679,151,764,22,3%
2015-01,המרכז,8300,ראשון לציון,4546,2016,2530,487,4059,1324,4502,83,3%
2015-01,המרכז,8400,רחובות,2601,1195,1406,491,2110,975,2515,50,4%
2015-01,המרכז,8500,רמלה,1852,835,1017,111,1741,766,1771,62,5%
2015-01,המרכז,8700,רעננה,779,335,444,268,511,55,770,10,2%
2015-01,המרכז,1304,שוהם,190,83,107,70,120,8,189,1,2%
2015-01,המרכז,154,תל מונד,156,78,78,44,112,19,156,2,3%
2015-01,הצפון,473,אבו סנאן,687,281,406,6,681,550,669,21,12%
2015-01,הצפון,478,אכסאל,566,280,286,13,553,466,548,3,10%
2015-01,הצפון,529,אעבלין,630,262,368,5,625,513,623,10,11%
2015-01,הצפון,482,בועיינה-נוג'ידאת,439,186,253,11,428,344,427,4,11%
2015-01,הצפון,4001,בוקעאתא,434,172,262,4,430,348,410,2,15%
2015-01,הצפון,998,ביר אל-מכסור,440,168,272,2,438,332,435,4,12%
2015-01,הצפון,480,בית ג'ן,399,124,275,4,395,294,383,5,7%
2015-01,הצפון,9200,בית שאן,862,385,477,19,843,434,820,50,8%
2015-01,הצפון,944,בסמת טבעון,219,107,112,1,218,163,215,2,7%
2015-01,הצפון,483,בענה,395,167,228,11,384,322,384,16,12%
2015-01,הצפון,1292,ג'דיידה-מכר,1377,612,765,6,1371,1122,1352,32,15%
2015-01,הצפון,485,ג'ולס,243,80,163,1,242,160,239,4,8%
2015-01,הצפון,487,ג'ש (גוש חלב),81,41,40,2,79,40,78,2,5%
2015-01,הצפון,489,דבורייה,389,172,217,20,369,280,385,1,9%
2015-01,הצפון,490,דייר אל-אסד,389,159,230,6,383,317,385,15,8%
2015-01,הצפון,492,דייר חנא,707,328,379,9,698,520,697,4,14%
2015-01,הצפון,975,זרזיר,294,130,164,4,290,198,281,6,9%
2015-01,הצפון,496,חורפיש,126,49,77,6,120,70,121,0,5%
2015-01,הצפון,2034,חצור הגלילית,279,125,154,16,263,135,259,15,6%
2015-01,הצפון,6700,טבריה,1832,835,997,73,1759,1032,1592,48,7%
2015-01,הצפון,962,טובא-זנגרייה,375,172,203,5,370,251,363,2,12%
2015-01,הצפון,498,טורעאן,546,215,331,10,536,447,518,5,9%
2015-01,הצפון,8900,טמרה,2028,856,1172,13,2015,1794,1975,20,14%
2015-01,הצפון,1295,יאנוח-ג'ת,178,68,110,8,170,95,176,1,6%
2015-01,הצפון,46,יבנאל,150,92,58,5,145,121,117,2,7%
2015-01,הצפון,499,יפיע,663,288,375,19,644,514,647,9,8%
2015-01,הצפון,240,יקנעם עילית,501,211,290,62,439,149,491,26,4%
2015-01,הצפון,502,ירכא,589,252,337,2,587,462,580,3,10%
2015-01,הצפון,504,כאבול,698,282,416,12,686,588,688,9,14%
2015-01,הצפון,505,כאוכב אבו אל-היג'א,229,96,133,8,221,190,224,4,13%
2015-01,הצפון,1296,כסרא-סמיע,238,93,145,4,234,170,230,5,7%
2015-01,הצפון,978,כעביה-טבאש-חג'אג'רה,206,83,123,3,203,136,199,2,9%
2015-01,הצפון,1263,כפר ורדים,64,25,39,26,38,5,64,0,2%
2015-01,הצפון,507,כפר יאסיף,446,192,254,5,441,355,438,2,9%
2015-01,הצפון,508,כפר כמא,63,25,38,2,61,24,61,1,4%
2015-01,הצפון,509,כפר כנא,1172,493,679,30,1142,960,1102,25,12%
2015-01,הצפון,510,כפר מנדא,1006,458,548,6,1000,747,979,5,13%
2015-01,הצפון,47,כפר תבור,49,17,32,15,34,1,48,0,2%
2015-01,הצפון,1139,כרמיאל,1668,667,1001,236,1432,779,1578,50,6%
2015-01,הצפון,481,מגאר,1539,644,895,11,1528,1343,1479,11,16%
2015-01,הצפון,516,מג'ד אל-כרום,542,239,303,3,539,413,534,14,8%
2015-01,הצפון,874,מגדל העמק,991,452,539,65,926,426,884,83,7%
2015-01,הצפון,4201,מג'דל שמס,478,175,303,8,470,374,461,4,10%
2015-01,הצפון,517,מזרעה,191,75,116,3,188,144,185,5,9%
2015-01,הצפון,4203,מסעדה,215,81,134,4,211,178,209,0,12%
2015-01,הצפון,518,מעיליא,53,23,30,5,48,20,52,0,3%
2015-01,הצפון,1063,מעלות-תרשיחא,857,421,436,94,763,470,834,27,7%
2015-01,הצפון,520,משהד,287,129,158,10,277,234,277,2,9%
2015-01,הצפון,9100,נהרייה,2001,931,1070,155,1846,1141,1918,68,6%
2015-01,הצפון,522,נחף,414,190,224,9,405,335,405,5,8%
2015-01,הצפון,7300,נצרת,3374,1472,1902,93,3281,2673,3283,35,9%
2015-01,הצפון,1061,נצרת עילית,1866,845,1021,152,1714,1005,1618,94,7%
2015-01,הצפון,525,סאג'ור,110,39,71,2,108,72,105,1,6%
2015-01,הצפון,7500,סח'נין,2174,926,1248,31,2143,1839,2156,19,15%
2015-01,הצפון,4501,ע'ג'ר,92,36,56,0,92,61,92,1,9%
2015-01,הצפון,530,עיילבון,190,80,110,1,189,135,185,0,7%
2015-01,הצפון,511,עילוט,353,152,201,5,348,281,343,0,12%
2015-01,הצפון,532,עין מאהל,577,286,291,3,574,461,539,5,10%
2015-01,הצפון,7600,עכו,3229,1472,1757,131,3098,2419,3090,68,12%
2015-01,הצפון,7700,עפולה,1677,699,978,116,1561,740,1583,90,6%
2015-01,הצפון,531,עראבה,1619,682,937,25,1594,1385,1595,8,16%
2015-01,הצפון,535,פסוטה,111,53,58,8,103,67,108,1,6%
2015-01,הצפון,536,פקיעין (בוקייעה),137,78,59,7,130,86,135,2,5%
2015-01,הצפון,8000,צפת,1438,797,641,55,1383,1021,1365,36,10%
2015-01,הצפון,4100,קצרין,231,105,126,16,215,90,229,6,6%
2015-01,הצפון,2800,קריית שמונה,805,377,428,39,766,349,768,45,6%
2015-01,הצפון,543,ראמה,300,121,179,11,289,225,296,1,8%
2015-01,הצפון,26,ראש פינה,66,31,35,9,57,22,64,2,4%
2015-01,הצפון,542,ריינה,685,287,398,14,671,547,664,13,10%
2015-01,הצפון,122,רמת ישי,98,44,54,18,80,21,96,2,2%
2015-01,הצפון,913,שבלי - אום אל-גנם,240,101,139,6,234,151,232,2,9%
2015-01,הצפון,812,שלומי,240,106,134,12,228,130,235,7,7%
2015-01,הצפון,538,שעב,551,222,329,4,547,475,548,7,18%
2015-01,הצפון,8800,שפרעם,2062,812,1250,25,2037,1658,2021,37,11%
2015-01,חיפה,2710,אום אל-פחם,3772,1568,2204,29,3743,3194,3689,33,18%
2015-01,חיפה,1020,אור עקיבא,597,271,326,48,549,192,574,17,6%
2015-01,חיפה,6000,באקה אל-גרביה,711,356,355,7,704,416,703,28,6%
2015-01,חיפה,9800,בנימינה-גבעת עדה*,202,90,112,47,155,59,201,2,3%
2015-01,חיפה,1326,"בסמ""ה",434,185,249,5,429,328,429,9,11%
2015-01,חיפה,541,ג'סר א-זרקא,461,250,211,0,461,323,455,6,8%
2015-01,חיפה,628,ג'ת,250,134,116,9,241,138,248,4,5%
2015-01,חיפה,494,דאלית אל-כרמל,559,230,329,8,551,297,538,8,7%
2015-01,חיפה,9300,זכרון יעקב,266,114,152,75,191,53,264,3,2%
2015-01,חיפה,6500,חדרה,2387,1056,1331,269,2118,897,2224,50,5%
2015-01,חיפה,4000,חיפה,6808,3334,3474,1205,5603,3474,6468,178,5%
2015-01,חיפה,1247,חריש,72,34,38,4,68,20,68,0,5%
2015-01,חיפה,2100,טירת כרמל,751,372,379,21,730,415,725,18,7%
2015-01,חיפה,654,כפר קרע,426,192,234,2,424,261,417,14,5%
2015-01,חיפה,1327,מעלה עירון,929,358,571,5,924,775,913,7,16%
2015-01,חיפה,2500,נשר,472,235,237,84,388,184,455,5,4%
2015-01,חיפה,534,עספיא,350,166,184,5,345,175,331,5,6%
2015-01,חיפה,637,ערערה,623,266,357,4,619,399,604,31,7%
2015-01,חיפה,537,פוריידיס,468,238,230,5,463,278,460,0,8%
2015-01,חיפה,7800,פרדס חנה-כרכור,901,425,476,141,760,264,885,21,4%
2015-01,חיפה,6800,קריית אתא,1641,752,889,139,1502,890,1591,44,5%
2015-01,חיפה,9500,קריית ביאליק,1068,462,606,122,946,538,1046,32,5%
2015-01,חיפה,2300,קריית טבעון,189,96,93,63,126,42,185,0,2%
2015-01,חיפה,9600,קריית ים,1524,701,823,148,1376,889,1470,56,7%
2015-01,חיפה,8200,קריית מוצקין,1006,419,587,139,867,470,983,23,4%
2015-01,חיפה,922,רכסים,139,69,70,5,134,83,131,1,4%
2015-01,ירושלים,472,אבו גוש,270,134,136,2,268,191,268,0,9%
2015-01,ירושלים,2610,בית שמש,1292,555,737,48,1244,520,1237,48,4%
2015-01,ירושלים,3000,ירושלים,12947,5927,7020,1361,11586,7757,12631,131,4%
2015-01,ירושלים,1015,מבשרת ציון,393,185,208,80,313,155,386,6,3%
2015-01,ירושלים,1137,קריית יערים,39,18,21,6,33,14,39,0,3%
2015-01,תל אביב,2400,אור יהודה,820,433,387,37,783,232,777,39,4%
2015-01,תל אביב,565,אזור,175,92,83,20,155,35,173,2,3%
2015-01,תל אביב,6100,בני ברק,2236,1060,1176,52,2184,1090,2116,31,4%
2015-01,תל אביב,6200,בת ים,3192,1483,1709,390,2802,1152,3048,67,4%
2015-01,תל אביב,6300,גבעתיים,785,359,426,322,463,92,782,4,3%
2015-01,תל אביב,6400,הרצלייה,1130,534,596,268,862,35,1117,27,2%
2015-01,תל אביב,6600,חולון,3195,1519,1676,280,2915,815,3108,64,3%
2015-01,תל אביב,2620,קריית אונו,409,183,226,109,300,39,404,2,2%
2015-01,תל אביב,8600,רמת גן,2096,967,1129,620,1476,419,2066,18,3%
2015-01,תל אביב,2650,רמת השרון,413,166,247,125,288,4,411,4,2%
2015-01,תל אביב,5000,תל אביב -יפו,7670,3826,3844,2340,5330,2090,7514,109,3%
2015-02,אזור יהודה והשומרון,3760,אורנית,102,42,60,36,66,3,102,0,2%
2015-02,אזור יהודה והשומרון,3750,אלפי מנשה,110,52,58,27,83,1,110,1,3%
2015-02,אזור יהודה והשומרון,3560,אלקנה,29,15,14,10,19,0,29,1,2%
2015-02,אזור יהודה והשומרון,3650,אפרת,128,62,66,38,90,10,128,0,3%
2015-02,אזור יהודה והשומרון,3570,אריאל,338,160,178,58,280,66,334,11,3%
2015-02,אזור יהודה והשומרון,3574,בית אל,41,16,25,14,27,15,41,0,2%
2015-02,אזור יהודה והשומרון,3652,בית אריה,54,24,30,7,47,3,54,2,2%
2015-02,אזור יהודה והשומרון,3780,ביתר עילית,601,309,292,7,594,287,595,1,5%
2015-02,אזור יהודה והשומרון,3730,גבעת זאב,217,104,113,41,176,53,214,3,3%
2015-02,אזור יהודה והשומרון,3769,הר אדר,39,12,27,19,20,4,38,0,2%
2015-02,אזור יהודה והשומרון,3797,מודיעין עילית,431,153,278,16,415,74,421,4,3%
2015-02,אזור יהודה והשומרון,3616,מעלה אדומים,634,276,358,37,597,185,624,17,3%
2015-02,אזור יהודה והשומרון,3660,עמנואל,63,40,23,1,62,40,60,1,5%
2015-02,אזור יהודה והשומרון,3557,קדומים,48,26,22,17,31,7,48,0,3%
2015-02,אזור יהודה והשומרון,3611,קריית ארבע,131,64,67,13,118,72,127,6,4%
2015-02,אזור יהודה והשומרון,3640,קרני שומרון,79,43,36,17,62,13,79,1,2%
2015-02,הדרום,31,אופקים,1179,505,674,57,1122,735,1139,44,9%
2015-02,הדרום,2600,אילת,1533,749,784,43,1490,533,1491,53,4%
2015-02,הדרום,70,אשדוד,6432,2710,3722,708,5724,3176,6178,194,6%
2015-02,הדרום,7100,אשקלון,4332,1890,2442,258,4074,2177,3881,126,6%
2015-02,הדרום,9000,באר שבע,6970,3149,3821,763,6207,3917,6671,178,6%
2015-02,הדרום,2200,דימונה,2122,970,1152,99,2023,1341,2017,66,11%
2015-02,הדרום,1303,חורה,786,328,458,8,778,716,776,1,19%
2015-02,הדרום,831,ירוחם,435,223,212,14,421,257,405,35,9%
2015-02,הדרום,1059,כסיפה,1016,416,600,3,1013,911,1009,1,22%
2015-02,הדרום,1271,להבים,47,18,29,20,27,6,46,0,1%
2015-02,הדרום,1060,לקיה,947,434,513,4,943,866,934,3,22%
2015-02,הדרום,1268,מיתר,74,30,44,14,60,10,72,0,2%
2015-02,הדרום,99,מצפה רמון,268,123,145,10,258,171,255,16,10%
2015-02,הדרום,246,נתיבות,1039,485,554,54,985,539,981,49,7%
2015-02,הדרום,666,עומר,63,28,35,20,43,4,63,0,2%
2015-02,הדרום,2560,ערד,933,424,509,60,873,435,895,36,7%
2015-02,הדרום,1192,ערערה-בנגב,1073,472,601,5,1068,969,1062,0,25%
2015-02,הדרום,2630,קריית גת,2146,892,1254,87,2059,1071,2084,69,7%
2015-02,הדרום,1034,קריית מלאכי,1161,511,650,17,1144,617,1099,76,9%
2015-02,הדרום,1161,רהט,3161,1375,1786,6,3155,2662,3128,30,17%
2015-02,הדרום,1286,שגב-שלום,537,207,330,0,537,471,526,2,20%
2015-02,הדרום,1031,שדרות,1102,518,584,53,1049,621,1050,34,8%
2015-02,הדרום,1054,תל שבע,1176,578,598,4,1172,1077,1157,11,24%
2015-02,המרכז,182,אבן יהודה,158,76,82,36,122,18,158,2,2%
2015-02,המרכז,41,אליכין,69,33,36,10,59,20,65,0,3%
2015-02,המרכז,1309,אלעד,414,181,233,8,406,79,400,3,3%
2015-02,המרכז,2530,באר יעקב,289,117,172,55,234,53,283,6,3%
2015-02,המרכז,466,בית דגן,107,58,49,4,103,33,106,1,3%
2015-02,המרכז,1066,"בני עי""ש",186,88,98,28,158,62,185,3,5%
2015-02,המרכז,681,גבעת שמואל,259,135,124,33,226,56,252,0,2%
2015-02,המרכז,2550,גדרה,386,156,230,89,297,113,374,8,3%
2015-02,המרכז,627,ג'לג'וליה,104,48,56,3,101,63,96,2,3%
2015-02,המרכז,166,גן יבנה,393,159,234,48,345,90,388,9,3%
2015-02,המרכז,229,גני תקווה,192,84,108,64,128,28,191,2,2%
2015-02,המרכז,9700,הוד השרון,607,265,342,170,437,54,601,8,2%
2015-02,המרכז,1290,זמר,160,54,106,1,159,109,159,4,5%
2015-02,המרכז,2730,טייבה,1634,738,896,23,1611,1337,1484,29,9%
2015-02,המרכז,2720,טירה,306,155,151,14,292,142,297,13,3%
2015-02,המרכז,2660,יבנה,888,436,452,98,790,286,876,28,4%
2015-02,המרכז,9400,יהוד,444,201,243,45,399,61,432,9,3%
2015-02,המרכז,1224,כוכב יאיר,93,40,53,34,59,1,91,0,2%
2015-02,המרכז,633,כפר ברא,26,10,16,1,25,11,26,2,2%
2015-02,המרכז,168,כפר יונה,322,142,180,48,274,60,317,8,3%
2015-02,המרכז,6900,כפר סבא,1325,597,728,347,978,146,1309,18,2%
2015-02,המרכז,634,כפר קאסם,211,92,119,6,205,116,206,3,2%
2015-02,המרכז,7000,לוד,2173,1035,1138,146,2027,1161,2134,59,6%
2015-02,המרכז,1200,מודיעין-מכבים-רעות*,911,401,510,340,571,62,896,15,2%
2015-02,המרכז,28,מזכרת בתיה,178,82,96,47,131,33,175,4,2%
2015-02,המרכז,7200,נס ציונה,683,325,358,176,507,178,672,13,3%
2015-02,המרכז,7400,נתניה,4390,2078,2312,381,4009,1553,4275,140,4%
2015-02,המרכז,587,סביון*,16,6,10,7,9,1,16,1,1%
2015-02,המרכז,171,פרדסייה,73,28,45,14,59,6,73,1,2%
2015-02,המרכז,7900,פתח תקווה,4016,1791,2225,829,3187,1049,3929,40,3%
2015-02,המרכז,195,קדימה-צורן,279,113,166,40,239,36,275,1,3%
2015-02,המרכז,638,קלנסווה,623,273,350,9,614,511,579,10,7%
2015-02,המרכז,469,קריית עקרון,282,141,141,10,272,130,273,11,5%
2015-02,המרכז,2640,ראש העין,744,342,402,96,648,150,728,29,3%
2015-02,המרכז,8300,ראשון לציון,4432,1975,2457,482,3950,1320,4387,102,3%
2015-02,המרכז,8400,רחובות,2502,1152,1350,483,2019,956,2419,56,4%
2015-02,המרכז,8500,רמלה,1790,820,970,97,1693,738,1718,65,5%
2015-02,המרכז,8700,רעננה,741,336,405,233,508,61,736,5,2%
2015-02,המרכז,1304,שוהם,185,81,104,68,117,8,185,2,2%
2015-02,המרכז,154,תל מונד,149,73,76,33,116,22,149,0,2%
2015-02,הצפון,473,אבו סנאן,701,291,410,8,693,550,685,13,12%
2015-02,הצפון,478,אכסאל,566,277,289,13,553,446,557,4,10%
2015-02,הצפון,529,אעבלין,622,263,359,4,618,505,613,7,11%
2015-02,הצפון,482,בועיינה-נוג'ידאת,438,181,257,8,430,343,425,0,11%
2015-02,הצפון,4001,בוקעאתא,443,180,263,4,439,351,421,1,15%
2015-02,הצפון,998,ביר אל-מכסור,445,175,270,2,443,333,442,9,12%
2015-02,הצפון,480,בית ג'ן,410,147,263,6,404,295,397,0,8%
2015-02,הצפון,9200,בית שאן,850,362,488,21,829,417,815,58,8%
2015-02,הצפון,944,בסמת טבעון,220,109,111,2,218,159,217,5,7%
2015-02,הצפון,483,בענה,373,162,211,11,362,303,369,10,11%
2015-02,הצפון,1292,ג'דיידה-מכר,1368,602,766,6,1362,1143,1339,39,15%
2015-02,הצפון,485,ג'ולס,235,75,160,2,233,158,230,4,8%
2015-02,הצפון,487,ג'ש (גוש חלב),81,41,40,4,77,40,77,2,5%
2015-02,הצפון,489,דבורייה,388,175,213,16,372,279,385,5,9%
2015-02,הצפון,490,דייר אל-אסד,367,160,207,7,360,294,366,5,7%
2015-02,הצפון,492,דייר חנא,707,328,379,9,698,514,701,4,14%
2015-02,הצפון,975,זרזיר,285,127,158,4,281,196,275,4,9%
2015-02,הצפון,496,חורפיש,119,50,69,6,113,71,116,4,4%
2015-02,הצפון,2034,חצור הגלילית,291,133,158,18,273,134,279,4,6%
2015-02,הצפון,6700,טבריה,1787,823,964,69,1718,988,1574,48,7%
2015-02,הצפון,962,טובא-זנגרייה,371,168,203,6,365,245,363,1,12%
2015-02,הצפון,498,טורעאן,520,204,316,12,508,435,503,5,9%
2015-02,הצפון,8900,טמרה,2015,879,1136,14,2001,1758,1981,20,14%
2015-02,הצפון,1295,יאנוח-ג'ת,185,74,111,10,175,99,183,4,6%
2015-02,הצפון,46,יבנאל,136,82,54,5,131,108,103,3,7%
2015-02,הצפון,499,יפיע,656,289,367,20,636,512,639,4,8%
2015-02,הצפון,240,יקנעם עילית,479,199,280,60,419,141,470,27,4%
2015-02,הצפון,502,ירכא,607,258,349,1,606,467,600,5,10%
2015-02,הצפון,504,כאבול,677,281,396,10,667,575,669,8,14%
2015-02,הצפון,505,כאוכב אבו אל-היג'א,221,97,124,8,213,188,217,0,13%
2015-02,הצפון,1296,כסרא-סמיע,228,98,130,6,222,158,223,6,7%
2015-02,הצפון,978,כעביה-טבאש-חג'אג'רה,206,76,130,4,202,140,197,1,9%
2015-02,הצפון,1263,כפר ורדים,59,23,36,23,36,7,59,1,2%
2015-02,הצפון,507,כפר יאסיף,444,196,248,3,441,346,436,5,8%
2015-02,הצפון,508,כפר כמא,68,26,42,2,66,23,66,1,4%
2015-02,הצפון,509,כפר כנא,1164,513,651,31,1133,947,1099,20,12%
2015-02,הצפון,510,כפר מנדא,1004,453,551,7,997,741,971,9,13%
2015-02,הצפון,47,כפר תבור,48,15,33,16,32,1,47,0,2%
2015-02,הצפון,1139,כרמיאל,1602,649,953,234,1368,772,1517,56,6%
2015-02,הצפון,481,מגאר,1513,633,880,8,1505,1302,1484,18,16%
2015-02,הצפון,516,מג'ד אל-כרום,532,243,289,3,529,396,528,11,8%
2015-02,הצפון,874,מגדל העמק,946,430,516,64,882,385,843,75,6%
2015-02,הצפון,4201,מג'דל שמס,497,188,309,8,489,384,477,3,10%
2015-02,הצפון,517,מזרעה,186,72,114,3,183,138,179,3,9%
2015-02,הצפון,4203,מסעדה,227,93,134,4,223,179,220,2,13%
2015-02,הצפון,518,מעיליא,58,22,36,10,48,26,57,1,3%
2015-02,הצפון,1063,מעלות-תרשיחא,842,401,441,83,759,460,819,26,7%
2015-02,הצפון,520,משהד,286,128,158,10,276,230,276,3,9%
2015-02,הצפון,9100,נהרייה,1928,911,1016,139,1789,1121,1853,82,6%
2015-02,הצפון,522,נחף,415,194,221,10,405,330,411,6,8%
2015-02,הצפון,7300,נצרת,3358,1491,1867,94,3264,2646,3272,39,9%
2015-02,הצפון,1061,נצרת עילית,1792,809,983,138,1654,917,1598,102,7%
2015-02,הצפון,525,סאג'ור,102,33,69,2,100,68,98,1,6%
2015-02,הצפון,7500,סח'נין,2163,927,1236,24,2139,1823,2143,10,15%
2015-02,הצפון,4501,ע'ג'ר,95,40,55,0,95,60,95,0,9%
2015-02,הצפון,530,עיילבון,185,78,107,1,184,130,182,3,7%
2015-02,הצפון,511,עילוט,345,149,196,5,340,273,337,2,12%
2015-02,הצפון,532,עין מאהל,535,261,274,4,531,433,514,3,10%
2015-02,הצפון,7600,עכו,3131,1437,1694,131,3000,2335,3013,68,11%
2015-02,הצפון,7700,עפולה,1665,693,972,107,1558,739,1566,81,6%
2015-02,הצפון,531,עראבה,1608,675,933,27,1581,1367,1587,8,16%
2015-02,הצפון,535,פסוטה,113,53,60,7,106,76,111,2,7%
2015-02,הצפון,536,פקיעין (בוקייעה),136,79,57,8,128,82,132,1,5%
2015-02,הצפון,8000,צפת,1392,755,637,55,1337,1011,1323,34,10%
2015-02,הצפון,4100,קצרין,231,101,130,17,214,95,226,6,6%
2015-02,הצפון,2800,קריית שמונה,766,357,409,35,731,351,734,36,6%
2015-02,הצפון,543,ראמה,305,124,181,11,294,222,301,3,8%
2015-02,הצפון,26,ראש פינה,56,24,32,6,50,20,55,0,3%
2015-02,הצפון,542,ריינה,664,287,377,13,651,526,644,16,9%
2015-02,הצפון,122,רמת ישי,91,44,47,18,73,17,89,1,2%
2015-02,הצפון,913,שבלי - אום אל-גנם,239,99,140,9,230,149,234,3,9%
2015-02,הצפון,812,שלומי,236,102,134,10,226,123,231,3,6%
2015-02,הצפון,538,שעב,545,217,328,3,542,478,542,1,18%
2015-02,הצפון,8800,שפרעם,1992,787,1205,19,1973,1614,1959,24,11%
2015-02,חיפה,2710,אום אל-פחם,3720,1540,2180,27,3693,3170,3638,38,17%
2015-02,חיפה,1020,אור עקיבא,568,266,302,48,520,171,546,22,5%
2015-02,חיפה,6000,באקה אל-גרביה,696,356,340,6,690,411,688,20,6%
2015-02,חיפה,9800,בנימינה-גבעת עדה*,206,97,109,49,157,56,204,3,3%
2015-02,חיפה,1326,"בסמ""ה",427,186,241,3,424,322,423,2,11%
2015-02,חיפה,541,ג'סר א-זרקא,452,241,211,0,452,322,446,4,8%
2015-02,חיפה,628,ג'ת,243,132,111,9,234,142,243,10,5%
2015-02,חיפה,494,דאלית אל-כרמל,541,226,315,7,534,292,510,10,7%
2015-02,חיפה,9300,זכרון יעקב,258,111,147,70,188,55,254,1,2%
2015-02,חיפה,6500,חדרה,2314,1006,1308,252,2062,850,2154,64,4%
2015-02,חיפה,4000,חיפה,6565,3238,3327,1175,5390,3384,6247,169,4%
2015-02,חיפה,1247,חריש,74,40,34,6,68,14,72,0,5%
2015-02,חיפה,2100,טירת כרמל,730,360,370,24,706,400,708,17,7%
2015-02,חיפה,654,כפר קרע,420,184,236,2,418,258,412,8,5%
2015-02,חיפה,1327,מעלה עירון,936,367,569,8,928,765,924,8,16%
2015-02,חיפה,2500,נשר,462,237,225,82,380,187,447,17,4%
2015-02,חיפה,534,עספיא,344,154,190,6,338,171,326,3,6%
2015-02,חיפה,637,ערערה,642,273,369,6,636,412,619,15,8%
2015-02,חיפה,537,פוריידיס,450,224,226,4,446,273,441,1,8%
2015-02,חיפה,7800,פרדס חנה-כרכור,886,425,461,138,748,258,870,28,4%
2015-02,חיפה,6800,קריית אתא,1603,736,867,133,1470,868,1564,50,5%
2015-02,חיפה,9500,קריית ביאליק,1029,440,589,111,918,516,1007,27,5%
2015-02,חיפה,2300,קריית טבעון,187,92,95,60,127,45,182,1,2%
2015-02,חיפה,9600,קריית ים,1497,702,795,137,1360,860,1456,34,7%
2015-02,חיפה,8200,קריית מוצקין,1025,431,594,137,888,471,999,27,4%
2015-02,חיפה,922,רכסים,149,78,71,8,141,86,138,1,4%
2015-02,ירושלים,472,אבו גוש,276,136,140,5,271,198,272,4,9%
2015-02,ירושלים,2610,בית שמש,1209,535,674,38,1171,494,1159,40,4%
2015-02,ירושלים,3000,ירושלים,12830,5891,6939,1308,11522,7690,12556,144,4%
2015-02,ירושלים,1015,מבשרת ציון,392,179,213,77,315,155,387,8,3%
2015-02,ירושלים,1137,קריית יערים,37,15,22,5,32,14,37,0,3%
2015-02,תל אביב,2400,אור יהודה,790,410,380,39,751,240,753,37,4%
2015-02,תל אביב,565,אזור,170,90,80,17,153,34,167,2,3%
2015-02,תל אביב,6100,בני ברק,2107,1019,1088,52,2055,1052,1998,38,4%
2015-02,תל אביב,6200,בת ים,3128,1476,1652,391,2737,1120,2997,64,4%
2015-02,תל אביב,6300,גבעתיים,746,344,402,301,445,91,739,4,2%
2015-02,תל אביב,6400,הרצלייה,1118,520,598,271,847,35,1103,33,2%
2015-02,תל אביב,6600,חולון,3061,1458,1603,273,2788,768,2988,71,3%
2015-02,תל אביב,2620,קריית אונו,383,174,209,104,279,40,378,5,2%
2015-02,תל אביב,8600,רמת גן,2047,926,1121,623,1424,407,2011,22,3%
2015-02,תל אביב,2650,רמת השרון,401,166,235,121,280,6,397,3,2%
2015-02,תל אביב,5000,תל אביב -יפו,7463,3695,3768,2292,5171,2053,7327,124,3%
2015-03,אזור יהודה והשומרון,3760,אורנית,107,51,56,37,70,5,107,2,2%
2015-03,אזור יהודה והשומרון,3750,אלפי מנשה,104,52,52,25,79,2,103,0,2%
2015-03,אזור יהודה והשומרון,3560,אלקנה,31,17,14,11,20,1,31,0,2%
2015-03,אזור יהודה והשומרון,3650,אפרת,120,58,62,36,84,8,120,0,3%
2015-03,אזור יהודה והשומרון,3570,אריאל,334,162,172,56,278,66,331,10,3%
2015-03,אזור יהודה והשומרון,3574,בית אל,43,20,23,15,28,12,42,1,2%
2015-03,אזור יהודה והשומרון,3652,בית אריה,49,23,26,9,40,3,48,1,2%
2015-03,אזור יהודה והשומרון,3780,ביתר עילית,578,298,280,6,572,277,574,1,5%
2015-03,אזור יהודה והשומרון,3730,גבעת זאב,227,110,117,40,187,50,224,0,3%
2015-03,אזור יהודה והשומרון,3769,הר אדר,37,12,25,21,16,2,37,0,2%
2015-03,אזור יהודה והשומרון,3797,מודיעין עילית,432,145,287,16,416,77,419,3,3%
2015-03,אזור יהודה והשומרון,3616,מעלה אדומים,637,269,368,37,600,186,630,14,3%
2015-03,אזור יהודה והשומרון,3660,עמנואל,56,35,21,1,55,39,55,2,5%
2015-03,אזור יהודה והשומרון,3557,קדומים,38,19,19,14,24,6,38,0,2%
2015-03,אזור יהודה והשומרון,3611,קריית ארבע,121,62,59,14,107,64,118,9,4%
2015-03,אזור יהודה והשומרון,3640,קרני שומרון,75,40,35,16,59,13,73,1,2%
2015-03,הדרום,31,אופקים,1133,504,629,55,1078,724,1094,43,9%
2015-03,הדרום,2600,אילת,1450,704,746,46,1404,536,1414,56,4%
2015-03,הדרום,70,אשדוד,6170,2649,3521,683,5487,3074,5959,180,6%
2015-03,הדרום,7100,אשקלון,4204,1829,2375,244,3960,2138,3774,132,5%
2015-03,הדרום,9000,באר שבע,6873,3145,3728,733,6140,3874,6574,169,6%
2015-03,הדרום,2200,דימונה,2111,963,1148,98,2013,1337,2018,84,11%
2015-03,הדרום,1303,חורה,791,333,458,6,785,712,782,7,19%
2015-03,הדרום,831,ירוחם,426,215,211,16,410,249,403,23,9%
2015-03,הדרום,1059,כסיפה,1036,425,611,4,1032,926,1028,5,22%
2015-03,הדרום,1271,להבים,42,17,25,16,26,6,41,0,1%
2015-03,הדרום,1060,לקיה,931,418,513,2,929,854,915,9,22%
2015-03,הדרום,1268,מיתר,75,28,47,20,55,6,74,1,2%
2015-03,הדרום,99,מצפה רמון,257,121,136,8,249,166,245,13,10%
2015-03,הדרום,246,נתיבות,967,467,500,48,919,530,924,39,7%
2015-03,הדרום,666,עומר,57,24,33,16,41,5,57,0,1%
2015-03,הדרום,2560,ערד,903,413,490,59,844,421,865,53,7%
2015-03,הדרום,1192,ערערה-בנגב,1096,481,615,7,1089,988,1083,1,26%
2015-03,הדרום,2630,קריית גת,2087,887,1200,81,2006,1024,2021,73,7%
2015-03,הדרום,1034,קריית מלאכי,1073,475,598,18,1055,593,1013,86,9%
2015-03,הדרום,1161,רהט,3150,1376,1774,4,3146,2655,3112,35,16%
2015-03,הדרום,1286,שגב-שלום,542,226,316,0,542,453,533,2,20%
2015-03,הדרום,1031,שדרות,1034,485,549,51,983,611,980,32,8%
2015-03,הדרום,1054,תל שבע,1156,572,584,3,1153,1054,1133,10,23%
2015-03,המרכז,182,אבן יהודה,165,78,87,38,127,17,165,1,2%
2015-03,המרכז,41,אליכין,69,38,31,11,58,21,66,3,4%
2015-03,המרכז,1309,אלעד,420,182,238,5,415,68,408,3,3%
2015-03,המרכז,2530,באר יעקב,266,103,163,56,210,45,261,5,3%
2015-03,המרכז,466,בית דגן,97,54,43,5,92,32,96,3,3%
2015-03,המרכז,1066,"בני עי""ש",187,92,95,27,160,63,187,6,5%
2015-03,המרכז,681,גבעת שמואל,248,118,130,27,221,58,240,3,2%
2015-03,המרכז,2550,גדרה,374,156,218,88,286,111,362,9,3%
2015-03,המרכז,627,ג'לג'וליה,105,51,54,3,102,63,97,3,3%
2015-03,המרכז,166,גן יבנה,390,149,241,54,336,87,383,13,3%
2015-03,המרכז,229,גני תקווה,194,79,115,67,127,27,193,3,2%
2015-03,המרכז,9700,הוד השרון,627,273,354,164,463,49,620,11,2%
2015-03,המרכז,1290,זמר,168,58,110,1,167,107,167,1,6%
2015-03,המרכז,2730,טייבה,1598,726,872,24,1574,1318,1449,34,8%
2015-03,המרכז,2720,טירה,283,141,142,11,272,128,279,12,2%
2015-03,המרכז,2660,יבנה,869,426,443,88,781,276,855,33,4%
2015-03,המרכז,9400,יהוד,416,192,224,37,379,54,408,9,3%
2015-03,המרכז,1224,כוכב יאיר,96,42,54,34,62,1,95,1,2%
2015-03,המרכז,633,כפר ברא,22,8,14,1,21,8,22,1,2%
2015-03,המרכז,168,כפר יונה,338,153,185,49,289,57,333,7,3%
2015-03,המרכז,6900,כפר סבא,1288,570,718,329,959,147,1269,26,2%
2015-03,המרכז,634,כפר קאסם,219,100,119,7,212,115,211,1,2%
2015-03,המרכז,7000,לוד,2079,993,1086,135,1944,1134,2026,66,6%
2015-03,המרכז,1200,מודיעין-מכבים-רעות*,905,392,513,323,582,57,894,27,2%
2015-03,המרכז,28,מזכרת בתיה,171,84,87,44,127,30,170,5,2%
2015-03,המרכז,7200,נס ציונה,650,314,336,153,497,176,638,15,3%
2015-03,המרכז,7400,נתניה,4308,2008,2300,335,3973,1499,4191,128,4%
2015-03,המרכז,587,סביון*,15,6,9,6,9,1,15,0,1%
2015-03,המרכז,171,פרדסייה,72,28,44,10,62,8,72,0,2%
2015-03,המרכז,7900,פתח תקווה,3980,1795,2185,787,3193,1029,3885,37,3%
2015-03,המרכז,195,קדימה-צורן,285,115,170,38,247,37,281,6,3%
2015-03,המרכז,638,קלנסווה,606,266,340,8,598,495,568,14,7%
2015-03,המרכז,469,קריית עקרון,269,130,139,12,257,120,264,14,5%
2015-03,המרכז,2640,ראש העין,736,338,398,94,642,145,720,26,3%
2015-03,המרכז,8300,ראשון לציון,4336,1912,2424,459,3877,1255,4304,113,3%
2015-03,המרכז,8400,רחובות,2441,1101,1340,495,1946,916,2369,57,4%
2015-03,המרכז,8500,רמלה,1670,776,894,82,1588,728,1601,68,4%
2015-03,המרכז,8700,רעננה,735,334,401,216,519,60,729,4,2%
2015-03,המרכז,1304,שוהם,187,83,104,72,115,9,187,2,2%
2015-03,המרכז,154,תל מונד,149,76,73,23,126,20,149,2,2%
2015-03,הצפון,473,אבו סנאן,682,282,400,9,673,543,669,14,12%
2015-03,הצפון,478,אכסאל,556,271,285,15,541,447,548,8,10%
2015-03,הצפון,529,אעבלין,594,247,347,7,587,489,586,13,10%
2015-03,הצפון,482,בועיינה-נוג'ידאת,460,188,272,8,452,339,448,4,12%
2015-03,הצפון,4001,בוקעאתא,439,177,262,3,436,347,413,3,15%
2015-03,הצפון,998,ביר אל-מכסור,438,171,267,2,436,333,434,2,12%
2015-03,הצפון,480,בית ג'ן,404,142,262,6,398,291,390,5,7%
2015-03,הצפון,9200,בית שאן,849,376,473,20,829,402,818,74,8%
2015-03,הצפון,944,בסמת טבעון,218,103,115,2,216,164,211,1,7%
2015-03,הצפון,483,בענה,357,161,196,9,348,288,354,11,11%
2015-03,הצפון,1292,ג'דיידה-מכר,1369,605,764,4,1365,1150,1339,32,15%
2015-03,הצפון,485,ג'ולס,225,72,153,2,223,158,221,7,8%
2015-03,הצפון,487,ג'ש (גוש חלב),73,38,35,3,70,35,71,2,4%
2015-03,הצפון,489,דבורייה,365,172,193,16,349,265,364,3,9%
2015-03,הצפון,490,דייר אל-אסד,375,169,206,7,368,296,374,11,7%
2015-03,הצפון,492,דייר חנא,700,322,378,7,693,513,691,4,14%
2015-03,הצפון,975,זרזיר,279,132,147,3,276,190,266,11,9%
2015-03,הצפון,496,חורפיש,124,55,69,8,116,71,118,2,4%
2015-03,הצפון,2034,חצור הגלילית,282,122,160,15,267,136,266,5,6%
2015-03,הצפון,6700,טבריה,1667,771,896,61,1606,940,1480,60,7%
2015-03,הצפון,962,טובא-זנגרייה,370,172,198,7,363,250,364,4,12%
2015-03,הצפון,498,טורעאן,536,224,312,12,524,453,504,9,9%
2015-03,הצפון,8900,טמרה,1985,864,1121,12,1973,1738,1958,19,14%
2015-03,הצפון,1295,יאנוח-ג'ת,174,69,105,10,164,94,174,5,6%
2015-03,הצפון,46,יבנאל,127,81,46,5,122,99,100,1,6%
2015-03,הצפון,499,יפיע,646,286,360,20,626,505,633,3,8%
2015-03,הצפון,240,יקנעם עילית,441,179,262,57,384,133,433,27,4%
2015-03,הצפון,502,ירכא,608,254,354,1,607,464,600,7,10%
2015-03,הצפון,504,כאבול,669,287,382,6,663,570,658,3,14%
2015-03,הצפון,505,כאוכב אבו אל-היג'א,213,91,122,8,205,182,211,1,12%
2015-03,הצפון,1296,כסרא-סמיע,237,104,133,8,229,151,226,5,7%
2015-03,הצפון,978,כעביה-טבאש-חג'אג'רה,200,76,124,4,196,138,195,2,9%
2015-03,הצפון,1263,כפר ורדים,60,30,30,25,35,9,60,0,2%
2015-03,הצפון,507,כפר יאסיף,455,213,242,3,452,358,444,8,9%
2015-03,הצפון,508,כפר כמא,64,27,37,3,61,25,63,1,4%
2015-03,הצפון,509,כפר כנא,1148,516,632,27,1121,942,1069,21,12%
2015-03,הצפון,510,כפר מנדא,1004,456,548,7,997,725,978,11,13%
2015-03,הצפון,47,כפר תבור,52,19,33,14,38,1,51,0,2%
2015-03,הצפון,1139,כרמיאל,1566,649,917,212,1354,766,1486,58,6%
2015-03,הצפון,481,מגאר,1516,644,872,9,1507,1303,1485,22,16%
2015-03,הצפון,516,מג'ד אל-כרום,508,241,267,5,503,374,503,7,8%
2015-03,הצפון,874,מגדל העמק,890,409,481,54,836,374,805,79,6%
2015-03,הצפון,4201,מג'דל שמס,510,190,320,8,502,393,478,12,10%
2015-03,הצפון,517,מזרעה,189,75,114,3,186,140,180,6,9%
2015-03,הצפון,4203,מסעדה,227,93,134,4,223,180,219,6,13%
2015-03,הצפון,518,מעיליא,58,25,33,9,49,27,56,0,3%
2015-03,הצפון,1063,מעלות-תרשיחא,836,395,441,88,748,469,811,23,7%
2015-03,הצפון,520,משהד,278,119,159,10,268,229,263,3,8%
2015-03,הצפון,9100,נהרייה,1909,911,998,140,1769,1101,1841,83,6%
2015-03,הצפון,522,נחף,415,199,216,10,405,336,408,10,8%
2015-03,הצפון,7300,נצרת,3352,1513,1839,102,3250,2619,3269,33,9%
2015-03,הצפון,1061,נצרת עילית,1742,796,946,131,1611,910,1563,98,7%
2015-03,הצפון,525,סאג'ור,97,32,65,3,94,67,96,0,5%
2015-03,הצפון,7500,סח'נין,2153,916,1237,21,2132,1812,2136,13,15%
2015-03,הצפון,4501,ע'ג'ר,93,44,49,0,93,56,93,0,9%
2015-03,הצפון,530,עיילבון,182,76,106,1,181,130,179,1,7%
2015-03,הצפון,511,עילוט,347,147,200,5,342,275,342,2,12%
2015-03,הצפון,532,עין מאהל,509,251,258,5,504,415,489,6,9%
2015-03,הצפון,7600,עכו,3069,1441,1628,127,2942,2309,2968,70,11%
2015-03,הצפון,7700,עפולה,1632,694,938,116,1516,742,1543,77,6%
2015-03,הצפון,531,עראבה,1604,672,932,26,1578,1368,1589,2,16%
2015-03,הצפון,535,פסוטה,118,57,61,9,109,73,116,5,7%
2015-03,הצפון,536,פקיעין (בוקייעה),137,83,54,9,128,85,132,6,5%
2015-03,הצפון,8000,צפת,1353,741,612,52,1301,970,1291,29,10%
2015-03,הצפון,4100,קצרין,214,97,117,17,197,88,212,11,5%
2015-03,הצפון,2800,קריית שמונה,763,354,409,38,725,354,725,39,6%
2015-03,הצפון,543,ראמה,295,123,172,11,284,217,291,1,8%
2015-03,הצפון,26,ראש פינה,52,21,31,5,47,17,51,0,3%
2015-03,הצפון,542,ריינה,646,284,362,12,634,513,618,7,9%
2015-03,הצפון,122,רמת ישי,98,44,54,23,75,15,96,2,2%
2015-03,הצפון,913,שבלי - אום אל-גנם,231,92,139,8,223,149,228,2,9%
2015-03,הצפון,812,שלומי,231,103,128,12,219,123,224,2,6%
2015-03,הצפון,538,שעב,552,228,324,2,550,487,548,0,18%
2015-03,הצפון,8800,שפרעם,1975,792,1183,19,1956,1591,1943,23,11%
2015-03,חיפה,2710,אום אל-פחם,3678,1534,2144,28,3650,3143,3600,32,17%
2015-03,חיפה,1020,אור עקיבא,555,259,296,45,510,190,539,20,5%
2015-03,חיפה,6000,באקה אל-גרביה,678,334,344,6,672,394,672,24,6%
2015-03,חיפה,9800,בנימינה-גבעת עדה*,206,94,112,44,162,61,204,4,3%
2015-03,חיפה,1326,"בסמ""ה",421,188,233,4,417,324,417,8,10%
2015-03,חיפה,541,ג'סר א-זרקא,442,231,211,0,442,320,438,3,8%
2015-03,חיפה,628,ג'ת,253,129,124,7,246,144,252,7,5%
2015-03,חיפה,494,דאלית אל-כרמל,549,230,319,11,538,291,521,8,7%
2015-03,חיפה,9300,זכרון יעקב,251,106,145,67,184,51,246,2,2%
2015-03,חיפה,6500,חדרה,2276,982,1294,252,2024,861,2130,59,4%
2015-03,חיפה,4000,חיפה,6409,3164,3245,1116,5293,3326,6103,163,4%
2015-03,חיפה,1247,חריש,70,40,30,8,62,20,66,1,4%
2015-03,חיפה,2100,טירת כרמל,744,359,385,27,717,408,719,18,7%
2015-03,חיפה,654,כפר קרע,423,181,242,3,420,260,416,2,5%
2015-03,חיפה,1327,מעלה עירון,927,361,566,8,919,773,911,9,16%
2015-03,חיפה,2500,נשר,471,241,230,82,389,189,461,18,4%
2015-03,חיפה,534,עספיא,362,155,207,9,353,178,341,10,6%
2015-03,חיפה,637,ערערה,625,269,356,4,621,413,599,7,7%
2015-03,חיפה,537,פוריידיס,441,221,220,3,438,270,433,2,8%
2015-03,חיפה,7800,פרדס חנה-כרכור,883,434,449,128,755,273,871,35,4%
2015-03,חיפה,6800,קריית אתא,1603,740,863,133,1470,851,1570,51,5%
2015-03,חיפה,9500,קריית ביאליק,1016,423,593,111,905,501,998,28,5%
2015-03,חיפה,2300,קריית טבעון,186,96,90,56,130,42,180,3,2%
2015-03,חיפה,9600,קריית ים,1501,712,789,143,1358,864,1465,52,7%
2015-03,חיפה,8200,קריית מוצקין,1001,427,574,130,871,472,974,31,4%
2015-03,חיפה,922,רכסים,149,70,79,7,142,85,134,0,4%
2015-03,ירושלים,472,אבו גוש,291,137,154,3,288,209,286,2,9%
2015-03,ירושלים,2610,בית שמש,1185,527,658,44,1141,499,1131,38,4%
2015-03,ירושלים,3000,ירושלים,12610,5810,6800,1271,11339,7692,12331,199,4%
2015-03,ירושלים,1015,מבשרת ציון,387,183,204,78,309,153,382,6,3%
2015-03,ירושלים,1137,קריית יערים,37,13,24,5,32,16,36,0,3%
2015-03,תל אביב,2400,אור יהודה,770,393,377,35,735,220,733,45,4%
2015-03,תל אביב,565,אזור,160,80,80,17,143,31,155,6,2%
2015-03,תל אביב,6100,בני ברק,2010,980,1030,48,1962,985,1906,35,3%
2015-03,תל אביב,6200,בת ים,3091,1430,1661,364,2727,1103,2962,80,4%
2015-03,תל אביב,6300,גבעתיים,731,336,395,298,433,95,724,7,2%
2015-03,תל אביב,6400,הרצלייה,1071,498,573,251,820,37,1055,33,2%
2015-03,תל אביב,6600,חולון,2966,1402,1564,248,2718,746,2898,79,3%
2015-03,תל אביב,2620,קריית אונו,369,169,200,95,274,42,366,1,2%
2015-03,תל אביב,8600,רמת גן,2063,941,1122,614,1449,416,2027,23,3%
2015-03,תל אביב,2650,רמת השרון,403,162,241,121,282,12,396,4,2%
2015-03,תל אביב,5000,תל אביב -יפו,7404,3636,3768,2232,5172,2031,7254,129,3%
2015-04,אזור יהודה והשומרון,3760,אורנית,110,56,54,36,74,3,110,1,2%
2015-04,אזור יהודה והשומרון,3750,אלפי מנשה,95,49,46,21,74,1,95,0,2%
2015-04,אזור יהודה והשומרון,3560,אלקנה,28,16,12,10,18,1,28,0,1%
2015-04,אזור יהודה והשומרון,3650,אפרת,114,52,62,34,80,8,114,2,3%
2015-04,אזור יהודה והשומרון,3570,אריאל,313,147,166,55,258,62,312,7,3%
2015-04,אזור יהודה והשומרון,3574,בית אל,38,17,21,11,27,12,38,0,2%
2015-04,אזור יהודה והשומרון,3652,בית אריה,44,21,23,6,38,2,44,0,2%
2015-04,אזור יהודה והשומרון,3780,ביתר עילית,551,281,270,8,543,278,548,0,4%
2015-04,אזור יהודה והשומרון,3730,גבעת זאב,207,103,104,37,170,49,206,3,3%
2015-04,אזור יהודה והשומרון,3769,הר אדר,33,14,19,18,15,4,33,0,2%
2015-04,אזור יהודה והשומרון,3797,מודיעין עילית,400,137,263,15,385,64,398,5,3%
2015-04,אזור יהודה והשומרון,3616,מעלה אדומים,624,267,357,56,568,185,621,12,3%
2015-04,אזור יהודה והשומרון,3660,עמנואל,51,31,20,1,50,36,51,0,5%
2015-04,אזור יהודה והשומרון,3557,קדומים,35,16,19,13,22,6,35,1,2%
2015-04,אזור יהודה והשומרון,3611,קריית ארבע,114,54,60,14,100,62,111,4,3%
2015-04,אזור יהודה והשומרון,3640,קרני שומרון,63,34,29,14,49,12,63,1,2%
2015-04,הדרום,31,אופקים,1099,473,626,52,1047,676,1081,30,9%
2015-04,הדרום,2600,אילת,1218,585,633,53,1165,510,1184,46,4%
2015-04,הדרום,70,אשדוד,5898,2520,3378,654,5244,2978,5735,122,5%
2015-04,הדרום,7100,אשקלון,3993,1696,2297,303,3690,2054,3654,123,5%
2015-04,הדרום,9000,באר שבע,6555,2993,3562,729,5826,3733,6383,102,6%
2015-04,הדרום,2200,דימונה,1962,890,1072,98,1864,1284,1896,86,10%
2015-04,הדרום,1303,חורה,769,327,442,6,763,693,764,1,19%
2015-04,הדרום,831,ירוחם,392,195,197,15,377,240,377,24,8%
2015-04,הדרום,1059,כסיפה,1005,405,600,1,1004,914,1002,3,22%
2015-04,הדרום,1271,להבים,36,17,19,16,20,5,35,0,1%
2015-04,הדרום,1060,לקיה,889,401,488,2,887,815,877,0,21%
2015-04,הדרום,1268,מיתר,65,25,40,19,46,9,64,1,2%
2015-04,הדרום,99,מצפה רמון,242,107,135,9,233,165,234,11,10%
2015-04,הדרום,246,נתיבות,1016,460,556,49,967,502,989,26,7%
2015-04,הדרום,666,עומר,47,18,29,12,35,4,47,0,1%
2015-04,הדרום,2560,ערד,818,375,443,70,748,399,801,25,7%
2015-04,הדרום,1192,ערערה-בנגב,1074,460,614,6,1068,967,1063,0,25%
2015-04,הדרום,2630,קריית גת,1962,813,1149,96,1866,993,1902,32,7%
2015-04,הדרום,1034,קריית מלאכי,1013,433,580,15,998,559,980,55,9%
2015-04,הדרום,1161,רהט,3051,1326,1725,9,3042,2556,3027,31,16%
2015-04,הדרום,1286,שגב-שלום,549,216,333,0,549,445,544,1,20%
2015-04,הדרום,1031,שדרות,986,466,520,50,936,592,945,13,7%
2015-04,הדרום,1054,תל שבע,1118,542,576,2,1116,1012,1107,6,23%
2015-04,המרכז,182,אבן יהודה,148,71,77,29,119,14,148,0,2%
2015-04,המרכז,41,אליכין,65,35,30,9,56,21,63,1,3%
2015-04,המרכז,1309,אלעד,381,168,213,10,371,59,374,1,3%
2015-04,המרכז,2530,באר יעקב,237,99,138,40,197,43,232,3,3%
2015-04,המרכז,466,בית דגן,97,52,45,4,93,31,97,0,3%
2015-04,המרכז,1066,"בני עי""ש",183,91,92,30,153,65,181,4,5%
2015-04,המרכז,681,גבעת שמואל,245,115,130,42,203,58,239,2,2%
2015-04,המרכז,2550,גדרה,341,145,196,82,259,102,333,6,3%
2015-04,המרכז,627,ג'לג'וליה,95,47,48,3,92,59,91,0,3%
2015-04,המרכז,166,גן יבנה,359,141,218,46,313,79,355,3,3%
2015-04,המרכז,229,גני תקווה,188,76,112,67,121,24,188,1,2%
2015-04,המרכז,9700,הוד השרון,559,239,320,147,412,50,556,8,2%
2015-04,המרכז,1290,זמר,154,51,103,1,153,105,153,9,5%
2015-04,המרכז,2730,טייבה,1520,679,841,26,1494,1259,1393,27,8%
2015-04,המרכז,2720,טירה,259,132,127,11,248,118,258,12,2%
2015-04,המרכז,2660,יבנה,858,402,456,92,766,277,854,23,4%
2015-04,המרכז,9400,יהוד,406,186,220,40,366,58,395,8,3%
2015-04,המרכז,1224,כוכב יאיר,91,37,54,39,52,0,91,0,2%
2015-04,המרכז,633,כפר ברא,27,11,16,1,26,9,26,0,2%
2015-04,המרכז,168,כפר יונה,312,140,172,46,266,54,310,10,3%
2015-04,המרכז,6900,כפר סבא,1222,538,684,347,875,138,1209,16,2%
2015-04,המרכז,634,כפר קאסם,207,96,111,7,200,108,203,4,2%
2015-04,המרכז,7000,לוד,1930,912,1018,134,1796,1055,1905,21,5%
2015-04,המרכז,1200,מודיעין-מכבים-רעות*,881,371,510,305,576,55,874,10,2%
2015-04,המרכז,28,מזכרת בתיה,159,74,85,40,119,29,159,0,2%
2015-04,המרכז,7200,נס ציונה,585,279,306,144,441,169,582,2,3%
2015-04,המרכז,7400,נתניה,4032,1880,2152,322,3710,1382,3964,96,4%
2015-04,המרכז,587,סביון*,15,4,11,6,9,0,15,0,1%
2015-04,המרכז,171,פרדסייה,74,32,42,12,62,8,74,0,2%
2015-04,המרכז,7900,פתח תקווה,3824,1702,2122,770,3054,976,3765,33,3%
2015-04,המרכז,195,קדימה-צורן,272,109,163,45,227,36,270,3,3%
2015-04,המרכז,638,קלנסווה,591,255,336,7,584,491,551,7,6%
2015-04,המרכז,469,קריית עקרון,235,117,118,9,226,114,234,5,4%
2015-04,המרכז,2640,ראש העין,687,315,372,79,608,145,682,20,3%
2015-04,המרכז,8300,ראשון לציון,4120,1804,2316,523,3597,1202,4099,64,3%
2015-04,המרכז,8400,רחובות,2321,1055,1266,470,1851,895,2269,38,3%
2015-04,המרכז,8500,רמלה,1603,757,846,89,1514,697,1555,37,4%
2015-04,המרכז,8700,רעננה,712,326,386,225,487,63,709,7,2%
2015-04,המרכז,1304,שוהם,175,81,94,70,105,10,175,1,2%
2015-04,המרכז,154,תל מונד,140,74,66,21,119,18,140,0,2%
2015-04,הצפון,473,אבו סנאן,664,274,390,6,658,525,654,5,11%
2015-04,הצפון,478,אכסאל,552,271,281,14,538,447,536,2,9%
2015-04,הצפון,529,אעבלין,563,233,330,8,555,460,561,6,10%
2015-04,הצפון,482,בועיינה-נוג'ידאת,435,181,254,8,427,328,424,9,11%
2015-04,הצפון,4001,בוקעאתא,407,161,246,3,404,334,388,0,14%
2015-04,הצפון,998,ביר אל-מכסור,423,163,260,1,422,324,418,0,11%
2015-04,הצפון,480,בית ג'ן,393,129,264,4,389,278,385,1,7%
2015-04,הצפון,9200,בית שאן,784,353,431,20,764,392,766,44,8%
2015-04,הצפון,944,בסמת טבעון,213,102,111,3,210,157,210,3,7%
2015-04,הצפון,483,בענה,347,154,193,7,340,278,342,11,10%
2015-04,הצפון,1292,ג'דיידה-מכר,1308,569,739,3,1305,1089,1285,18,14%
2015-04,הצפון,485,ג'ולס,210,65,145,2,208,156,207,5,7%
2015-04,הצפון,487,ג'ש (גוש חלב),64,31,33,5,59,36,62,0,4%
2015-04,הצפון,489,דבורייה,366,168,198,21,345,258,365,2,9%
2015-04,הצפון,490,דייר אל-אסד,352,154,198,5,347,284,352,5,7%
2015-04,הצפון,492,דייר חנא,664,292,372,8,656,511,657,0,14%
2015-04,הצפון,975,זרזיר,259,116,143,3,256,187,256,3,8%
2015-04,הצפון,496,חורפיש,112,49,63,5,107,68,110,1,4%
2015-04,הצפון,2034,חצור הגלילית,284,128,156,14,270,132,278,11,6%
2015-04,הצפון,6700,טבריה,1536,732,804,64,1472,911,1368,49,6%
2015-04,הצפון,962,טובא-זנגרייה,374,171,203,6,368,246,367,2,12%
2015-04,הצפון,498,טורעאן,499,200,299,11,488,426,473,7,8%
2015-04,הצפון,8900,טמרה,1913,830,1083,11,1902,1673,1895,17,14%
2015-04,הצפון,1295,יאנוח-ג'ת,170,63,107,10,160,93,170,4,6%
2015-04,הצפון,46,יבנאל,115,66,49,5,110,95,92,0,6%
2015-04,הצפון,499,יפיע,644,285,359,21,623,504,626,2,8%
2015-04,הצפון,240,יקנעם עילית,434,175,259,58,376,134,428,22,4%
2015-04,הצפון,502,ירכא,600,240,360,1,599,459,596,3,10%
2015-04,הצפון,504,כאבול,652,278,374,6,646,556,649,3,13%
2015-04,הצפון,505,כאוכב אבו אל-היג'א,216,92,124,7,209,184,214,0,12%
2015-04,הצפון,1296,כסרא-סמיע,209,90,119,7,202,140,203,1,6%
2015-04,הצפון,978,כעביה-טבאש-חג'אג'רה,194,74,120,5,189,133,191,1,8%
2015-04,הצפון,1263,כפר ורדים,54,27,27,22,32,7,54,0,2%
2015-04,הצפון,507,כפר יאסיף,430,201,229,1,429,340,418,6,8%
2015-04,הצפון,508,כפר כמא,54,25,29,2,52,24,52,0,3%
2015-04,הצפון,509,כפר כנא,1108,484,624,26,1082,921,1054,15,12%
2015-04,הצפון,510,כפר מנדא,1003,466,537,8,995,734,963,17,13%
2015-04,הצפון,47,כפר תבור,54,19,35,17,37,2,52,0,2%
2015-04,הצפון,1139,כרמיאל,1504,622,882,204,1300,742,1451,35,6%
2015-04,הצפון,481,מגאר,1481,602,879,11,1470,1267,1463,12,16%
2015-04,הצפון,516,מג'ד אל-כרום,488,221,267,7,481,370,482,13,8%
2015-04,הצפון,874,מגדל העמק,837,386,451,50,787,347,802,55,6%
2015-04,הצפון,4201,מג'דל שמס,466,175,291,8,458,369,447,4,9%
2015-04,הצפון,517,מזרעה,176,67,109,2,174,139,170,0,9%
2015-04,הצפון,4203,מסעדה,212,87,125,4,208,171,207,1,12%
2015-04,הצפון,518,מעיליא,53,26,27,7,46,24,53,1,3%
2015-04,הצפון,1063,מעלות-תרשיחא,782,361,421,85,697,455,769,19,6%
2015-04,הצפון,520,משהד,281,114,167,8,273,223,269,3,8%
2015-04,הצפון,9100,נהרייה,1827,853,974,142,1685,1056,1788,72,6%
2015-04,הצפון,522,נחף,397,183,214,9,388,315,394,7,8%
2015-04,הצפון,7300,נצרת,3275,1495,1780,99,3176,2574,3187,14,9%
2015-04,הצפון,1061,נצרת עילית,1637,742,895,127,1510,882,1493,65,6%
2015-04,הצפון,525,סאג'ור,110,35,75,4,106,69,110,0,6%
2015-04,הצפון,7500,סח'נין,2105,876,1229,14,2091,1792,2094,8,15%
2015-04,הצפון,4501,ע'ג'ר,100,43,57,0,100,55,99,1,10%
2015-04,הצפון,530,עיילבון,163,67,96,1,162,118,161,2,6%
2015-04,הצפון,511,עילוט,344,148,196,5,339,272,334,1,12%
2015-04,הצפון,532,עין מאהל,491,240,251,7,484,412,473,3,9%
2015-04,הצפון,7600,עכו,2921,1371,1550,114,2807,2201,2862,46,11%
2015-04,הצפון,7700,עפולה,1541,659,882,122,1419,679,1503,47,6%
2015-04,הצפון,531,עראבה,1572,660,912,26,1546,1338,1561,3,15%
2015-04,הצפון,535,פסוטה,104,48,56,5,99,63,104,1,6%
2015-04,הצפון,536,פקיעין (בוקייעה),116,69,47,7,109,75,114,1,4%
2015-04,הצפון,8000,צפת,1334,724,610,53,1281,963,1274,22,10%
2015-04,הצפון,4100,קצרין,187,86,101,16,171,83,183,3,5%
2015-04,הצפון,2800,קריית שמונה,697,317,380,37,660,329,673,40,5%
2015-04,הצפון,543,ראמה,289,121,168,12,277,215,286,1,7%
2015-04,הצפון,26,ראש פינה,39,14,25,5,34,15,39,1,2%
2015-04,הצפון,542,ריינה,631,271,360,8,623,500,600,4,9%
2015-04,הצפון,122,רמת ישי,107,48,59,24,83,17,105,2,3%
2015-04,הצפון,913,שבלי - אום אל-גנם,211,93,118,6,205,142,210,1,8%
2015-04,הצפון,812,שלומי,205,90,115,12,193,104,202,6,6%
2015-04,הצפון,538,שעב,530,214,316,2,528,476,526,1,17%
2015-04,הצפון,8800,שפרעם,1920,767,1153,20,1900,1554,1897,34,11%
2015-04,חיפה,2710,אום אל-פחם,3582,1497,2085,26,3556,3052,3507,25,17%
2015-04,חיפה,1020,אור עקיבא,524,248,276,36,488,184,505,17,5%
2015-04,חיפה,6000,באקה אל-גרביה,635,303,332,5,630,371,632,18,5%
2015-04,חיפה,9800,בנימינה-גבעת עדה*,205,96,109,54,151,57,204,1,3%
2015-04,חיפה,1326,"בסמ""ה",408,185,223,4,404,308,407,2,10%
2015-04,חיפה,541,ג'סר א-זרקא,435,227,208,0,435,315,433,3,7%
2015-04,חיפה,628,ג'ת,222,115,107,7,215,132,221,6,4%
2015-04,חיפה,494,דאלית אל-כרמל,503,212,291,11,492,266,489,5,6%
2015-04,חיפה,9300,זכרון יעקב,250,109,141,63,187,51,250,1,2%
2015-04,חיפה,6500,חדרה,2169,935,1234,237,1932,816,2074,49,4%
2015-04,חיפה,4000,חיפה,5983,2935,3048,1049,4934,3212,5745,110,4%
2015-04,חיפה,1247,חריש,60,34,26,10,50,14,60,0,4%
2015-04,חיפה,2100,טירת כרמל,733,353,380,24,709,397,720,18,7%
2015-04,חיפה,654,כפר קרע,390,163,227,3,387,246,386,9,5%
2015-04,חיפה,1327,מעלה עירון,913,356,557,9,904,758,900,10,15%
2015-04,חיפה,2500,נשר,450,227,223,79,371,186,439,6,3%
2015-04,חיפה,534,עספיא,328,144,184,9,319,168,315,6,6%
2015-04,חיפה,637,ערערה,598,263,335,2,596,379,588,7,7%
2015-04,חיפה,537,פוריידיס,395,199,196,4,391,268,392,2,7%
2015-04,חיפה,7800,פרדס חנה-כרכור,836,399,437,130,706,254,826,13,4%
2015-04,חיפה,6800,קריית אתא,1486,682,804,134,1352,821,1465,29,5%
2015-04,חיפה,9500,קריית ביאליק,947,393,554,111,836,476,936,21,4%
2015-04,חיפה,2300,קריית טבעון,165,85,80,53,112,37,160,1,2%
2015-04,חיפה,9600,קריית ים,1412,664,748,127,1285,816,1385,19,7%
2015-04,חיפה,8200,קריית מוצקין,949,398,551,127,822,461,929,13,4%
2015-04,חיפה,922,רכסים,140,64,76,7,133,74,130,0,4%
2015-04,ירושלים,472,אבו גוש,277,131,146,3,274,201,276,1,9%
2015-04,ירושלים,2610,בית שמש,1114,498,616,40,1074,478,1083,19,3%
2015-04,ירושלים,3000,ירושלים,12060,5501,6559,1220,10840,7528,11863,100,4%
2015-04,ירושלים,1015,מבשרת ציון,370,185,185,66,304,142,366,4,3%
2015-04,ירושלים,1137,קריית יערים,32,12,20,1,31,17,32,0,2%
2015-04,תל אביב,2400,אור יהודה,707,339,368,40,667,215,677,16,4%
2015-04,תל אביב,565,אזור,145,77,68,15,130,26,144,1,2%
2015-04,תל אביב,6100,בני ברק,1964,957,1007,58,1906,961,1874,17,3%
2015-04,תל אביב,6200,בת ים,2888,1345,1543,349,2539,1063,2794,55,4%
2015-04,תל אביב,6300,גבעתיים,694,303,391,284,410,94,691,6,2%
2015-04,תל אביב,6400,הרצלייה,985,442,543,274,711,28,978,15,2%
2015-04,תל אביב,6600,חולון,2763,1297,1466,307,2456,684,2733,64,3%
2015-04,תל אביב,2620,קריית אונו,344,156,188,97,247,42,343,0,2%
2015-04,תל אביב,8600,רמת גן,1929,884,1045,600,1329,402,1903,10,2%
2015-04,תל אביב,2650,רמת השרון,372,133,239,133,239,7,370,5,2%
2015-04,תל אביב,5000,תל אביב -יפו,6896,3351,3545,2129,4767,1931,6801,70,3%
2015-05,אזור יהודה והשומרון,3760,אורנית,108,51,57,39,69,3,108,2,2%
2015-05,אזור יהודה והשומרון,3750,אלפי מנשה,100,49,51,33,67,1,100,3,2%
2015-05,אזור יהודה והשומרון,3560,אלקנה,24,11,13,9,15,1,24,0,1%
2015-05,אזור יהודה והשומרון,3650,אפרת,106,60,46,34,72,6,106,2,3%
2015-05,אזור יהודה והשומרון,3570,אריאל,310,148,162,72,238,61,310,15,3%
2015-05,אזור יהודה והשומרון,3574,בית אל,49,21,28,17,32,15,49,0,2%
2015-05,אזור יהודה והשומרון,3652,בית אריה,48,21,27,12,36,2,48,0,2%
2015-05,אזור יהודה והשומרון,3780,ביתר עילית,577,292,285,6,571,292,573,15,5%
2015-05,אזור יהודה והשומרון,3730,גבעת זאב,194,97,97,36,158,43,193,2,3%
2015-05,אזור יהודה והשומרון,3769,הר אדר,32,14,18,20,12,4,32,0,2%
2015-05,אזור יהודה והשומרון,3797,מודיעין עילית,383,128,255,23,360,59,381,3,3%
2015-05,אזור יהודה והשומרון,3616,מעלה אדומים,642,276,366,89,553,178,637,17,3%
2015-05,אזור יהודה והשומרון,3660,עמנואל,54,34,20,2,52,40,53,0,5%
2015-05,אזור יהודה והשומרון,3557,קדומים,37,16,21,17,20,6,37,1,2%
2015-05,אזור יהודה והשומרון,3611,קריית ארבע,119,61,58,17,102,66,116,5,4%
2015-05,אזור יהודה והשומרון,3640,קרני שומרון,69,38,31,17,52,11,69,1,2%
2015-05,הדרום,31,אופקים,1108,487,621,55,1053,671,1096,42,9%
2015-05,הדרום,2600,אילת,1212,576,636,67,1145,510,1179,58,4%
2015-05,הדרום,70,אשדוד,6024,2566,3458,724,5300,2968,5853,206,5%
2015-05,הדרום,7100,אשקלון,4084,1744,2340,440,3644,2044,3720,127,5%
2015-05,הדרום,9000,באר שבע,6684,3082,3602,855,5829,3769,6499,199,6%
2015-05,הדרום,2200,דימונה,1955,903,1052,102,1853,1277,1897,76,10%
2015-05,הדרום,1303,חורה,762,330,432,4,758,681,758,3,19%
2015-05,הדרום,831,ירוחם,398,205,193,18,380,240,386,31,9%
2015-05,הדרום,1059,כסיפה,1007,404,603,1,1006,925,1006,1,22%
2015-05,הדרום,1271,להבים,38,20,18,17,21,5,37,0,1%
2015-05,הדרום,1060,לקיה,886,407,479,4,882,810,879,4,21%
2015-05,הדרום,1268,מיתר,65,27,38,20,45,9,65,1,2%
2015-05,הדרום,99,מצפה רמון,268,112,156,21,247,176,261,14,11%
2015-05,הדרום,246,נתיבות,978,428,550,45,933,498,952,51,7%
2015-05,הדרום,666,עומר,56,19,37,22,34,5,56,1,1%
2015-05,הדרום,2560,ערד,815,362,453,81,734,399,795,53,6%
2015-05,הדרום,1192,ערערה-בנגב,1097,467,630,5,1092,995,1086,0,26%
2015-05,הדרום,2630,קריית גת,1995,833,1162,127,1868,1032,1938,64,7%
2015-05,הדרום,1034,קריית מלאכי,1055,456,599,20,1035,559,1021,72,9%
2015-05,הדרום,1161,רהט,3085,1292,1793,14,3071,2564,3065,76,16%
2015-05,הדרום,1286,שגב-שלום,569,210,359,1,568,449,565,1,21%
2015-05,הדרום,1031,שדרות,1027,485,542,45,982,595,983,25,8%
2015-05,הדרום,1054,תל שבע,1131,539,592,1,1130,1015,1122,11,23%
2015-05,המרכז,182,אבן יהודה,139,63,76,34,105,16,139,1,2%
2015-05,המרכז,41,אליכין,63,36,27,7,56,21,61,1,3%
2015-05,המרכז,1309,אלעד,376,177,199,20,356,63,368,4,3%
2015-05,המרכז,2530,באר יעקב,237,94,143,42,195,52,233,5,3%
2015-05,המרכז,466,בית דגן,98,54,44,6,92,33,98,5,3%
2015-05,המרכז,1066,"בני עי""ש",182,91,91,28,154,66,180,4,5%
2015-05,המרכז,681,גבעת שמואל,249,120,129,84,165,58,242,2,2%
2015-05,המרכז,2550,גדרה,329,138,191,84,245,101,326,4,3%
2015-05,המרכז,627,ג'לג'וליה,94,43,51,4,90,60,92,2,3%
2015-05,המרכז,166,גן יבנה,350,141,209,47,303,77,344,9,3%
2015-05,המרכז,229,גני תקווה,186,69,117,69,117,24,186,0,2%
2015-05,המרכז,9700,הוד השרון,572,250,322,225,347,48,569,9,2%
2015-05,המרכז,1290,זמר,146,45,101,1,145,102,145,8,5%
2015-05,המרכז,2730,טייבה,1489,654,835,26,1463,1228,1365,39,8%
2015-05,המרכז,2720,טירה,265,124,141,12,253,122,258,8,2%
2015-05,המרכז,2660,יבנה,875,410,465,118,757,276,873,47,4%
2015-05,המרכז,9400,יהוד,392,190,202,52,340,54,388,12,2%
2015-05,המרכז,1224,כוכב יאיר,89,39,50,49,40,0,89,2,2%
2015-05,המרכז,633,כפר ברא,27,10,17,2,25,8,27,1,2%
2015-05,המרכז,168,כפר יונה,288,126,162,50,238,47,287,4,3%
2015-05,המרכז,6900,כפר סבא,1225,549,676,421,804,137,1214,26,2%
2015-05,המרכז,634,כפר קאסם,222,107,115,5,217,115,217,3,2%
2015-05,המרכז,7000,לוד,1953,933,1020,153,1800,1071,1926,57,6%
2015-05,המרכז,1200,מודיעין-מכבים-רעות*,913,381,532,349,564,62,907,25,2%
2015-05,המרכז,28,מזכרת בתיה,164,82,82,45,119,30,164,4,2%
2015-05,המרכז,7200,נס ציונה,591,284,307,159,432,179,588,7,3%
2015-05,המרכז,7400,נתניה,4144,1921,2223,498,3646,1399,4073,123,4%
2015-05,המרכז,587,סביון*,16,5,11,9,7,0,16,0,1%
2015-05,המרכז,171,פרדסייה,75,32,43,13,62,7,75,0,2%
2015-05,המרכז,7900,פתח תקווה,3907,1740,2167,856,3051,1008,3846,51,3%
2015-05,המרכז,195,קדימה-צורן,281,104,177,66,215,38,276,6,3%
2015-05,המרכז,638,קלנסווה,576,254,322,6,570,476,530,11,6%
2015-05,המרכז,469,קריית עקרון,244,122,122,12,232,114,243,6,4%
2015-05,המרכז,2640,ראש העין,691,304,387,76,615,148,686,25,3%
2015-05,המרכז,8300,ראשון לציון,4237,1872,2365,818,3419,1224,4219,92,3%
2015-05,המרכז,8400,רחובות,2354,1099,1255,513,1841,883,2315,50,3%
2015-05,המרכז,8500,רמלה,1652,787,865,105,1547,698,1617,63,4%
2015-05,המרכז,8700,רעננה,752,345,407,294,458,74,745,14,2%
2015-05,המרכז,1304,שוהם,180,79,101,79,101,8,180,2,2%
2015-05,המרכז,154,תל מונד,152,82,70,39,113,21,152,3,2%
2015-05,הצפון,473,אבו סנאן,656,272,384,5,651,512,647,14,11%
2015-05,הצפון,478,אכסאל,560,268,292,13,547,458,546,3,10%
2015-05,הצפון,529,אעבלין,577,244,333,10,567,469,576,8,10%
2015-05,הצפון,482,בועיינה-נוג'ידאת,403,167,236,10,393,314,398,9,10%
2015-05,הצפון,4001,בוקעאתא,428,169,259,5,423,340,405,4,15%
2015-05,הצפון,998,ביר אל-מכסור,420,162,258,3,417,328,417,2,11%
2015-05,הצפון,480,בית ג'ן,412,132,280,7,405,288,407,2,8%
2015-05,הצפון,9200,בית שאן,772,341,431,19,753,389,756,59,8%
2015-05,הצפון,944,בסמת טבעון,215,102,113,2,213,158,210,3,7%
2015-05,הצפון,483,בענה,339,150,189,9,330,273,337,6,10%
2015-05,הצפון,1292,ג'דיידה-מכר,1305,566,739,4,1301,1073,1286,36,14%
2015-05,הצפון,485,ג'ולס,210,67,143,2,208,159,207,4,7%
2015-05,הצפון,487,ג'ש (גוש חלב),77,34,43,5,72,38,75,1,5%
2015-05,הצפון,489,דבורייה,374,168,206,24,350,260,374,5,9%
2015-05,הצפון,490,דייר אל-אסד,369,163,206,6,363,290,368,10,7%
2015-05,הצפון,492,דייר חנא,654,287,367,11,643,511,647,6,13%
2015-05,הצפון,975,זרזיר,258,113,145,2,256,187,256,6,8%
2015-05,הצפון,496,חורפיש,108,44,64,8,100,67,107,2,4%
2015-05,הצפון,2034,חצור הגלילית,274,116,158,16,258,135,267,13,6%
2015-05,הצפון,6700,טבריה,1549,720,829,73,1476,901,1367,69,6%
2015-05,הצפון,962,טובא-זנגרייה,401,172,229,5,396,243,398,3,13%
2015-05,הצפון,498,טורעאן,492,197,295,12,480,420,473,3,8%
2015-05,הצפון,8900,טמרה,1856,808,1048,16,1840,1616,1846,26,13%
2015-05,הצפון,1295,יאנוח-ג'ת,172,62,110,8,164,95,169,5,6%
2015-05,הצפון,46,יבנאל,102,62,40,3,99,83,79,1,5%
2015-05,הצפון,499,יפיע,625,276,349,22,603,490,615,7,8%
2015-05,הצפון,240,יקנעם עילית,427,176,251,64,363,133,424,30,4%
2015-05,הצפון,502,ירכא,596,244,352,1,595,456,590,2,10%
2015-05,הצפון,504,כאבול,656,282,374,9,647,556,653,3,13%
2015-05,הצפון,505,כאוכב אבו אל-היג'א,220,94,126,9,211,186,218,1,13%
2015-05,הצפון,1296,כסרא-סמיע,236,100,136,7,229,153,235,4,7%
2015-05,הצפון,978,כעביה-טבאש-חג'אג'רה,195,78,117,6,189,136,191,4,8%
2015-05,הצפון,1263,כפר ורדים,56,26,30,27,29,7,56,2,2%
2015-05,הצפון,507,כפר יאסיף,433,197,236,2,431,326,428,13,8%
2015-05,הצפון,508,כפר כמא,58,28,30,1,57,27,56,0,3%
2015-05,הצפון,509,כפר כנא,1093,468,625,28,1065,907,1046,13,12%
2015-05,הצפון,510,כפר מנדא,964,434,530,7,957,682,948,16,13%
2015-05,הצפון,47,כפר תבור,43,18,25,13,30,1,42,0,2%
2015-05,הצפון,1139,כרמיאל,1512,638,874,249,1263,752,1458,59,6%
2015-05,הצפון,481,מגאר,1465,593,872,14,1451,1248,1451,16,16%
2015-05,הצפון,516,מג'ד אל-כרום,504,224,280,9,495,370,500,8,8%
2015-05,הצפון,874,מגדל העמק,868,401,467,66,802,347,845,81,6%
2015-05,הצפון,4201,מג'דל שמס,485,175,310,10,475,369,457,7,10%
2015-05,הצפון,517,מזרעה,183,72,111,2,181,140,177,5,9%
2015-05,הצפון,4203,מסעדה,217,88,129,5,212,171,208,4,12%
2015-05,הצפון,518,מעיליא,48,27,21,6,42,21,48,5,3%
2015-05,הצפון,1063,מעלות-תרשיחא,812,390,422,105,707,453,809,29,7%
2015-05,הצפון,520,משהד,275,107,168,7,268,215,270,4,8%
2015-05,הצפון,9100,נהרייה,1798,833,965,180,1618,1046,1769,72,6%
2015-05,הצפון,522,נחף,392,178,214,13,379,311,389,11,8%
2015-05,הצפון,7300,נצרת,3234,1464,1770,110,3124,2545,3169,27,9%
2015-05,הצפון,1061,נצרת עילית,1668,762,906,145,1523,872,1535,133,7%
2015-05,הצפון,525,סאג'ור,111,36,75,4,107,71,111,1,6%
2015-05,הצפון,7500,סח'נין,2124,888,1236,14,2110,1806,2111,14,15%
2015-05,הצפון,4501,ע'ג'ר,110,41,69,1,109,60,110,0,11%
2015-05,הצפון,530,עיילבון,167,68,99,4,163,122,166,2,6%
2015-05,הצפון,511,עילוט,337,146,191,7,330,265,335,1,12%
2015-05,הצפון,532,עין מאהל,484,238,246,7,477,402,469,4,9%
2015-05,הצפון,7600,עכו,3029,1402,1627,114,2915,2233,2974,62,11%
2015-05,הצפון,7700,עפולה,1574,673,901,162,1412,693,1548,92,6%
2015-05,הצפון,531,עראבה,1577,654,923,27,1550,1344,1560,17,15%
2015-05,הצפון,535,פסוטה,113,49,64,7,106,73,112,0,7%
2015-05,הצפון,536,פקיעין (בוקייעה),122,71,51,8,114,77,121,1,4%
2015-05,הצפון,8000,צפת,1354,754,600,74,1280,988,1301,32,10%
2015-05,הצפון,4100,קצרין,178,80,98,29,149,83,174,3,4%
2015-05,הצפון,2800,קריית שמונה,689,322,367,52,637,318,669,53,5%
2015-05,הצפון,543,ראמה,291,121,170,13,278,211,289,4,7%
2015-05,הצפון,26,ראש פינה,42,17,25,10,32,16,42,1,3%
2015-05,הצפון,542,ריינה,635,265,370,11,624,504,615,10,9%
2015-05,הצפון,122,רמת ישי,100,46,54,31,69,14,99,6,2%
2015-05,הצפון,913,שבלי - אום אל-גנם,213,100,113,6,207,148,212,2,8%
2015-05,הצפון,812,שלומי,209,94,115,16,193,106,207,5,6%
2015-05,הצפון,538,שעב,540,220,320,4,536,476,534,2,17%
2015-05,הצפון,8800,שפרעם,1921,759,1162,27,1894,1551,1908,48,11%
2015-05,חיפה,2710,אום אל-פחם,3612,1514,2098,26,3586,3048,3545,51,17%
2015-05,חיפה,1020,אור עקיבא,509,238,271,46,463,188,494,24,5%
2015-05,חיפה,6000,באקה אל-גרביה,648,299,349,10,638,367,645,45,6%
2015-05,חיפה,9800,בנימינה-גבעת עדה*,194,95,99,56,138,59,194,3,3%
2015-05,חיפה,1326,"בסמ""ה",411,184,227,4,407,308,409,7,10%
2015-05,חיפה,541,ג'סר א-זרקא,491,252,239,1,490,321,490,5,8%
2015-05,חיפה,628,ג'ת,210,107,103,8,202,135,210,8,4%
2015-05,חיפה,494,דאלית אל-כרמל,501,198,303,12,489,275,488,5,6%
2015-05,חיפה,9300,זכרון יעקב,258,119,139,82,176,50,257,6,2%
2015-05,חיפה,6500,חדרה,2236,930,1306,268,1968,810,2144,61,4%
2015-05,חיפה,4000,חיפה,6115,2995,3120,1190,4925,3223,5884,152,4%
2015-05,חיפה,1247,חריש,56,32,24,12,44,20,56,1,4%
2015-05,חיפה,2100,טירת כרמל,748,381,367,31,717,404,735,23,7%
2015-05,חיפה,654,כפר קרע,405,165,240,7,398,246,401,13,5%
2015-05,חיפה,1327,מעלה עירון,893,350,543,10,883,734,882,12,15%
2015-05,חיפה,2500,נשר,460,235,225,88,372,184,450,11,4%
2015-05,חיפה,534,עספיא,329,151,178,13,316,167,317,9,6%
2015-05,חיפה,637,ערערה,603,262,341,4,599,373,594,10,7%
2015-05,חיפה,537,פוריידיס,398,187,211,4,394,267,395,3,7%
2015-05,חיפה,7800,פרדס חנה-כרכור,847,405,442,154,693,245,841,12,4%
2015-05,חיפה,6800,קריית אתא,1499,706,793,149,1350,809,1481,41,5%
2015-05,חיפה,9500,קריית ביאליק,967,421,546,119,848,486,958,32,4%
2015-05,חיפה,2300,קריית טבעון,178,89,89,63,115,37,175,0,2%
2015-05,חיפה,9600,קריית ים,1391,649,742,141,1250,800,1370,39,6%
2015-05,חיפה,8200,קריית מוצקין,977,407,570,145,832,447,956,30,4%
2015-05,חיפה,922,רכסים,134,60,74,10,124,71,124,1,4%
2015-05,ירושלים,472,אבו גוש,289,142,147,4,285,202,287,2,9%
2015-05,ירושלים,2610,בית שמש,1222,556,666,77,1145,486,1189,67,4%
2015-05,ירושלים,3000,ירושלים,12207,5576,6631,1368,10839,7537,12045,175,4%
2015-05,ירושלים,1015,מבשרת ציון,372,184,188,76,296,137,368,8,3%
2015-05,ירושלים,1137,קריית יערים,35,13,22,2,33,16,35,0,3%
2015-05,תל אביב,2400,אור יהודה,736,366,370,57,679,201,711,42,4%
2015-05,תל אביב,565,אזור,151,78,73,21,130,31,149,5,2%
2015-05,תל אביב,6100,בני ברק,1934,961,973,83,1851,963,1844,34,3%
2015-05,תל אביב,6200,בת ים,2903,1328,1575,393,2510,1060,2808,85,4%
2015-05,תל אביב,6300,גבעתיים,718,302,416,323,395,86,716,9,2%
2015-05,תל אביב,6400,הרצלייה,993,433,560,349,644,27,988,34,2%
2015-05,תל אביב,6600,חולון,2818,1298,1520,445,2373,678,2785,61,3%
2015-05,תל אביב,2620,קריית אונו,359,174,185,149,210,38,356,2,2%
2015-05,תל אביב,8600,רמת גן,2060,953,1107,692,1368,421,2033,27,3%
2015-05,תל אביב,2650,רמת השרון,364,125,239,168,196,8,363,9,2%
2015-05,תל אביב,5000,תל אביב -יפו,7198,3539,3659,2429,4769,1943,7120,132,3%
2015-06,אזור יהודה והשומרון,3760,אורנית,94,44,50,35,59,4,94,0,2%
2015-06,אזור יהודה והשומרון,3750,אלפי מנשה,88,46,42,26,62,1,88,1,2%
2015-06,אזור יהודה והשומרון,3560,אלקנה,31,18,13,10,21,1,31,0,2%
2015-06,אזור יהודה והשומרון,3650,אפרת,106,58,48,38,68,4,106,2,3%
2015-06,אזור יהודה והשומרון,3570,אריאל,299,143,156,67,232,55,299,10,3%
2015-06,אזור יהודה והשומרון,3574,בית אל,53,28,25,14,39,16,53,0,2%
2015-06,אזור יהודה והשומרון,3652,בית אריה,52,23,29,13,39,2,51,1,2%
2015-06,אזור יהודה והשומרון,3780,ביתר עילית,601,292,309,10,591,298,596,5,5%
2015-06,אזור יהודה והשומרון,3730,גבעת זאב,195,90,105,41,154,39,192,4,3%
2015-06,אזור יהודה והשומרון,3769,הר אדר,30,13,17,18,12,5,30,0,1%
2015-06,אזור יהודה והשומרון,3797,מודיעין עילית,441,150,291,24,417,62,434,5,3%
2015-06,אזור יהודה והשומרון,3616,מעלה אדומים,679,298,381,95,584,171,677,15,3%
2015-06,אזור יהודה והשומרון,3660,עמנואל,57,35,22,2,55,41,56,1,5%
2015-06,אזור יהודה והשומרון,3557,קדומים,31,16,15,15,16,6,31,1,2%
2015-06,אזור יהודה והשומרון,3611,קריית ארבע,110,58,52,13,97,60,110,3,3%
2015-06,אזור יהודה והשומרון,3640,קרני שומרון,70,36,34,17,53,11,70,2,2%
2015-06,הדרום,31,אופקים,1141,492,649,58,1083,664,1125,37,9%
2015-06,הדרום,2600,אילת,1205,560,645,63,1142,493,1166,55,4%
2015-06,הדרום,70,אשדוד,6065,2596,3469,753,5312,2951,5895,173,5%
2015-06,הדרום,7100,אשקלון,4081,1721,2360,438,3643,2037,3670,115,5%
2015-06,הדרום,9000,באר שבע,6633,3014,3619,839,5794,3776,6438,172,6%
2015-06,הדרום,2200,דימונה,1972,903,1069,103,1869,1286,1915,95,10%
2015-06,הדרום,1303,חורה,759,330,429,2,757,677,754,1,19%
2015-06,הדרום,831,ירוחם,395,204,191,19,376,237,378,30,8%
2015-06,הדרום,1059,כסיפה,992,389,603,1,991,913,988,6,21%
2015-06,הדרום,1271,להבים,42,21,21,20,22,4,42,2,1%
2015-06,הדרום,1060,לקיה,881,411,470,5,876,805,876,3,21%
2015-06,הדרום,1268,מיתר,73,33,40,27,46,8,73,1,2%
2015-06,הדרום,99,מצפה רמון,277,116,161,12,265,179,270,18,11%
2015-06,הדרום,246,נתיבות,995,439,556,45,950,487,961,49,7%
2015-06,הדרום,666,עומר,50,13,37,21,29,4,49,0,1%
2015-06,הדרום,2560,ערד,840,374,466,85,755,418,817,54,7%
2015-06,הדרום,1192,ערערה-בנגב,1087,463,624,3,1084,994,1069,0,25%
2015-06,הדרום,2630,קריית גת,1991,827,1164,122,1869,1045,1930,75,7%
2015-06,הדרום,1034,קריית מלאכי,1054,472,582,21,1033,558,1022,82,9%
2015-06,הדרום,1161,רהט,3127,1343,1784,6,3121,2552,3095,63,16%
2015-06,הדרום,1286,שגב-שלום,549,200,349,1,548,431,545,4,20%
2015-06,הדרום,1031,שדרות,1070,501,569,47,1023,597,1022,36,8%
2015-06,הדרום,1054,תל שבע,1079,514,565,2,1077,985,1073,6,22%
2015-06,המרכז,182,אבן יהודה,144,62,82,33,111,14,144,1,2%
2015-06,המרכז,41,אליכין,65,36,29,7,58,17,64,1,3%
2015-06,המרכז,1309,אלעד,371,179,192,18,353,59,364,4,3%
2015-06,המרכז,2530,באר יעקב,241,98,143,43,198,55,236,7,3%
2015-06,המרכז,466,בית דגן,101,57,44,10,91,35,100,0,3%
2015-06,המרכז,1066,"בני עי""ש",164,79,85,24,140,64,161,3,4%
2015-06,המרכז,681,גבעת שמואל,262,129,133,93,169,59,253,5,2%
2015-06,המרכז,2550,גדרה,348,151,197,83,265,94,343,9,3%
2015-06,המרכז,627,ג'לג'וליה,92,39,53,3,89,59,91,1,3%
2015-06,המרכז,166,גן יבנה,346,140,206,51,295,79,341,4,3%
2015-06,המרכז,229,גני תקווה,193,73,120,67,126,29,193,1,2%
2015-06,המרכז,9700,הוד השרון,581,264,317,228,353,47,573,10,2%
2015-06,המרכז,1290,זמר,143,44,99,1,142,101,142,4,5%
2015-06,המרכז,2730,טייבה,1440,636,804,26,1414,1186,1320,43,8%
2015-06,המרכז,2720,טירה,254,116,138,13,241,120,247,15,2%
2015-06,המרכז,2660,יבנה,885,420,465,120,765,273,880,35,4%
2015-06,המרכז,9400,יהוד,379,173,206,54,325,56,372,10,2%
2015-06,המרכז,1224,כוכב יאיר,94,42,52,49,45,0,94,0,2%
2015-06,המרכז,633,כפר ברא,34,15,19,1,33,16,33,1,2%
2015-06,המרכז,168,כפר יונה,294,132,162,46,248,48,294,4,3%
2015-06,המרכז,6900,כפר סבא,1145,530,615,389,756,144,1130,26,2%
2015-06,המרכז,634,כפר קאסם,212,94,118,5,207,112,206,2,2%
2015-06,המרכז,7000,לוד,1942,942,1000,159,1783,1073,1915,68,5%
2015-06,המרכז,1200,מודיעין-מכבים-רעות*,910,385,525,345,565,64,902,19,2%
2015-06,המרכז,28,מזכרת בתיה,162,80,82,46,116,31,162,6,2%
2015-06,המרכז,7200,נס ציונה,598,279,319,161,437,177,593,4,3%
2015-06,המרכז,7400,נתניה,4113,1910,2203,469,3644,1372,4037,122,4%
2015-06,המרכז,587,סביון*,15,6,9,7,8,0,15,0,1%
2015-06,המרכז,171,פרדסייה,78,33,45,8,70,7,78,1,2%
2015-06,המרכז,7900,פתח תקווה,3859,1707,2152,837,3022,993,3799,47,3%
2015-06,המרכז,195,קדימה-צורן,268,97,171,55,213,37,265,4,3%
2015-06,המרכז,638,קלנסווה,569,254,315,5,564,465,535,15,6%
2015-06,המרכז,469,קריית עקרון,246,123,123,12,234,115,245,8,4%
2015-06,המרכז,2640,ראש העין,701,324,377,69,632,150,697,23,3%
2015-06,המרכז,8300,ראשון לציון,4254,1874,2380,798,3456,1248,4217,78,3%
2015-06,המרכז,8400,רחובות,2349,1092,1257,496,1853,886,2305,59,3%
2015-06,המרכז,8500,רמלה,1625,751,874,108,1517,687,1577,62,4%
2015-06,המרכז,8700,רעננה,744,348,396,289,455,63,738,7,2%
2015-06,המרכז,1304,שוהם,178,81,97,78,100,7,178,1,2%
2015-06,המרכז,154,תל מונד,143,78,65,37,106,21,143,1,2%
2015-06,הצפון,473,אבו סנאן,646,268,378,8,638,486,638,17,11%
2015-06,הצפון,478,אכסאל,551,263,288,12,539,460,536,3,9%
2015-06,הצפון,529,אעבלין,562,234,328,10,552,468,560,9,10%
2015-06,הצפון,482,בועיינה-נוג'ידאת,398,170,228,8,390,316,385,11,10%
2015-06,הצפון,4001,בוקעאתא,419,164,255,5,414,325,391,3,14%
2015-06,הצפון,998,ביר אל-מכסור,421,157,264,3,418,322,416,7,11%
2015-06,הצפון,480,בית ג'ן,402,123,279,9,393,283,396,4,8%
2015-06,הצפון,9200,בית שאן,805,358,447,18,787,388,789,48,8%
2015-06,הצפון,944,בסמת טבעון,223,104,119,2,221,159,215,0,7%
2015-06,הצפון,483,בענה,339,146,193,10,329,280,336,9,10%
2015-06,הצפון,1292,ג'דיידה-מכר,1281,560,721,4,1277,1021,1267,37,14%
2015-06,הצפון,485,ג'ולס,206,67,139,2,204,150,205,4,7%
2015-06,הצפון,487,ג'ש (גוש חלב),78,36,42,3,75,43,75,4,5%
2015-06,הצפון,489,דבורייה,380,170,210,24,356,260,379,5,9%
2015-06,הצפון,490,דייר אל-אסד,369,164,205,7,362,299,365,5,7%
2015-06,הצפון,492,דייר חנא,653,286,367,8,645,516,646,4,13%
2015-06,הצפון,975,זרזיר,272,125,147,2,270,185,268,2,9%
2015-06,הצפון,496,חורפיש,115,49,66,7,108,67,114,1,4%
2015-06,הצפון,2034,חצור הגלילית,270,111,159,15,255,127,262,14,6%
2015-06,הצפון,6700,טבריה,1588,748,840,75,1513,890,1402,59,7%
2015-06,הצפון,962,טובא-זנגרייה,393,176,217,6,387,246,387,4,13%
2015-06,הצפון,498,טורעאן,496,204,292,11,485,414,470,8,8%
2015-06,הצפון,8900,טמרה,1850,816,1034,18,1832,1582,1836,13,13%
2015-06,הצפון,1295,יאנוח-ג'ת,160,58,102,7,153,95,156,4,6%
2015-06,הצפון,46,יבנאל,103,62,41,4,99,80,79,1,5%
2015-06,הצפון,499,יפיע,646,287,359,24,622,508,626,4,8%
2015-06,הצפון,240,יקנעם עילית,424,176,248,60,364,133,420,27,4%
2015-06,הצפון,502,ירכא,585,246,339,0,585,435,579,6,10%
2015-06,הצפון,504,כאבול,647,283,364,10,637,551,644,2,13%
2015-06,הצפון,505,כאוכב אבו אל-היג'א,223,94,129,8,215,184,222,3,13%
2015-06,הצפון,1296,כסרא-סמיע,227,96,131,8,219,144,217,5,6%
2015-06,הצפון,978,כעביה-טבאש-חג'אג'רה,196,77,119,5,191,131,192,1,8%
2015-06,הצפון,1263,כפר ורדים,54,26,28,25,29,7,54,0,2%
2015-06,הצפון,507,כפר יאסיף,423,194,229,3,420,313,416,11,8%
2015-06,הצפון,508,כפר כמא,54,24,30,2,52,26,52,0,3%
2015-06,הצפון,509,כפר כנא,1119,479,640,22,1097,922,1057,21,12%
2015-06,הצפון,510,כפר מנדא,995,469,526,8,987,717,958,3,13%
2015-06,הצפון,47,כפר תבור,47,16,31,16,31,1,47,0,2%
2015-06,הצפון,1139,כרמיאל,1515,640,875,252,1263,763,1459,53,6%
2015-06,הצפון,481,מגאר,1489,601,888,17,1472,1257,1467,15,16%
2015-06,הצפון,516,מג'ד אל-כרום,522,234,288,10,512,370,519,15,8%
2015-06,הצפון,874,מגדל העמק,872,410,462,68,804,345,846,87,6%
2015-06,הצפון,4201,מג'דל שמס,476,167,309,11,465,360,445,7,9%
2015-06,הצפון,517,מזרעה,178,68,110,1,177,138,172,10,9%
2015-06,הצפון,4203,מסעדה,220,88,132,5,215,160,213,11,13%
2015-06,הצפון,518,מעיליא,42,23,19,5,37,20,42,1,3%
2015-06,הצפון,1063,מעלות-תרשיחא,786,384,402,96,690,433,773,33,7%
2015-06,הצפון,520,משהד,280,110,170,4,276,220,270,3,8%
2015-06,הצפון,9100,נהרייה,1817,848,969,187,1630,1043,1776,68,6%
2015-06,הצפון,522,נחף,389,184,205,12,377,308,386,11,8%
2015-06,הצפון,7300,נצרת,3293,1499,1794,107,3186,2565,3192,38,9%
2015-06,הצפון,1061,נצרת עילית,1682,747,935,143,1539,887,1542,106,7%
2015-06,הצפון,525,סאג'ור,111,33,78,4,107,70,110,0,6%
2015-06,הצפון,7500,סח'נין,2139,907,1232,17,2122,1825,2123,10,15%
2015-06,הצפון,4501,ע'ג'ר,110,38,72,1,109,59,110,0,11%
2015-06,הצפון,530,עיילבון,168,70,98,5,163,122,168,2,6%
2015-06,הצפון,511,עילוט,335,142,193,7,328,265,327,1,12%
2015-06,הצפון,532,עין מאהל,489,233,256,4,485,407,474,4,9%
2015-06,הצפון,7600,עכו,3082,1405,1677,113,2969,2260,3012,76,11%
2015-06,הצפון,7700,עפולה,1562,675,887,155,1407,693,1532,94,6%
2015-06,הצפון,531,עראבה,1575,660,915,28,1547,1354,1556,10,15%
2015-06,הצפון,535,פסוטה,108,49,59,6,102,66,106,1,6%
2015-06,הצפון,536,פקיעין (בוקייעה),124,71,53,7,117,77,123,3,5%
2015-06,הצפון,8000,צפת,1351,752,599,84,1267,1001,1288,29,10%
2015-06,הצפון,4100,קצרין,181,86,95,27,154,81,177,4,5%
2015-06,הצפון,2800,קריית שמונה,686,323,363,51,635,310,664,47,5%
2015-06,הצפון,543,ראמה,278,115,163,13,265,204,274,5,7%
2015-06,הצפון,26,ראש פינה,39,15,24,9,30,14,39,3,2%
2015-06,הצפון,542,ריינה,632,271,361,14,618,495,609,8,9%
2015-06,הצפון,122,רמת ישי,100,46,54,32,68,14,99,2,2%
2015-06,הצפון,913,שבלי - אום אל-גנם,215,101,114,6,209,142,213,2,8%
2015-06,הצפון,812,שלומי,213,91,122,12,201,109,207,8,6%
2015-06,הצפון,538,שעב,530,211,319,4,526,469,526,5,17%
2015-06,הצפון,8800,שפרעם,1922,763,1159,26,1896,1533,1913,54,11%
2015-06,חיפה,2710,אום אל-פחם,3581,1501,2080,24,3557,2992,3515,41,17%
2015-06,חיפה,1020,אור עקיבא,513,229,284,45,468,182,496,20,5%
2015-06,חיפה,6000,באקה אל-גרביה,621,295,326,12,609,354,617,23,5%
2015-06,חיפה,9800,בנימינה-גבעת עדה*,188,91,97,49,139,63,188,1,3%
2015-06,חיפה,1326,"בסמ""ה",411,185,226,3,408,315,407,5,10%
2015-06,חיפה,541,ג'סר א-זרקא,487,243,244,2,485,306,487,7,8%
2015-06,חיפה,628,ג'ת,203,100,103,6,197,124,203,4,4%
2015-06,חיפה,494,דאלית אל-כרמל,479,197,282,12,467,269,463,7,6%
2015-06,חיפה,9300,זכרון יעקב,246,116,130,77,169,48,246,6,2%
2015-06,חיפה,6500,חדרה,2294,940,1354,285,2009,829,2178,79,4%
2015-06,חיפה,4000,חיפה,6235,3043,3192,1209,5026,3288,5946,178,4%
2015-06,חיפה,1247,חריש,58,36,22,10,48,20,54,0,4%
2015-06,חיפה,2100,טירת כרמל,729,371,358,32,697,410,706,25,7%
2015-06,חיפה,654,כפר קרע,404,169,235,7,397,245,400,9,5%
2015-06,חיפה,1327,מעלה עירון,893,349,544,6,887,736,879,11,15%
2015-06,חיפה,2500,נשר,473,244,229,86,387,183,461,14,4%
2015-06,חיפה,534,עספיא,322,152,170,10,312,167,313,7,6%
2015-06,חיפה,637,ערערה,594,257,337,3,591,377,582,4,7%
2015-06,חיפה,537,פוריידיס,404,184,220,8,396,268,399,0,7%
2015-06,חיפה,7800,פרדס חנה-כרכור,835,395,440,158,677,243,827,25,4%
2015-06,חיפה,6800,קריית אתא,1552,716,836,135,1417,840,1509,52,5%
2015-06,חיפה,9500,קריית ביאליק,1013,424,589,129,884,488,999,35,5%
2015-06,חיפה,2300,קריית טבעון,180,90,90,67,113,40,177,1,2%
2015-06,חיפה,9600,קריית ים,1477,674,803,153,1324,845,1422,43,7%
2015-06,חיפה,8200,קריית מוצקין,995,424,571,150,845,470,968,25,4%
2015-06,חיפה,922,רכסים,152,68,84,9,143,84,135,1,4%
2015-06,ירושלים,472,אבו גוש,271,137,134,5,266,190,271,5,9%
2015-06,ירושלים,2610,בית שמש,1227,559,668,86,1141,496,1182,49,4%
2015-06,ירושלים,3000,ירושלים,12223,5565,6658,1363,10860,7578,12048,150,4%
2015-06,ירושלים,1015,מבשרת ציון,365,178,187,82,283,139,359,5,3%
2015-06,ירושלים,1137,קריית יערים,34,12,22,3,31,14,34,0,3%
2015-06,תל אביב,2400,אור יהודה,729,377,352,46,683,209,706,36,4%
2015-06,תל אביב,565,אזור,170,85,85,20,150,30,170,6,3%
2015-06,תל אביב,6100,בני ברק,1904,933,971,88,1816,927,1815,31,3%
2015-06,תל אביב,6200,בת ים,2846,1338,1508,383,2463,1048,2743,88,4%
2015-06,תל אביב,6300,גבעתיים,700,307,393,303,397,89,697,4,2%
2015-06,תל אביב,6400,הרצלייה,986,409,577,358,628,35,979,47,2%
2015-06,תל אביב,6600,חולון,2910,1339,1571,441,2469,695,2852,72,3%
2015-06,תל אביב,2620,קריית אונו,361,162,199,158,203,39,359,6,2%
2015-06,תל אביב,8600,רמת גן,2018,938,1080,703,1315,409,1992,35,3%
2015-06,תל אביב,2650,רמת השרון,345,127,218,158,187,8,341,4,2%
2015-06,תל אביב,5000,תל אביב -יפו,7174,3561,3613,2336,4838,1978,7091,125,3%
2015-07,אזור יהודה והשומרון,3760,אורנית,98,43,55,35,63,4,98,0,2%
2015-07,אזור יהודה והשומרון,3750,אלפי מנשה,92,39,53,28,64,1,92,1,2%
2015-07,אזור יהודה והשומרון,3560,אלקנה,30,17,13,9,21,1,30,0,2%
2015-07,אזור יהודה והשומרון,3650,אפרת,108,62,46,40,68,4,104,2,3%
2015-07,אזור יהודה והשומרון,3570,אריאל,317,150,167,76,241,57,316,2,3%
2015-07,אזור יהודה והשומרון,3574,בית אל,66,38,28,15,51,16,66,0,3%
2015-07,אזור יהודה והשומרון,3652,בית אריה,59,22,37,15,44,2,58,1,2%
2015-07,אזור יהודה והשומרון,3780,ביתר עילית,803,328,475,15,788,306,797,5,6%
2015-07,אזור יהודה והשומרון,3730,גבעת זאב,217,93,124,48,169,44,211,1,3%
2015-07,אזור יהודה והשומרון,3769,הר אדר,35,16,19,20,15,5,35,0,2%
2015-07,אזור יהודה והשומרון,3797,מודיעין עילית,754,161,593,24,730,62,749,1,6%
2015-07,אזור יהודה והשומרון,3616,מעלה אדומים,737,299,438,95,642,176,731,21,4%
2015-07,אזור יהודה והשומרון,3660,עמנואל,81,48,33,3,78,42,81,0,7%
2015-07,אזור יהודה והשומרון,3557,קדומים,43,28,15,18,25,5,43,0,2%
2015-07,אזור יהודה והשומרון,3611,קריית ארבע,119,65,54,12,107,58,119,1,4%
2015-07,אזור יהודה והשומרון,3640,קרני שומרון,76,40,36,21,55,11,75,0,2%
2015-07,הדרום,31,אופקים,1278,519,759,61,1217,655,1246,30,10%
2015-07,הדרום,2600,אילת,1253,576,677,68,1185,490,1216,57,4%
2015-07,הדרום,70,אשדוד,6564,2655,3909,783,5781,2878,6379,186,6%
2015-07,הדרום,7100,אשקלון,4336,1771,2565,443,3893,2061,3895,116,6%
2015-07,הדרום,9000,באר שבע,6772,3001,3771,852,5920,3706,6543,166,6%
2015-07,הדרום,2200,דימונה,2070,887,1183,107,1963,1321,1998,61,11%
2015-07,הדרום,1303,חורה,750,322,428,2,748,666,744,1,19%
2015-07,הדרום,831,ירוחם,430,207,223,18,412,242,406,21,9%
2015-07,הדרום,1059,כסיפה,1006,386,620,1,1005,905,1001,4,22%
2015-07,הדרום,1271,להבים,39,22,17,18,21,4,39,0,1%
2015-07,הדרום,1060,לקיה,868,393,475,3,865,778,862,1,21%
2015-07,הדרום,1268,מיתר,77,30,47,28,49,9,76,1,2%
2015-07,הדרום,99,מצפה רמון,283,115,168,15,268,169,273,15,11%
2015-07,הדרום,246,נתיבות,1208,480,728,58,1150,501,1170,48,8%
2015-07,הדרום,666,עומר,57,16,41,23,34,4,56,0,1%
2015-07,הדרום,2560,ערד,842,360,482,88,754,409,820,50,7%
2015-07,הדרום,1192,ערערה-בנגב,1077,454,623,3,1074,994,1061,1,25%
2015-07,הדרום,2630,קריית גת,2087,854,1233,117,1970,1047,2019,60,7%
2015-07,הדרום,1034,קריית מלאכי,1081,486,595,25,1056,542,1050,74,9%
2015-07,הדרום,1161,רהט,3082,1292,1790,12,3070,2515,3046,45,16%
2015-07,הדרום,1286,שגב-שלום,529,190,339,1,528,429,522,2,20%
2015-07,הדרום,1031,שדרות,1127,506,621,55,1072,593,1076,38,8%
2015-07,הדרום,1054,תל שבע,1088,500,588,4,1084,986,1080,5,22%
2015-07,המרכז,182,אבן יהודה,154,69,85,39,115,16,153,0,2%
2015-07,המרכז,41,אליכין,83,42,41,8,75,15,82,3,4%
2015-07,המרכז,1309,אלעד,560,224,336,19,541,58,555,2,4%
2015-07,המרכז,2530,באר יעקב,233,104,129,43,190,46,230,6,3%
2015-07,המרכז,466,בית דגן,108,69,39,11,97,33,107,2,3%
2015-07,המרכז,1066,"בני עי""ש",156,68,88,25,131,66,154,1,4%
2015-07,המרכז,681,גבעת שמואל,281,135,146,94,187,56,277,1,2%
2015-07,המרכז,2550,גדרה,365,148,217,76,289,98,361,15,3%
2015-07,המרכז,627,ג'לג'וליה,101,43,58,1,100,60,99,0,3%
2015-07,המרכז,166,גן יבנה,383,144,239,67,316,77,377,4,3%
2015-07,המרכז,229,גני תקווה,208,84,124,70,138,28,207,0,2%
2015-07,המרכז,9700,הוד השרון,640,282,358,236,404,47,636,6,2%
2015-07,המרכז,1290,זמר,136,44,92,1,135,93,135,0,5%
2015-07,המרכז,2730,טייבה,1409,625,784,27,1382,1143,1266,38,7%
2015-07,המרכז,2720,טירה,253,121,132,13,240,114,247,9,2%
2015-07,המרכז,2660,יבנה,941,431,510,140,801,280,932,23,4%
2015-07,המרכז,9400,יהוד,412,197,215,60,352,60,403,5,3%
2015-07,המרכז,1224,כוכב יאיר,95,41,54,45,50,1,95,2,2%
2015-07,המרכז,633,כפר ברא,34,18,16,0,34,15,34,0,2%
2015-07,המרכז,168,כפר יונה,340,147,193,46,294,53,337,3,3%
2015-07,המרכז,6900,כפר סבא,1215,552,663,402,813,141,1201,18,2%
2015-07,המרכז,634,כפר קאסם,238,106,132,4,234,119,234,2,3%
2015-07,המרכז,7000,לוד,2040,936,1104,177,1863,1051,2003,55,6%
2015-07,המרכז,1200,מודיעין-מכבים-רעות*,974,392,582,333,641,65,966,18,2%
2015-07,המרכז,28,מזכרת בתיה,178,78,100,43,135,35,176,1,3%
2015-07,המרכז,7200,נס ציונה,654,293,361,161,493,178,648,12,3%
2015-07,המרכז,7400,נתניה,4444,1951,2493,483,3961,1377,4344,89,4%
2015-07,המרכז,587,סביון*,17,10,7,8,9,0,17,0,1%
2015-07,המרכז,171,פרדסייה,73,30,43,11,62,6,73,0,2%
2015-07,המרכז,7900,פתח תקווה,4109,1782,2327,845,3264,1011,4030,51,3%
2015-07,המרכז,195,קדימה-צורן,297,100,197,67,230,36,293,2,3%
2015-07,המרכז,638,קלנסווה,545,252,293,4,541,444,500,14,6%
2015-07,המרכז,469,קריית עקרון,282,135,147,12,270,121,276,6,5%
2015-07,המרכז,2640,ראש העין,768,351,417,74,694,145,764,27,3%
2015-07,המרכז,8300,ראשון לציון,4492,1933,2559,829,3663,1218,4457,94,3%
2015-07,המרכז,8400,רחובות,2630,1120,1510,537,2093,882,2578,50,4%
2015-07,המרכז,8500,רמלה,1786,809,977,116,1670,691,1715,56,5%
2015-07,המרכז,8700,רעננה,778,333,445,287,491,59,771,8,2%
2015-07,המרכז,1304,שוהם,191,81,110,83,108,8,190,1,2%
2015-07,המרכז,154,תל מונד,155,79,76,43,112,21,153,0,2%
2015-07,הצפון,473,אבו סנאן,641,260,381,9,632,486,630,17,11%
2015-07,הצפון,478,אכסאל,551,252,299,11,540,454,538,8,10%
2015-07,הצפון,529,אעבלין,560,225,335,12,548,460,555,14,10%
2015-07,הצפון,482,בועיינה-נוג'ידאת,388,170,218,8,380,317,375,14,10%
2015-07,הצפון,4001,בוקעאתא,380,141,239,3,377,317,360,0,13%
2015-07,הצפון,998,ביר אל-מכסור,406,155,251,3,403,318,404,0,11%
2015-07,הצפון,480,בית ג'ן,397,127,270,10,387,291,386,6,7%
2015-07,הצפון,9200,בית שאן,895,400,495,17,878,409,876,50,9%
2015-07,הצפון,944,בסמת טבעון,218,97,121,3,215,157,211,3,7%
2015-07,הצפון,483,בענה,364,149,215,10,354,297,355,10,11%
2015-07,הצפון,1292,ג'דיידה-מכר,1275,543,732,6,1269,1004,1263,34,14%
2015-07,הצפון,485,ג'ולס,208,65,143,1,207,150,206,5,7%
2015-07,הצפון,487,ג'ש (גוש חלב),70,33,37,4,66,41,67,4,4%
2015-07,הצפון,489,דבורייה,386,170,216,28,358,253,386,3,9%
2015-07,הצפון,490,דייר אל-אסד,389,165,224,11,378,300,385,3,8%
2015-07,הצפון,492,דייר חנא,648,285,363,7,641,509,642,4,13%
2015-07,הצפון,975,זרזיר,283,131,152,2,281,190,275,6,9%
2015-07,הצפון,496,חורפיש,104,43,61,5,99,62,101,6,4%
2015-07,הצפון,2034,חצור הגלילית,279,123,156,14,265,128,264,11,6%
2015-07,הצפון,6700,טבריה,1683,749,934,82,1601,900,1495,59,7%
2015-07,הצפון,962,טובא-זנגרייה,381,173,208,6,375,239,374,2,12%
2015-07,הצפון,498,טורעאן,552,213,339,15,537,427,511,9,9%
2015-07,הצפון,8900,טמרה,1855,812,1043,30,1825,1535,1843,9,13%
2015-07,הצפון,1295,יאנוח-ג'ת,142,49,93,4,138,98,139,2,5%
2015-07,הצפון,46,יבנאל,110,64,46,4,106,86,81,3,5%
2015-07,הצפון,499,יפיע,630,289,341,25,605,489,614,6,8%
2015-07,הצפון,240,יקנעם עילית,498,194,304,70,428,129,489,29,4%
2015-07,הצפון,502,ירכא,578,245,333,0,578,430,572,9,10%
2015-07,הצפון,504,כאבול,642,274,368,10,632,542,639,4,13%
2015-07,הצפון,505,כאוכב אבו אל-היג'א,224,88,136,8,216,192,217,2,13%
2015-07,הצפון,1296,כסרא-סמיע,227,90,137,9,218,144,224,2,7%
2015-07,הצפון,978,כעביה-טבאש-חג'אג'רה,191,77,114,4,187,126,188,2,8%
2015-07,הצפון,1263,כפר ורדים,60,24,36,30,30,7,60,0,2%
2015-07,הצפון,507,כפר יאסיף,419,184,235,3,416,304,414,11,8%
2015-07,הצפון,508,כפר כמא,55,25,30,3,52,24,53,1,3%
2015-07,הצפון,509,כפר כנא,1169,509,660,27,1142,955,1090,18,12%
2015-07,הצפון,510,כפר מנדא,977,446,531,8,969,691,956,22,13%
2015-07,הצפון,47,כפר תבור,47,14,33,20,27,1,47,0,2%
2015-07,הצפון,1139,כרמיאל,1507,622,885,255,1252,760,1444,51,6%
2015-07,הצפון,481,מגאר,1475,595,880,21,1454,1246,1450,23,16%
2015-07,הצפון,516,מג'ד אל-כרום,553,238,315,11,542,381,542,20,8%
2015-07,הצפון,874,מגדל העמק,953,417,536,84,869,372,898,73,7%
2015-07,הצפון,4201,מג'דל שמס,458,170,288,12,446,353,438,7,9%
2015-07,הצפון,517,מזרעה,170,69,101,1,169,128,165,6,8%
2015-07,הצפון,4203,מסעדה,203,78,125,4,199,158,197,0,12%
2015-07,הצפון,518,מעיליא,43,27,16,11,32,17,43,1,3%
2015-07,הצפון,1063,מעלות-תרשיחא,830,387,443,105,725,432,813,32,7%
2015-07,הצפון,520,משהד,283,112,171,5,278,222,271,5,9%
2015-07,הצפון,9100,נהרייה,1828,845,983,204,1624,995,1766,68,6%
2015-07,הצפון,522,נחף,403,191,212,15,388,319,394,9,8%
2015-07,הצפון,7300,נצרת,3284,1465,1819,121,3163,2516,3216,14,9%
2015-07,הצפון,1061,נצרת עילית,1772,763,1009,151,1621,891,1602,92,7%
2015-07,הצפון,525,סאג'ור,109,37,72,4,105,70,108,0,6%
2015-07,הצפון,7500,סח'נין,2196,924,1272,26,2170,1840,2181,8,16%
2015-07,הצפון,4501,ע'ג'ר,110,42,68,0,110,64,109,1,10%
2015-07,הצפון,530,עיילבון,166,64,102,5,161,114,164,0,6%
2015-07,הצפון,511,עילוט,347,139,208,6,341,261,344,0,12%
2015-07,הצפון,532,עין מאהל,498,243,255,11,487,407,480,1,9%
2015-07,הצפון,7600,עכו,3174,1405,1769,117,3057,2251,3096,84,12%
2015-07,הצפון,7700,עפולה,1723,727,996,171,1552,694,1679,70,7%
2015-07,הצפון,531,עראבה,1599,669,930,30,1569,1367,1582,4,16%
2015-07,הצפון,535,פסוטה,121,48,73,6,115,65,120,0,7%
2015-07,הצפון,536,פקיעין (בוקייעה),132,75,57,9,123,77,127,2,5%
2015-07,הצפון,8000,צפת,1447,761,686,87,1360,979,1381,32,10%
2015-07,הצפון,4100,קצרין,197,87,110,33,164,83,193,1,5%
2015-07,הצפון,2800,קריית שמונה,741,346,395,57,684,309,720,22,6%
2015-07,הצפון,543,ראמה,288,121,167,14,274,204,283,5,7%
2015-07,הצפון,26,ראש פינה,40,16,24,7,33,14,40,0,3%
2015-07,הצפון,542,ריינה,655,273,382,17,638,500,635,11,9%
2015-07,הצפון,122,רמת ישי,116,52,64,41,75,15,114,1,3%
2015-07,הצפון,913,שבלי - אום אל-גנם,221,105,116,6,215,147,217,3,8%
2015-07,הצפון,812,שלומי,211,89,122,10,201,97,205,8,6%
2015-07,הצפון,538,שעב,551,226,325,4,547,482,543,0,18%
2015-07,הצפון,8800,שפרעם,1915,752,1163,26,1889,1516,1895,39,11%
2015-07,חיפה,2710,אום אל-פחם,3579,1477,2102,30,3549,2985,3514,29,17%
2015-07,חיפה,1020,אור עקיבא,531,238,293,42,489,183,516,22,5%
2015-07,חיפה,6000,באקה אל-גרביה,631,290,341,14,617,354,625,12,5%
2015-07,חיפה,9800,בנימינה-גבעת עדה*,177,86,91,45,132,60,177,3,3%
2015-07,חיפה,1326,"בסמ""ה",417,189,228,3,414,312,410,5,10%
2015-07,חיפה,541,ג'סר א-זרקא,493,243,250,5,488,314,487,8,8%
2015-07,חיפה,628,ג'ת,211,105,106,7,204,119,209,2,4%
2015-07,חיפה,494,דאלית אל-כרמל,488,189,299,10,478,269,464,6,6%
2015-07,חיפה,9300,זכרון יעקב,260,118,142,87,173,46,259,1,2%
2015-07,חיפה,6500,חדרה,2363,984,1379,296,2067,816,2237,65,5%
2015-07,חיפה,4000,חיפה,6267,3014,3253,1199,5068,3174,5965,160,4%
2015-07,חיפה,1247,חריש,44,30,14,6,38,18,44,1,3%
2015-07,חיפה,2100,טירת כרמל,733,360,373,35,698,408,716,20,7%
2015-07,חיפה,654,כפר קרע,399,176,223,13,386,238,395,4,5%
2015-07,חיפה,1327,מעלה עירון,890,340,550,5,885,724,879,4,15%
2015-07,חיפה,2500,נשר,462,241,221,88,374,179,454,15,4%
2015-07,חיפה,534,עספיא,322,150,172,13,309,155,310,6,6%
2015-07,חיפה,637,ערערה,579,250,329,5,574,360,570,8,7%
2015-07,חיפה,537,פוריידיס,417,194,223,11,406,255,413,1,7%
2015-07,חיפה,7800,פרדס חנה-כרכור,851,388,463,141,710,255,837,26,4%
2015-07,חיפה,6800,קריית אתא,1665,724,941,134,1531,829,1624,43,5%
2015-07,חיפה,9500,קריית ביאליק,1028,416,612,124,904,487,1006,23,5%
2015-07,חיפה,2300,קריית טבעון,171,81,90,69,102,34,170,0,2%
2015-07,חיפה,9600,קריית ים,1466,683,783,149,1317,820,1419,38,7%
2015-07,חיפה,8200,קריית מוצקין,1001,425,576,145,856,436,977,26,4%
2015-07,חיפה,922,רכסים,232,72,160,11,221,86,216,1,6%
2015-07,ירושלים,472,אבו גוש,278,147,131,7,271,189,276,2,9%
2015-07,ירושלים,2610,בית שמש,1566,643,923,105,1461,511,1517,27,5%
2015-07,ירושלים,3000,ירושלים,13075,5627,7448,1415,11660,7568,12828,138,4%
2015-07,ירושלים,1015,מבשרת ציון,384,184,200,82,302,142,379,7,3%
2015-07,ירושלים,1137,קריית יערים,45,15,30,5,40,14,45,0,3%
2015-07,תל אביב,2400,אור יהודה,807,369,438,45,762,191,783,38,4%
2015-07,תל אביב,565,אזור,183,85,98,20,163,31,181,5,3%
2015-07,תל אביב,6100,בני ברק,2572,969,1603,94,2478,929,2481,33,4%
2015-07,תל אביב,6200,בת ים,2998,1364,1634,409,2589,1031,2873,91,4%
2015-07,תל אביב,6300,גבעתיים,747,313,434,319,428,86,743,5,2%
2015-07,תל אביב,6400,הרצלייה,1065,447,618,368,697,37,1060,33,2%
2015-07,תל אביב,6600,חולון,3082,1373,1709,481,2601,711,3028,60,3%
2015-07,תל אביב,2620,קריית אונו,382,167,215,155,227,38,380,2,2%
2015-07,תל אביב,8600,רמת גן,2123,922,1201,692,1431,407,2098,23,3%
2015-07,תל אביב,2650,רמת השרון,368,127,241,160,208,9,365,3,2%
2015-07,תל אביב,5000,תל אביב -יפו,7221,3568,3653,2390,4831,1907,7122,117,3%
2015-08,אזור יהודה והשומרון,3760,אורנית,100,43,57,38,62,4,100,0,2%
2015-08,אזור יהודה והשומרון,3750,אלפי מנשה,92,40,52,27,65,1,91,0,2%
2015-08,אזור יהודה והשומרון,3560,אלקנה,29,16,13,12,17,1,29,0,2%
2015-08,אזור יהודה והשומרון,3650,אפרת,128,68,60,58,70,4,128,0,3%
2015-08,אזור יהודה והשומרון,3570,אריאל,334,160,174,82,252,60,332,7,3%
2015-08,אזור יהודה והשומרון,3574,בית אל,61,38,23,11,50,16,60,0,2%
2015-08,אזור יהודה והשומרון,3652,בית אריה,63,22,41,17,46,2,63,1,2%
2015-08,אזור יהודה והשומרון,3780,ביתר עילית,850,337,513,11,839,301,845,2,7%
2015-08,אזור יהודה והשומרון,3730,גבעת זאב,215,94,121,48,167,44,213,1,3%
2015-08,אזור יהודה והשומרון,3769,הר אדר,36,17,19,19,17,5,36,0,2%
2015-08,אזור יהודה והשומרון,3797,מודיעין עילית,847,163,684,18,829,64,843,5,6%
2015-08,אזור יהודה והשומרון,3616,מעלה אדומים,754,317,437,96,658,181,743,21,4%
2015-08,אזור יהודה והשומרון,3660,עמנואל,86,50,36,3,83,40,85,0,7%
2015-08,אזור יהודה והשומרון,3557,קדומים,47,29,18,21,26,6,47,0,3%
2015-08,אזור יהודה והשומרון,3611,קריית ארבע,130,67,63,15,115,60,127,3,4%
2015-08,אזור יהודה והשומרון,3640,קרני שומרון,82,44,38,19,63,8,80,2,2%
2015-08,הדרום,31,אופקים,1303,507,796,75,1228,639,1279,34,10%
2015-08,הדרום,2600,אילת,1212,527,685,74,1138,476,1171,55,4%
2015-08,הדרום,70,אשדוד,6657,2610,4047,772,5885,2851,6465,189,6%
2015-08,הדרום,7100,אשקלון,4368,1762,2606,456,3912,2057,3933,121,6%
2015-08,הדרום,9000,באר שבע,6818,2977,3841,859,5959,3649,6605,125,6%
2015-08,הדרום,2200,דימונה,2099,888,1211,111,1988,1306,2022,62,11%
2015-08,הדרום,1303,חורה,762,323,439,2,760,673,753,4,19%
2015-08,הדרום,831,ירוחם,459,211,248,21,438,238,433,28,9%
2015-08,הדרום,1059,כסיפה,1021,391,630,1,1020,917,1015,2,22%
2015-08,הדרום,1271,להבים,43,25,18,17,26,4,42,0,1%
2015-08,הדרום,1060,לקיה,859,378,481,3,856,779,850,2,21%
2015-08,הדרום,1268,מיתר,80,32,48,32,48,10,80,0,2%
2015-08,הדרום,99,מצפה רמון,279,113,166,19,260,174,272,13,11%
2015-08,הדרום,246,נתיבות,1212,482,730,59,1153,493,1178,59,8%
2015-08,הדרום,666,עומר,58,15,43,24,34,3,57,0,1%
2015-08,הדרום,2560,ערד,806,342,464,77,729,392,779,47,6%
2015-08,הדרום,1192,ערערה-בנגב,1082,452,630,3,1079,1000,1067,1,25%
2015-08,הדרום,2630,קריית גת,2023,806,1217,115,1908,1012,1968,59,7%
2015-08,הדרום,1034,קריית מלאכי,1057,450,607,29,1028,537,1024,59,9%
2015-08,הדרום,1161,רהט,3048,1317,1731,13,3035,2499,3015,46,16%
2015-08,הדרום,1286,שגב-שלום,527,186,341,1,526,428,520,3,20%
2015-08,הדרום,1031,שדרות,1129,491,638,62,1067,586,1075,33,8%
2015-08,הדרום,1054,תל שבע,1100,498,602,6,1094,989,1089,5,23%
2015-08,המרכז,182,אבן יהודה,152,71,81,38,114,18,152,0,2%
2015-08,המרכז,41,אליכין,86,46,40,7,79,15,84,4,4%
2015-08,המרכז,1309,אלעד,623,235,388,15,608,64,614,2,5%
2015-08,המרכז,2530,באר יעקב,244,105,139,41,203,45,242,6,3%
2015-08,המרכז,466,בית דגן,113,65,48,11,102,34,112,1,3%
2015-08,המרכז,1066,"בני עי""ש",175,75,100,25,150,66,172,3,4%
2015-08,המרכז,681,גבעת שמואל,270,136,134,91,179,51,265,2,2%
2015-08,המרכז,2550,גדרה,352,144,208,79,273,96,348,3,3%
2015-08,המרכז,627,ג'לג'וליה,105,46,59,2,103,60,104,1,3%
2015-08,המרכז,166,גן יבנה,398,145,253,64,334,77,393,16,3%
2015-08,המרכז,229,גני תקווה,236,87,149,80,156,29,234,0,3%
2015-08,המרכז,9700,הוד השרון,685,279,406,232,453,54,679,8,2%
2015-08,המרכז,1290,זמר,157,47,110,3,154,96,156,2,5%
2015-08,המרכז,2730,טייבה,1395,601,794,26,1369,1110,1230,37,7%
2015-08,המרכז,2720,טירה,280,118,162,18,262,113,273,6,2%
2015-08,המרכז,2660,יבנה,959,422,537,140,819,271,949,29,4%
2015-08,המרכז,9400,יהוד,431,204,227,70,361,56,421,9,3%
2015-08,המרכז,1224,כוכב יאיר,90,41,49,42,48,1,90,0,2%
2015-08,המרכז,633,כפר ברא,41,25,16,0,41,15,40,0,3%
2015-08,המרכז,168,כפר יונה,341,143,198,47,294,58,339,2,3%
2015-08,המרכז,6900,כפר סבא,1240,535,705,409,831,129,1225,27,2%
2015-08,המרכז,634,כפר קאסם,257,114,143,9,248,127,249,7,3%
2015-08,המרכז,7000,לוד,2120,960,1160,168,1952,1051,2088,46,6%
2015-08,המרכז,1200,מודיעין-מכבים-רעות*,998,392,606,316,682,55,989,12,2%
2015-08,המרכז,28,מזכרת בתיה,187,75,112,47,140,33,186,0,3%
2015-08,המרכז,7200,נס ציונה,695,307,388,171,524,176,689,10,3%
2015-08,המרכז,7400,נתניה,4669,1950,2719,479,4190,1386,4574,75,4%
2015-08,המרכז,587,סביון*,18,10,8,10,8,0,18,0,1%
2015-08,המרכז,171,פרדסייה,79,32,47,14,65,7,78,0,2%
2015-08,המרכז,7900,פתח תקווה,4217,1749,2468,868,3349,1026,4155,57,3%
2015-08,המרכז,195,קדימה-צורן,294,108,186,71,223,33,291,3,3%
2015-08,המרכז,638,קלנסווה,545,252,293,4,541,426,497,12,6%
2015-08,המרכז,469,קריית עקרון,296,143,153,14,282,118,291,8,5%
2015-08,המרכז,2640,ראש העין,885,380,505,92,793,160,876,19,4%
2015-08,המרכז,8300,ראשון לציון,4425,1868,2557,830,3595,1237,4393,73,3%
2015-08,המרכז,8400,רחובות,2710,1101,1609,552,2158,863,2655,60,4%
2015-08,המרכז,8500,רמלה,1811,826,985,109,1702,682,1749,66,5%
2015-08,המרכז,8700,רעננה,780,330,450,281,499,57,774,7,2%
2015-08,המרכז,1304,שוהם,195,84,111,79,116,9,195,0,2%
2015-08,המרכז,154,תל מונד,156,68,88,48,108,21,156,1,3%
2015-08,הצפון,473,אבו סנאן,617,257,360,8,609,475,610,11,11%
2015-08,הצפון,478,אכסאל,537,246,291,8,529,449,525,3,9%
2015-08,הצפון,529,אעבלין,561,222,339,12,549,462,555,11,10%
2015-08,הצפון,482,בועיינה-נוג'ידאת,354,161,193,6,348,296,338,8,9%
2015-08,הצפון,4001,בוקעאתא,379,142,237,5,374,314,362,1,13%
2015-08,הצפון,998,ביר אל-מכסור,405,155,250,3,402,319,403,1,11%
2015-08,הצפון,480,בית ג'ן,381,123,258,9,372,273,373,8,7%
2015-08,הצפון,9200,בית שאן,882,373,509,17,865,410,864,59,9%
2015-08,הצפון,944,בסמת טבעון,224,99,125,3,221,162,216,3,7%
2015-08,הצפון,483,בענה,353,147,206,9,344,286,349,8,11%
2015-08,הצפון,1292,ג'דיידה-מכר,1249,538,711,5,1244,983,1238,34,14%
2015-08,הצפון,485,ג'ולס,201,58,143,1,200,146,201,6,7%
2015-08,הצפון,487,ג'ש (גוש חלב),68,28,40,3,65,38,65,4,4%
2015-08,הצפון,489,דבורייה,398,176,222,28,370,257,397,8,9%
2015-08,הצפון,490,דייר אל-אסד,401,171,230,12,389,304,395,10,8%
2015-08,הצפון,492,דייר חנא,636,274,362,7,629,505,628,3,13%
2015-08,הצפון,975,זרזיר,279,126,153,6,273,180,274,8,9%
2015-08,הצפון,496,חורפיש,99,43,56,5,94,59,97,7,4%
2015-08,הצפון,2034,חצור הגלילית,277,107,170,16,261,131,265,6,6%
2015-08,הצפון,6700,טבריה,1664,734,930,87,1577,881,1491,54,7%
2015-08,הצפון,962,טובא-זנגרייה,377,171,206,7,370,245,369,2,12%
2015-08,הצפון,498,טורעאן,541,200,341,15,526,418,507,11,9%
2015-08,הצפון,8900,טמרה,1830,811,1019,30,1800,1519,1816,14,13%
2015-08,הצפון,1295,יאנוח-ג'ת,142,55,87,2,140,92,140,3,5%
2015-08,הצפון,46,יבנאל,119,71,48,4,115,79,94,1,6%
2015-08,הצפון,499,יפיע,629,293,336,24,605,474,614,6,8%
2015-08,הצפון,240,יקנעם עילית,520,200,320,79,441,131,507,30,4%
2015-08,הצפון,502,ירכא,567,239,328,1,566,420,560,13,10%
2015-08,הצפון,504,כאבול,642,278,364,6,636,545,638,7,13%
2015-08,הצפון,505,כאוכב אבו אל-היג'א,218,87,131,6,212,189,214,0,12%
2015-08,הצפון,1296,כסרא-סמיע,215,78,137,6,209,139,210,3,6%
2015-08,הצפון,978,כעביה-טבאש-חג'אג'רה,189,80,109,5,184,128,183,6,8%
2015-08,הצפון,1263,כפר ורדים,61,27,34,27,34,8,61,1,2%
2015-08,הצפון,507,כפר יאסיף,408,182,226,3,405,292,401,9,8%
2015-08,הצפון,508,כפר כמא,63,30,33,3,60,28,62,2,4%
2015-08,הצפון,509,כפר כנא,1162,491,671,27,1135,953,1079,20,12%
2015-08,הצפון,510,כפר מנדא,958,429,529,7,951,681,936,11,13%
2015-08,הצפון,47,כפר תבור,50,12,38,22,28,1,50,0,2%
2015-08,הצפון,1139,כרמיאל,1524,621,903,267,1257,740,1453,51,6%
2015-08,הצפון,481,מגאר,1395,560,835,25,1370,1187,1375,11,15%
2015-08,הצפון,516,מג'ד אל-כרום,550,227,323,11,539,371,538,14,8%
2015-08,הצפון,874,מגדל העמק,953,405,548,86,867,367,895,77,7%
2015-08,הצפון,4201,מג'דל שמס,450,165,285,11,439,349,433,6,9%
2015-08,הצפון,517,מזרעה,171,69,102,0,171,129,164,2,8%
2015-08,הצפון,4203,מסעדה,201,79,122,5,196,162,195,3,12%
2015-08,הצפון,518,מעיליא,47,23,24,12,35,22,47,0,3%
2015-08,הצפון,1063,מעלות-תרשיחא,856,373,483,110,746,452,839,33,7%
2015-08,הצפון,520,משהד,281,110,171,3,278,227,270,5,8%
2015-08,הצפון,9100,נהרייה,1833,843,990,196,1637,1003,1760,71,6%
2015-08,הצפון,522,נחף,395,188,207,11,384,315,388,8,8%
2015-08,הצפון,7300,נצרת,3292,1446,1846,112,3180,2537,3212,16,9%
2015-08,הצפון,1061,נצרת עילית,1801,775,1026,168,1633,884,1631,98,7%
2015-08,הצפון,525,סאג'ור,98,34,64,5,93,68,97,2,6%
2015-08,הצפון,7500,סח'נין,2183,932,1251,29,2154,1831,2163,5,15%
2015-08,הצפון,4501,ע'ג'ר,107,42,65,1,106,64,106,0,10%
2015-08,הצפון,530,עיילבון,162,66,96,7,155,108,161,3,6%
2015-08,הצפון,511,עילוט,357,144,213,6,351,274,352,0,12%
2015-08,הצפון,532,עין מאהל,504,243,261,8,496,414,484,3,9%
2015-08,הצפון,7600,עכו,3183,1403,1780,122,3061,2243,3114,77,12%
2015-08,הצפון,7700,עפולה,1730,712,1018,163,1567,693,1681,101,7%
2015-08,הצפון,531,עראבה,1609,674,935,32,1577,1390,1587,11,16%
2015-08,הצפון,535,פסוטה,118,44,74,8,110,66,118,0,7%
2015-08,הצפון,536,פקיעין (בוקייעה),130,72,58,8,122,79,125,4,5%
2015-08,הצפון,8000,צפת,1496,780,716,84,1412,978,1424,30,11%
2015-08,הצפון,4100,קצרין,207,94,113,31,176,91,206,3,5%
2015-08,הצפון,2800,קריית שמונה,744,333,411,62,682,301,717,35,6%
2015-08,הצפון,543,ראמה,288,120,168,15,273,207,283,1,7%
2015-08,הצפון,26,ראש פינה,45,14,31,8,37,16,45,2,3%
2015-08,הצפון,542,ריינה,645,268,377,14,631,498,615,7,9%
2015-08,הצפון,122,רמת ישי,104,47,57,35,69,17,102,1,2%
2015-08,הצפון,913,שבלי - אום אל-גנם,234,105,129,7,227,145,229,6,9%
2015-08,הצפון,812,שלומי,222,94,128,9,213,98,216,3,6%
2015-08,הצפון,538,שעב,545,220,325,3,542,474,540,1,18%
2015-08,הצפון,8800,שפרעם,1893,739,1154,31,1862,1515,1872,17,11%
2015-08,חיפה,2710,אום אל-פחם,3591,1491,2100,32,3559,2981,3525,23,17%
2015-08,חיפה,1020,אור עקיבא,536,244,292,40,496,177,514,23,5%
2015-08,חיפה,6000,באקה אל-גרביה,650,303,347,15,635,353,644,20,6%
2015-08,חיפה,9800,בנימינה-גבעת עדה*,185,91,94,48,137,62,185,0,3%
2015-08,חיפה,1326,"בסמ""ה",416,185,231,3,413,313,411,5,10%
2015-08,חיפה,541,ג'סר א-זרקא,482,244,238,3,479,316,480,3,8%
2015-08,חיפה,628,ג'ת,215,106,109,6,209,126,214,2,4%
2015-08,חיפה,494,דאלית אל-כרמל,471,188,283,10,461,260,455,6,6%
2015-08,חיפה,9300,זכרון יעקב,256,120,136,80,176,46,255,1,2%
2015-08,חיפה,6500,חדרה,2438,982,1456,305,2133,824,2299,65,5%
2015-08,חיפה,4000,חיפה,6254,2960,3294,1175,5079,3144,5958,130,4%
2015-08,חיפה,1247,חריש,50,32,18,10,40,14,48,2,3%
2015-08,חיפה,2100,טירת כרמל,728,347,381,35,693,390,714,21,7%
2015-08,חיפה,654,כפר קרע,410,183,227,11,399,242,407,10,5%
2015-08,חיפה,1327,מעלה עירון,887,327,560,6,881,731,872,3,15%
2015-08,חיפה,2500,נשר,457,231,226,93,364,174,448,9,4%
2015-08,חיפה,534,עספיא,318,143,175,9,309,169,299,6,5%
2015-08,חיפה,637,ערערה,587,254,333,7,580,360,579,10,7%
2015-08,חיפה,537,פוריידיס,429,198,231,11,418,257,426,2,8%
2015-08,חיפה,7800,פרדס חנה-כרכור,796,347,449,144,652,243,784,16,4%
2015-08,חיפה,6800,קריית אתא,1705,720,985,125,1580,831,1665,63,6%
2015-08,חיפה,9500,קריית ביאליק,1019,416,603,131,888,484,1001,31,5%
2015-08,חיפה,2300,קריית טבעון,175,75,100,79,96,34,173,1,2%
2015-08,חיפה,9600,קריית ים,1474,682,792,140,1334,802,1436,43,7%
2015-08,חיפה,8200,קריית מוצקין,1026,437,589,145,881,446,1001,29,4%
2015-08,חיפה,922,רכסים,246,81,165,14,232,82,229,2,7%
2015-08,ירושלים,472,אבו גוש,280,145,135,8,272,185,277,4,9%
2015-08,ירושלים,2610,בית שמש,1612,625,987,106,1506,508,1572,33,5%
2015-08,ירושלים,3000,ירושלים,13556,5762,7794,1428,12128,7639,13278,131,4%
2015-08,ירושלים,1015,מבשרת ציון,398,189,209,80,318,141,390,6,3%
2015-08,ירושלים,1137,קריית יערים,50,17,33,9,41,15,50,0,4%
2015-08,תל אביב,2400,אור יהודה,868,368,500,49,819,195,834,39,4%
2015-08,תל אביב,565,אזור,178,80,98,19,159,27,178,2,3%
2015-08,תל אביב,6100,בני ברק,2790,958,1832,95,2695,893,2705,20,5%
2015-08,תל אביב,6200,בת ים,2975,1348,1627,411,2564,1011,2858,84,4%
2015-08,תל אביב,6300,גבעתיים,752,317,435,321,431,85,750,7,2%
2015-08,תל אביב,6400,הרצלייה,1157,456,701,364,793,41,1153,30,2%
2015-08,תל אביב,6600,חולון,3062,1356,1706,477,2585,688,2993,58,3%
2015-08,תל אביב,2620,קריית אונו,406,166,240,162,244,36,403,1,2%
2015-08,תל אביב,8600,רמת גן,2125,918,1207,671,1454,391,2091,22,3%
2015-08,תל אביב,2650,רמת השרון,397,125,272,169,228,8,396,6,2%
2015-08,תל אביב,5000,תל אביב -יפו,7255,3563,3692,2392,4863,1894,7131,104,3%
2015-09,אזור יהודה והשומרון,3760,אורנית,103,48,55,40,63,4,103,0,2%
2015-09,אזור יהודה והשומרון,3750,אלפי מנשה,78,37,41,24,54,0,78,1,2%
2015-09,אזור יהודה והשומרון,3560,אלקנה,30,14,16,13,17,1,30,0,2%
2015-09,אזור יהודה והשומרון,3650,אפרת,112,56,56,56,56,4,112,1,3%
2015-09,אזור יהודה והשומרון,3570,אריאל,313,142,171,82,231,52,313,4,3%
2015-09,אזור יהודה והשומרון,3574,בית אל,55,36,19,10,45,13,54,1,2%
2015-09,אזור יהודה והשומרון,3652,בית אריה,56,19,37,14,42,2,56,0,2%
2015-09,אזור יהודה והשומרון,3780,ביתר עילית,621,278,343,11,610,270,618,2,5%
2015-09,אזור יהודה והשומרון,3730,גבעת זאב,194,95,99,35,159,39,192,1,3%
2015-09,אזור יהודה והשומרון,3769,הר אדר,28,11,17,17,11,2,28,0,1%
2015-09,אזור יהודה והשומרון,3797,מודיעין עילית,430,127,303,13,417,41,430,4,3%
2015-09,אזור יהודה והשומרון,3616,מעלה אדומים,644,288,356,96,548,170,635,11,3%
2015-09,אזור יהודה והשומרון,3660,עמנואל,70,38,32,2,68,37,70,3,6%
2015-09,אזור יהודה והשומרון,3557,קדומים,42,28,14,14,28,6,41,0,2%
2015-09,אזור יהודה והשומרון,3611,קריית ארבע,114,55,59,10,104,55,114,3,4%
2015-09,אזור יהודה והשומרון,3640,קרני שומרון,75,42,33,17,58,7,74,0,2%
2015-09,הדרום,31,אופקים,1111,443,668,55,1056,619,1086,15,9%
2015-09,הדרום,2600,אילת,1103,490,613,56,1047,467,1069,30,3%
2015-09,הדרום,70,אשדוד,5575,2292,3283,691,4884,2710,5393,124,5%
2015-09,הדרום,7100,אשקלון,3923,1579,2344,419,3504,1973,3490,78,5%
2015-09,הדרום,9000,באר שבע,6184,2718,3466,807,5377,3451,5985,128,6%
2015-09,הדרום,2200,דימונה,1858,810,1048,104,1754,1224,1799,43,10%
2015-09,הדרום,1303,חורה,715,298,417,1,714,639,708,3,18%
2015-09,הדרום,831,ירוחם,402,199,203,18,384,215,388,17,9%
2015-09,הדרום,1059,כסיפה,969,367,602,0,969,896,961,1,21%
2015-09,הדרום,1271,להבים,48,25,23,18,30,5,47,1,1%
2015-09,הדרום,1060,לקיה,792,343,449,3,789,736,787,1,19%
2015-09,הדרום,1268,מיתר,68,27,41,28,40,7,67,1,2%
2015-09,הדרום,99,מצפה רמון,270,109,161,22,248,167,261,9,11%
2015-09,הדרום,246,נתיבות,1038,429,609,49,989,482,995,50,7%
2015-09,הדרום,666,עומר,58,15,43,28,30,3,58,0,1%
2015-09,הדרום,2560,ערד,708,303,405,71,637,382,688,25,6%
2015-09,הדרום,1192,ערערה-בנגב,1059,434,625,3,1056,988,1049,0,25%
2015-09,הדרום,2630,קריית גת,1817,722,1095,112,1705,973,1766,36,6%
2015-09,הדרום,1034,קריית מלאכי,952,388,564,26,926,511,918,42,8%
2015-09,הדרום,1161,רהט,2772,1170,1602,11,2761,2368,2750,69,15%
2015-09,הדרום,1286,שגב-שלום,491,176,315,0,491,407,485,1,19%
2015-09,הדרום,1031,שדרות,1034,437,597,59,975,571,974,26,8%
2015-09,הדרום,1054,תל שבע,1025,458,567,6,1019,943,1013,10,21%
2015-09,המרכז,182,אבן יהודה,137,68,69,40,97,16,137,1,2%
2015-09,המרכז,41,אליכין,72,40,32,8,64,17,70,0,4%
2015-09,המרכז,1309,אלעד,412,179,233,15,397,52,406,3,3%
2015-09,המרכז,2530,באר יעקב,206,85,121,39,167,39,204,2,2%
2015-09,המרכז,466,בית דגן,92,53,39,10,82,34,90,3,3%
2015-09,המרכז,1066,"בני עי""ש",161,74,87,28,133,62,157,3,4%
2015-09,המרכז,681,גבעת שמואל,246,117,129,79,167,48,240,0,2%
2015-09,המרכז,2550,גדרה,327,130,197,77,250,86,320,3,3%
2015-09,המרכז,627,ג'לג'וליה,88,37,51,1,87,57,86,0,2%
2015-09,המרכז,166,גן יבנה,343,129,214,61,282,72,334,4,3%
2015-09,המרכז,229,גני תקווה,203,83,120,70,133,24,203,0,2%
2015-09,המרכז,9700,הוד השרון,582,242,340,222,360,50,576,6,2%
2015-09,המרכז,1290,זמר,139,39,100,2,137,98,138,2,5%
2015-09,המרכז,2730,טייבה,1337,574,763,21,1316,1078,1201,19,7%
2015-09,המרכז,2720,טירה,229,103,126,15,214,100,222,10,2%
2015-09,המרכז,2660,יבנה,811,363,448,139,672,258,806,28,3%
2015-09,המרכז,9400,יהוד,369,172,197,72,297,49,364,3,2%
2015-09,המרכז,1224,כוכב יאיר,76,39,37,40,36,1,76,0,1%
2015-09,המרכז,633,כפר ברא,34,18,16,0,34,15,33,0,2%
2015-09,המרכז,168,כפר יונה,300,127,173,41,259,45,299,2,3%
2015-09,המרכז,6900,כפר סבא,1080,494,586,367,713,129,1065,18,2%
2015-09,המרכז,634,כפר קאסם,203,95,108,6,197,112,200,2,2%
2015-09,המרכז,7000,לוד,1860,847,1013,155,1705,991,1837,30,5%
2015-09,המרכז,1200,מודיעין-מכבים-רעות*,852,338,514,314,538,63,846,6,2%
2015-09,המרכז,28,מזכרת בתיה,161,66,95,44,117,30,161,4,2%
2015-09,המרכז,7200,נס ציונה,600,267,333,159,441,170,596,4,3%
2015-09,המרכז,7400,נתניה,4080,1785,2295,393,3687,1315,4002,43,4%
2015-09,המרכז,587,סביון*,14,7,7,8,6,0,14,0,1%
2015-09,המרכז,171,פרדסייה,71,30,41,12,59,6,71,0,2%
2015-09,המרכז,7900,פתח תקווה,3724,1609,2115,781,2943,1002,3653,27,3%
2015-09,המרכז,195,קדימה-צורן,263,102,161,58,205,34,261,0,2%
2015-09,המרכז,638,קלנסווה,524,239,285,5,519,406,484,8,6%
2015-09,המרכז,469,קריית עקרון,248,130,118,15,233,110,244,5,4%
2015-09,המרכז,2640,ראש העין,687,319,368,87,600,139,684,14,3%
2015-09,המרכז,8300,ראשון לציון,4063,1721,2342,752,3311,1170,4036,56,3%
2015-09,המרכז,8400,רחובות,2263,998,1265,505,1758,810,2223,46,3%
2015-09,המרכז,8500,רמלה,1543,686,857,100,1443,626,1491,55,4%
2015-09,המרכז,8700,רעננה,694,308,386,263,431,61,682,5,2%
2015-09,המרכז,1304,שוהם,185,89,96,84,101,10,185,0,2%
2015-09,המרכז,154,תל מונד,140,63,77,41,99,21,139,0,2%
2015-09,הצפון,473,אבו סנאן,581,241,340,8,573,457,576,4,10%
2015-09,הצפון,478,אכסאל,511,225,286,6,505,444,501,0,9%
2015-09,הצפון,529,אעבלין,536,207,329,8,528,451,528,8,10%
2015-09,הצפון,482,בועיינה-נוג'ידאת,335,150,185,6,329,283,324,2,9%
2015-09,הצפון,4001,בוקעאתא,362,131,231,6,356,307,349,1,13%
2015-09,הצפון,998,ביר אל-מכסור,402,151,251,3,399,320,400,1,11%
2015-09,הצפון,480,בית ג'ן,348,102,246,11,337,261,340,1,7%
2015-09,הצפון,9200,בית שאן,797,343,453,21,776,400,778,43,8%
2015-09,הצפון,944,בסמת טבעון,196,86,110,2,194,147,190,2,6%
2015-09,הצפון,483,בענה,328,143,185,6,322,284,325,6,10%
2015-09,הצפון,1292,ג'דיידה-מכר,1182,524,658,6,1176,968,1170,21,13%
2015-09,הצפון,485,ג'ולס,193,48,145,0,193,139,191,5,7%
2015-09,הצפון,487,ג'ש (גוש חלב),66,29,37,4,62,36,64,0,4%
2015-09,הצפון,489,דבורייה,357,156,201,22,335,254,357,0,8%
2015-09,הצפון,490,דייר אל-אסד,346,152,194,9,337,283,346,4,7%
2015-09,הצפון,492,דייר חנא,625,270,355,6,619,508,615,0,13%
2015-09,הצפון,975,זרזיר,246,107,139,6,240,175,240,5,8%
2015-09,הצפון,496,חורפיש,89,37,52,3,86,59,87,2,3%
2015-09,הצפון,2034,חצור הגלילית,262,102,160,14,248,133,248,6,5%
2015-09,הצפון,6700,טבריה,1557,695,862,88,1469,889,1377,43,6%
2015-09,הצפון,962,טובא-זנגרייה,350,158,192,6,344,235,342,0,11%
2015-09,הצפון,498,טורעאן,480,183,297,10,470,392,462,0,8%
2015-09,הצפון,8900,טמרה,1741,772,969,31,1710,1483,1720,30,12%
2015-09,הצפון,1295,יאנוח-ג'ת,128,44,84,3,125,87,127,0,5%
2015-09,הצפון,46,יבנאל,102,63,39,5,97,77,81,1,5%
2015-09,הצפון,499,יפיע,592,262,330,30,562,457,580,4,8%
2015-09,הצפון,240,יקנעם עילית,444,169,275,80,364,127,435,18,4%
2015-09,הצפון,502,ירכא,527,224,303,1,526,401,522,9,9%
2015-09,הצפון,504,כאבול,622,266,356,10,612,533,616,10,13%
2015-09,הצפון,505,כאוכב אבו אל-היג'א,215,83,132,5,210,186,210,0,12%
2015-09,הצפון,1296,כסרא-סמיע,180,67,113,4,176,124,177,4,5%
2015-09,הצפון,978,כעביה-טבאש-חג'אג'רה,184,70,114,5,179,130,178,0,8%
2015-09,הצפון,1263,כפר ורדים,66,29,37,29,37,8,65,1,2%
2015-09,הצפון,507,כפר יאסיף,379,165,214,3,376,281,373,7,7%
2015-09,הצפון,508,כפר כמא,56,25,31,6,50,25,56,1,3%
2015-09,הצפון,509,כפר כנא,1077,458,619,26,1051,916,1000,12,11%
2015-09,הצפון,510,כפר מנדא,918,426,492,6,912,671,882,1,12%
2015-09,הצפון,47,כפר תבור,43,12,31,19,24,2,43,0,2%
2015-09,הצפון,1139,כרמיאל,1415,571,844,259,1156,712,1362,24,5%
2015-09,הצפון,481,מגאר,1316,527,789,20,1296,1142,1293,1,14%
2015-09,הצפון,516,מג'ד אל-כרום,491,217,274,12,479,369,481,5,8%
2015-09,הצפון,874,מגדל העמק,818,341,477,79,739,313,773,51,6%
2015-09,הצפון,4201,מג'דל שמס,448,162,286,11,437,351,428,3,9%
2015-09,הצפון,517,מזרעה,156,67,89,0,156,119,151,5,8%
2015-09,הצפון,4203,מסעדה,196,70,126,6,190,166,190,0,11%
2015-09,הצפון,518,מעיליא,42,24,18,11,31,17,42,0,3%
2015-09,הצפון,1063,מעלות-תרשיחא,771,334,437,99,672,414,756,27,6%
2015-09,הצפון,520,משהד,256,106,150,4,252,211,243,1,8%
2015-09,הצפון,9100,נהרייה,1730,787,943,185,1545,984,1668,54,5%
2015-09,הצפון,522,נחף,368,169,199,15,353,306,361,6,7%
2015-09,הצפון,7300,נצרת,3151,1369,1782,108,3043,2451,3079,12,9%
2015-09,הצפון,1061,נצרת עילית,1664,714,950,148,1516,848,1503,74,6%
2015-09,הצפון,525,סאג'ור,93,35,58,4,89,67,91,1,5%
2015-09,הצפון,7500,סח'נין,2145,914,1231,28,2117,1832,2112,1,15%
2015-09,הצפון,4501,ע'ג'ר,87,31,56,1,86,60,87,0,9%
2015-09,הצפון,530,עיילבון,161,64,97,9,152,112,161,0,6%
2015-09,הצפון,511,עילוט,326,136,190,6,320,260,322,2,11%
2015-09,הצפון,532,עין מאהל,468,222,246,9,459,379,457,0,9%
2015-09,הצפון,7600,עכו,2886,1289,1597,117,2769,2139,2824,48,11%
2015-09,הצפון,7700,עפולה,1532,621,911,156,1376,671,1486,50,6%
2015-09,הצפון,531,עראבה,1572,667,905,34,1538,1381,1550,1,15%
2015-09,הצפון,535,פסוטה,101,37,64,7,94,63,100,0,6%
2015-09,הצפון,536,פקיעין (בוקייעה),100,54,46,4,96,66,98,1,4%
2015-09,הצפון,8000,צפת,1314,700,614,76,1238,931,1242,33,9%
2015-09,הצפון,4100,קצרין,191,81,110,29,162,84,188,2,5%
2015-09,הצפון,2800,קריית שמונה,684,310,374,65,619,309,653,19,5%
2015-09,הצפון,543,ראמה,253,104,149,11,242,190,248,3,6%
2015-09,הצפון,26,ראש פינה,43,11,32,9,34,13,41,1,3%
2015-09,הצפון,542,ריינה,590,248,342,13,577,474,562,6,8%
2015-09,הצפון,122,רמת ישי,86,33,53,28,58,14,85,1,2%
2015-09,הצפון,913,שבלי - אום אל-גנם,186,84,102,7,179,133,184,0,7%
2015-09,הצפון,812,שלומי,213,91,122,11,202,97,209,4,6%
2015-09,הצפון,538,שעב,532,216,316,4,528,466,529,1,17%
2015-09,הצפון,8800,שפרעם,1835,717,1118,31,1804,1511,1808,19,10%
2015-09,חיפה,2710,אום אל-פחם,3425,1417,2008,30,3395,2895,3369,31,16%
2015-09,חיפה,1020,אור עקיבא,475,214,261,41,434,173,451,14,5%
2015-09,חיפה,6000,באקה אל-גרביה,601,279,322,11,590,348,595,11,5%
2015-09,חיפה,9800,בנימינה-גבעת עדה*,181,87,94,47,134,60,181,1,3%
2015-09,חיפה,1326,"בסמ""ה",394,173,221,2,392,310,391,1,10%
2015-09,חיפה,541,ג'סר א-זרקא,428,222,206,2,426,289,427,5,7%
2015-09,חיפה,628,ג'ת,209,103,106,5,204,122,207,5,4%
2015-09,חיפה,494,דאלית אל-כרמל,448,165,283,13,435,256,429,4,6%
2015-09,חיפה,9300,זכרון יעקב,241,104,137,76,165,51,239,1,2%
2015-09,חיפה,6500,חדרה,2223,882,1341,294,1929,771,2090,42,4%
2015-09,חיפה,4000,חיפה,5759,2762,2997,1105,4654,2967,5512,89,4%
2015-09,חיפה,1247,חריש,50,30,20,8,42,18,46,0,3%
2015-09,חיפה,2100,טירת כרמל,679,318,361,37,642,378,666,17,6%
2015-09,חיפה,654,כפר קרע,390,171,219,7,383,236,386,0,5%
2015-09,חיפה,1327,מעלה עירון,837,305,532,6,831,704,829,3,14%
2015-09,חיפה,2500,נשר,425,205,220,88,337,160,415,8,3%
2015-09,חיפה,534,עספיא,286,116,170,12,274,154,275,3,5%
2015-09,חיפה,637,ערערה,559,232,327,8,551,344,549,4,7%
2015-09,חיפה,537,פוריידיס,404,195,209,10,394,258,400,1,7%
2015-09,חיפה,7800,פרדס חנה-כרכור,789,330,459,144,645,242,777,17,4%
2015-09,חיפה,6800,קריית אתא,1462,660,802,131,1331,795,1425,32,5%
2015-09,חיפה,9500,קריית ביאליק,953,395,558,123,830,460,937,18,4%
2015-09,חיפה,2300,קריית טבעון,160,64,96,64,96,33,158,1,2%
2015-09,חיפה,9600,קריית ים,1392,630,762,134,1258,785,1357,21,6%
2015-09,חיפה,8200,קריית מוצקין,970,410,560,139,831,438,948,14,4%
2015-09,חיפה,922,רכסים,167,68,99,14,153,77,150,1,4%
2015-09,ירושלים,472,אבו גוש,254,128,126,8,246,176,252,3,8%
2015-09,ירושלים,2610,בית שמש,1347,534,813,100,1247,469,1309,23,4%
2015-09,ירושלים,3000,ירושלים,12130,5348,6782,1287,10843,7443,11877,118,4%
2015-09,ירושלים,1015,מבשרת ציון,343,183,160,67,276,130,337,2,3%
2015-09,ירושלים,1137,קריית יערים,43,14,29,10,33,13,43,0,3%
2015-09,תל אביב,2400,אור יהודה,641,299,342,42,599,168,624,24,3%
2015-09,תל אביב,565,אזור,166,77,89,19,147,27,165,0,3%
2015-09,תל אביב,6100,בני ברק,2028,874,1154,93,1935,871,1947,10,4%
2015-09,תל אביב,6200,בת ים,2583,1185,1398,361,2222,950,2489,63,4%
2015-09,תל אביב,6300,גבעתיים,664,297,367,280,384,80,659,3,2%
2015-09,תל אביב,6400,הרצלייה,976,385,591,345,631,37,967,27,2%
2015-09,תל אביב,6600,חולון,2771,1267,1504,456,2315,650,2721,24,3%
2015-09,תל אביב,2620,קריית אונו,367,156,211,155,212,32,367,2,2%
2015-09,תל אביב,8600,רמת גן,1858,848,1010,609,1249,393,1835,21,2%
2015-09,תל אביב,2650,רמת השרון,338,107,231,153,185,9,335,4,1%
2015-09,תל אביב,5000,תל אביב -יפו,6498,3157,3341,2133,4365,1787,6401,82,3%
2015-10,אזור יהודה והשומרון,3760,אורנית,106,51,55,42,64,4,106,1,2%
2015-10,אזור יהודה והשומרון,3750,אלפי מנשה,95,44,51,29,66,2,94,0,2%
2015-10,אזור יהודה והשומרון,3560,אלקנה,40,18,22,15,25,0,40,0,2%
2015-10,אזור יהודה והשומרון,3650,אפרת,112,52,60,54,58,8,112,2,3%
2015-10,אזור יהודה והשומרון,3570,אריאל,348,145,203,86,262,52,346,11,3%
2015-10,אזור יהודה והשומרון,3574,בית אל,56,35,21,13,43,19,55,1,2%
2015-10,אזור יהודה והשומרון,3652,בית אריה,56,23,33,16,40,2,56,0,2%
2015-10,אזור יהודה והשומרון,3780,ביתר עילית,618,300,318,12,606,283,614,1,5%
2015-10,אזור יהודה והשומרון,3730,גבעת זאב,210,92,118,41,169,44,208,3,3%
2015-10,אזור יהודה והשומרון,3769,הר אדר,40,17,23,20,20,4,40,0,2%
2015-10,אזור יהודה והשומרון,3797,מודיעין עילית,399,142,257,15,384,48,397,5,3%
2015-10,אזור יהודה והשומרון,3616,מעלה אדומים,660,283,377,93,567,182,655,19,3%
2015-10,אזור יהודה והשומרון,3660,עמנואל,67,39,28,2,65,36,67,0,6%
2015-10,אזור יהודה והשומרון,3557,קדומים,40,28,12,14,26,5,40,0,2%
2015-10,אזור יהודה והשומרון,3611,קריית ארבע,118,59,59,12,106,55,118,4,4%
2015-10,אזור יהודה והשומרון,3640,קרני שומרון,75,43,32,15,60,8,74,2,2%
2015-10,הדרום,31,אופקים,1099,451,648,57,1042,610,1074,44,8%
2015-10,הדרום,2600,אילת,1221,584,637,57,1164,496,1173,51,4%
2015-10,הדרום,70,אשדוד,5864,2462,3402,734,5130,2768,5653,214,5%
2015-10,הדרום,7100,אשקלון,4107,1673,2434,428,3679,2037,3648,114,5%
2015-10,הדרום,9000,באר שבע,6393,2840,3553,827,5566,3485,6165,158,6%
2015-10,הדרום,2200,דימונה,1929,851,1078,109,1820,1235,1854,61,10%
2015-10,הדרום,1303,חורה,741,310,431,0,741,654,731,5,18%
2015-10,הדרום,831,ירוחם,415,202,213,16,399,223,399,27,9%
2015-10,הדרום,1059,כסיפה,988,381,607,0,988,916,982,16,21%
2015-10,הדרום,1271,להבים,47,25,22,16,31,5,46,1,1%
2015-10,הדרום,1060,לקיה,788,330,458,1,787,735,779,8,19%
2015-10,הדרום,1268,מיתר,74,29,45,33,41,9,74,0,2%
2015-10,הדרום,99,מצפה רמון,282,113,169,25,257,171,273,18,11%
2015-10,הדרום,246,נתיבות,1023,428,595,39,984,485,986,51,7%
2015-10,הדרום,666,עומר,65,23,42,25,40,3,64,1,2%
2015-10,הדרום,2560,ערד,748,333,415,85,663,387,723,32,6%
2015-10,הדרום,1192,ערערה-בנגב,1062,438,624,2,1060,989,1048,10,25%
2015-10,הדרום,2630,קריית גת,1944,803,1141,115,1829,993,1880,55,7%
2015-10,הדרום,1034,קריית מלאכי,1046,450,596,23,1023,512,1007,78,9%
2015-10,הדרום,1161,רהט,2788,1209,1579,7,2781,2396,2745,36,15%
2015-10,הדרום,1286,שגב-שלום,483,182,301,3,480,415,476,8,18%
2015-10,הדרום,1031,שדרות,1075,478,597,60,1015,565,1013,46,8%
2015-10,הדרום,1054,תל שבע,1024,461,563,7,1017,940,1015,23,21%
2015-10,המרכז,182,אבן יהודה,145,73,72,43,102,19,145,1,2%
2015-10,המרכז,41,אליכין,72,39,33,8,64,17,71,0,4%
2015-10,המרכז,1309,אלעד,395,175,220,16,379,53,389,3,3%
2015-10,המרכז,2530,באר יעקב,224,87,137,51,173,44,222,1,2%
2015-10,המרכז,466,בית דגן,87,53,34,10,77,34,86,2,2%
2015-10,המרכז,1066,"בני עי""ש",156,73,83,26,130,58,153,1,4%
2015-10,המרכז,681,גבעת שמואל,266,136,130,83,183,53,260,2,2%
2015-10,המרכז,2550,גדרה,333,132,201,69,264,94,326,9,3%
2015-10,המרכז,627,ג'לג'וליה,91,36,55,2,89,58,86,2,2%
2015-10,המרכז,166,גן יבנה,334,126,208,60,274,74,326,7,3%
2015-10,המרכז,229,גני תקווה,199,85,114,66,133,28,196,1,2%
2015-10,המרכז,9700,הוד השרון,634,259,375,245,389,52,623,13,2%
2015-10,המרכז,1290,זמר,144,44,100,2,142,99,143,1,5%
2015-10,המרכז,2730,טייבה,1240,555,685,17,1223,1017,1112,17,7%
2015-10,המרכז,2720,טירה,216,101,115,12,204,100,211,6,2%
2015-10,המרכז,2660,יבנה,809,397,412,126,683,256,800,39,3%
2015-10,המרכז,9400,יהוד,388,180,208,88,300,52,381,9,2%
2015-10,המרכז,1224,כוכב יאיר,76,37,39,38,38,0,76,0,1%
2015-10,המרכז,633,כפר ברא,32,19,13,0,32,11,31,0,2%
2015-10,המרכז,168,כפר יונה,318,132,186,50,268,45,317,1,3%
2015-10,המרכז,6900,כפר סבא,1183,533,650,401,782,129,1167,25,2%
2015-10,המרכז,634,כפר קאסם,204,96,108,6,198,118,199,2,2%
2015-10,המרכז,7000,לוד,1936,896,1040,152,1784,1025,1908,50,5%
2015-10,המרכז,1200,מודיעין-מכבים-רעות*,908,378,530,345,563,62,898,15,2%
2015-10,המרכז,28,מזכרת בתיה,168,71,97,48,120,29,168,0,2%
2015-10,המרכז,7200,נס ציונה,657,296,361,170,487,176,651,10,3%
2015-10,המרכז,7400,נתניה,4380,1945,2435,416,3964,1394,4281,53,4%
2015-10,המרכז,587,סביון*,16,7,9,8,8,0,16,0,1%
2015-10,המרכז,171,פרדסייה,75,37,38,14,61,7,74,0,2%
2015-10,המרכז,7900,פתח תקווה,3857,1692,2165,797,3060,1001,3784,51,3%
2015-10,המרכז,195,קדימה-צורן,274,113,161,58,216,36,272,0,3%
2015-10,המרכז,638,קלנסווה,515,234,281,5,510,399,472,9,6%
2015-10,המרכז,469,קריית עקרון,268,145,123,12,256,114,264,10,5%
2015-10,המרכז,2640,ראש העין,774,363,411,95,679,145,765,21,3%
2015-10,המרכז,8300,ראשון לציון,4252,1842,2410,792,3460,1194,4219,71,3%
2015-10,המרכז,8400,רחובות,2379,1059,1320,525,1854,819,2333,67,3%
2015-10,המרכז,8500,רמלה,1646,757,889,104,1542,673,1577,52,4%
2015-10,המרכז,8700,רעננה,711,322,389,260,451,55,706,7,2%
2015-10,המרכז,1304,שוהם,189,81,108,84,105,11,189,0,2%
2015-10,המרכז,154,תל מונד,152,70,82,40,112,21,152,0,2%
2015-10,הצפון,473,אבו סנאן,595,258,337,9,586,464,588,15,10%
2015-10,הצפון,478,אכסאל,515,227,288,8,507,448,506,2,9%
2015-10,הצפון,529,אעבלין,540,206,334,8,532,452,535,9,10%
2015-10,הצפון,482,בועיינה-נוג'ידאת,350,149,201,7,343,297,339,3,9%
2015-10,הצפון,4001,בוקעאתא,363,135,228,4,359,302,347,4,13%
2015-10,הצפון,998,ביר אל-מכסור,394,153,241,2,392,314,390,4,11%
2015-10,הצפון,480,בית ג'ן,367,114,253,8,359,271,358,0,7%
2015-10,הצפון,9200,בית שאן,849,374,475,28,821,408,833,56,8%
2015-10,הצפון,944,בסמת טבעון,204,92,112,2,202,160,193,3,6%
2015-10,הצפון,483,בענה,338,146,192,6,332,294,334,7,10%
2015-10,הצפון,1292,ג'דיידה-מכר,1212,541,671,8,1204,991,1195,27,13%
2015-10,הצפון,485,ג'ולס,196,51,145,0,196,137,194,4,7%
2015-10,הצפון,487,ג'ש (גוש חלב),62,27,35,2,60,33,60,2,4%
2015-10,הצפון,489,דבורייה,344,154,190,19,325,249,343,2,8%
2015-10,הצפון,490,דייר אל-אסד,352,147,205,8,344,293,351,9,7%
2015-10,הצפון,492,דייר חנא,628,268,360,8,620,498,619,0,13%
2015-10,הצפון,975,זרזיר,249,113,136,6,243,171,243,9,8%
2015-10,הצפון,496,חורפיש,98,39,59,10,88,59,94,0,4%
2015-10,הצפון,2034,חצור הגלילית,298,116,182,12,286,136,281,7,6%
2015-10,הצפון,6700,טבריה,1633,747,886,96,1537,913,1436,63,7%
2015-10,הצפון,962,טובא-זנגרייה,354,158,196,4,350,241,345,2,11%
2015-10,הצפון,498,טורעאן,487,197,290,11,476,386,462,5,8%
2015-10,הצפון,8900,טמרה,1680,761,919,27,1653,1432,1663,18,12%
2015-10,הצפון,1295,יאנוח-ג'ת,143,52,91,1,142,93,142,2,5%
2015-10,הצפון,46,יבנאל,112,65,47,6,106,80,90,0,6%
2015-10,הצפון,499,יפיע,606,276,330,26,580,469,590,3,8%
2015-10,הצפון,240,יקנעם עילית,465,183,282,76,389,115,458,24,4%
2015-10,הצפון,502,ירכא,542,230,312,1,541,404,537,14,9%
2015-10,הצפון,504,כאבול,616,267,349,9,607,525,612,7,13%
2015-10,הצפון,505,כאוכב אבו אל-היג'א,208,82,126,3,205,183,208,0,12%
2015-10,הצפון,1296,כסרא-סמיע,195,78,117,4,191,135,188,1,6%
2015-10,הצפון,978,כעביה-טבאש-חג'אג'רה,187,73,114,5,182,137,181,1,8%
2015-10,הצפון,1263,כפר ורדים,70,30,40,25,45,10,69,0,2%
2015-10,הצפון,507,כפר יאסיף,398,181,217,3,395,290,393,10,8%
2015-10,הצפון,508,כפר כמא,62,25,37,6,56,28,60,0,4%
2015-10,הצפון,509,כפר כנא,1074,446,628,28,1046,917,1015,25,12%
2015-10,הצפון,510,כפר מנדא,872,408,464,6,866,665,846,2,12%
2015-10,הצפון,47,כפר תבור,47,13,34,20,27,1,47,0,2%
2015-10,הצפון,1139,כרמיאל,1518,613,905,258,1260,720,1440,46,6%
2015-10,הצפון,481,מגאר,1307,524,783,20,1287,1128,1288,3,14%
2015-10,הצפון,516,מג'ד אל-כרום,510,225,285,14,496,380,504,16,8%
2015-10,הצפון,874,מגדל העמק,906,368,538,86,820,333,849,63,6%
2015-10,הצפון,4201,מג'דל שמס,455,166,289,9,446,354,424,5,9%
2015-10,הצפון,517,מזרעה,158,67,91,0,158,122,147,5,8%
2015-10,הצפון,4203,מסעדה,197,73,124,4,193,162,189,0,11%
2015-10,הצפון,518,מעיליא,46,29,17,11,35,18,45,1,3%
2015-10,הצפון,1063,מעלות-תרשיחא,874,405,469,109,765,435,857,29,7%
2015-10,הצפון,520,משהד,256,111,145,4,252,218,243,2,8%
2015-10,הצפון,9100,נהרייה,1889,868,1021,210,1679,1042,1824,78,6%
2015-10,הצפון,522,נחף,374,177,197,17,357,303,371,8,8%
2015-10,הצפון,7300,נצרת,3171,1397,1774,117,3054,2470,3102,24,9%
2015-10,הצפון,1061,נצרת עילית,1745,781,964,150,1595,865,1580,107,7%
2015-10,הצפון,525,סאג'ור,101,37,64,4,97,67,99,3,6%
2015-10,הצפון,7500,סח'נין,2149,910,1239,29,2120,1823,2126,6,15%
2015-10,הצפון,4501,ע'ג'ר,87,33,54,1,86,60,87,0,9%
2015-10,הצפון,530,עיילבון,161,66,95,8,153,109,161,0,6%
2015-10,הצפון,511,עילוט,327,135,192,5,322,261,322,3,11%
2015-10,הצפון,532,עין מאהל,477,231,246,10,467,381,466,4,9%
2015-10,הצפון,7600,עכו,3014,1347,1667,120,2894,2181,2954,65,11%
2015-10,הצפון,7700,עפולה,1637,670,967,174,1463,710,1566,104,6%
2015-10,הצפון,531,עראבה,1589,679,910,31,1558,1397,1566,3,16%
2015-10,הצפון,535,פסוטה,97,40,57,5,92,65,95,3,6%
2015-10,הצפון,536,פקיעין (בוקייעה),123,64,59,5,118,77,118,2,4%
2015-10,הצפון,8000,צפת,1374,739,635,71,1303,928,1296,24,10%
2015-10,הצפון,4100,קצרין,209,82,127,31,178,86,204,1,5%
2015-10,הצפון,2800,קריית שמונה,721,329,392,75,646,302,690,31,5%
2015-10,הצפון,543,ראמה,272,106,166,13,259,203,266,3,7%
2015-10,הצפון,26,ראש פינה,53,15,38,14,39,14,51,2,3%
2015-10,הצפון,542,ריינה,611,262,349,14,597,487,586,10,9%
2015-10,הצפון,122,רמת ישי,86,35,51,27,59,13,85,2,2%
2015-10,הצפון,913,שבלי - אום אל-גנם,202,86,116,8,194,144,199,0,8%
2015-10,הצפון,812,שלומי,227,95,132,13,214,102,221,5,6%
2015-10,הצפון,538,שעב,535,218,317,4,531,466,529,1,17%
2015-10,הצפון,8800,שפרעם,1806,727,1079,27,1779,1477,1781,21,10%
2015-10,חיפה,2710,אום אל-פחם,3470,1429,2041,35,3435,2919,3420,32,16%
2015-10,חיפה,1020,אור עקיבא,511,235,276,50,461,170,491,13,5%
2015-10,חיפה,6000,באקה אל-גרביה,636,303,333,10,626,365,632,16,5%
2015-10,חיפה,9800,בנימינה-גבעת עדה*,178,77,101,56,122,59,177,1,3%
2015-10,חיפה,1326,"בסמ""ה",397,176,221,4,393,312,394,2,10%
2015-10,חיפה,541,ג'סר א-זרקא,445,224,221,3,442,306,443,3,8%
2015-10,חיפה,628,ג'ת,217,111,106,5,212,129,217,5,4%
2015-10,חיפה,494,דאלית אל-כרמל,464,185,279,14,450,260,441,6,6%
2015-10,חיפה,9300,זכרון יעקב,259,116,143,86,173,48,257,1,2%
2015-10,חיפה,6500,חדרה,2350,972,1378,296,2054,796,2206,54,4%
2015-10,חיפה,4000,חיפה,6082,2935,3147,1158,4924,3065,5807,125,4%
2015-10,חיפה,1247,חריש,46,26,20,8,38,20,40,0,3%
2015-10,חיפה,2100,טירת כרמל,701,326,375,42,659,376,682,16,6%
2015-10,חיפה,654,כפר קרע,387,172,215,10,377,232,384,5,5%
2015-10,חיפה,1327,מעלה עירון,841,307,534,6,835,705,831,2,14%
2015-10,חיפה,2500,נשר,438,214,224,82,356,161,429,8,3%
2015-10,חיפה,534,עספיא,297,124,173,14,283,161,283,10,5%
2015-10,חיפה,637,ערערה,546,234,312,7,539,333,536,5,7%
2015-10,חיפה,537,פוריידיס,400,202,198,10,390,262,395,2,7%
2015-10,חיפה,7800,פרדס חנה-כרכור,835,362,473,158,677,234,819,25,4%
2015-10,חיפה,6800,קריית אתא,1553,713,840,132,1421,795,1515,45,5%
2015-10,חיפה,9500,קריית ביאליק,984,403,581,119,865,464,967,29,5%
2015-10,חיפה,2300,קריית טבעון,182,73,109,66,116,34,179,1,2%
2015-10,חיפה,9600,קריית ים,1461,671,790,132,1329,812,1421,32,7%
2015-10,חיפה,8200,קריית מוצקין,1009,426,583,141,868,447,977,36,4%
2015-10,חיפה,922,רכסים,168,68,100,12,156,76,153,0,4%
2015-10,ירושלים,472,אבו גוש,247,126,121,6,241,174,247,5,8%
2015-10,ירושלים,2610,בית שמש,1371,576,795,105,1266,471,1336,52,4%
2015-10,ירושלים,3000,ירושלים,12385,5548,6837,1369,11016,7546,12133,154,4%
2015-10,ירושלים,1015,מבשרת ציון,360,185,175,76,284,138,349,5,3%
2015-10,ירושלים,1137,קריית יערים,38,15,23,8,30,16,38,0,3%
2015-10,תל אביב,2400,אור יהודה,722,343,379,50,672,182,693,37,4%
2015-10,תל אביב,565,אזור,183,89,94,21,162,31,182,2,3%
2015-10,תל אביב,6100,בני ברק,2015,934,1081,92,1923,898,1923,19,3%
2015-10,תל אביב,6200,בת ים,2758,1290,1468,368,2390,996,2641,57,4%
2015-10,תל אביב,6300,גבעתיים,687,313,374,289,398,80,682,7,2%
2015-10,תל אביב,6400,הרצלייה,1047,432,615,349,698,36,1037,37,2%
2015-10,תל אביב,6600,חולון,3029,1375,1654,478,2551,686,2977,65,3%
2015-10,תל אביב,2620,קריית אונו,379,166,213,158,221,36,377,5,2%
2015-10,תל אביב,8600,רמת גן,1963,892,1071,648,1315,409,1936,28,2%
2015-10,תל אביב,2650,רמת השרון,365,137,228,176,189,9,363,3,2%
2015-10,תל אביב,5000,תל אביב -יפו,6919,3400,3519,2255,4664,1865,6824,97,3%
2015-11,אזור יהודה והשומרון,3760,אורנית,109,56,53,38,71,4,109,0,2%
2015-11,אזור יהודה והשומרון,3750,אלפי מנשה,93,42,51,28,65,0,93,3,2%
2015-11,אזור יהודה והשומרון,3560,אלקנה,39,19,20,13,26,0,39,0,2%
2015-11,אזור יהודה והשומרון,3650,אפרת,100,56,44,50,50,4,100,2,2%
2015-11,אזור יהודה והשומרון,3570,אריאל,335,159,176,87,248,47,333,14,3%
2015-11,אזור יהודה והשומרון,3574,בית אל,56,34,22,14,42,18,55,1,2%
2015-11,אזור יהודה והשומרון,3652,בית אריה,52,24,28,12,40,2,52,0,2%
2015-11,אזור יהודה והשומרון,3780,ביתר עילית,623,318,305,10,613,280,617,10,5%
2015-11,אזור יהודה והשומרון,3730,גבעת זאב,206,95,111,42,164,46,205,0,3%
2015-11,אזור יהודה והשומרון,3769,הר אדר,41,16,25,22,19,4,41,0,2%
2015-11,אזור יהודה והשומרון,3797,מודיעין עילית,356,128,228,15,341,49,348,6,3%
2015-11,אזור יהודה והשומרון,3616,מעלה אדומים,670,293,377,105,565,187,663,14,3%
2015-11,אזור יהודה והשומרון,3660,עמנואל,68,35,33,3,65,37,67,1,6%
2015-11,אזור יהודה והשומרון,3557,קדומים,36,24,12,15,21,5,36,0,2%
2015-11,אזור יהודה והשומרון,3611,קריית ארבע,124,64,60,11,113,56,124,7,4%
2015-11,אזור יהודה והשומרון,3640,קרני שומרון,81,48,33,24,57,6,80,3,2%
2015-11,הדרום,31,אופקים,1056,449,607,57,999,600,1030,42,8%
2015-11,הדרום,2600,אילת,1288,629,659,61,1227,490,1239,53,4%
2015-11,הדרום,70,אשדוד,5809,2475,3334,695,5114,2772,5590,203,5%
2015-11,הדרום,7100,אשקלון,3950,1634,2316,402,3548,2003,3485,116,5%
2015-11,הדרום,9000,באר שבע,6403,2833,3570,817,5586,3468,6158,187,6%
2015-11,הדרום,2200,דימונה,1894,859,1035,100,1794,1237,1817,43,10%
2015-11,הדרום,1303,חורה,734,298,436,2,732,648,725,7,18%
2015-11,הדרום,831,ירוחם,397,207,190,15,382,224,383,39,8%
2015-11,הדרום,1059,כסיפה,987,388,599,1,986,905,981,7,21%
2015-11,הדרום,1271,להבים,43,23,20,16,27,5,41,1,1%
2015-11,הדרום,1060,לקיה,789,340,449,1,788,735,777,11,19%
2015-11,הדרום,1268,מיתר,72,29,43,32,40,10,71,3,2%
2015-11,הדרום,99,מצפה רמון,280,117,163,21,259,175,268,15,11%
2015-11,הדרום,246,נתיבות,963,438,525,39,924,472,916,48,7%
2015-11,הדרום,666,עומר,60,19,41,27,33,3,59,0,1%
2015-11,הדרום,2560,ערד,753,346,407,95,658,385,729,44,6%
2015-11,הדרום,1192,ערערה-בנגב,1069,443,626,3,1066,991,1053,24,25%
2015-11,הדרום,2630,קריית גת,1920,824,1096,116,1804,960,1838,49,7%
2015-11,הדרום,1034,קריית מלאכי,966,435,531,19,947,487,939,70,8%
2015-11,הדרום,1161,רהט,2822,1245,1577,5,2817,2377,2784,75,15%
2015-11,הדרום,1286,שגב-שלום,473,177,296,3,470,408,468,8,18%
2015-11,הדרום,1031,שדרות,1004,452,552,53,951,561,940,31,7%
2015-11,הדרום,1054,תל שבע,1032,462,570,6,1026,938,1023,25,21%
2015-11,המרכז,182,אבן יהודה,143,73,70,35,108,19,143,0,2%
2015-11,המרכז,41,אליכין,69,40,29,8,61,18,68,0,4%
2015-11,המרכז,1309,אלעד,388,172,216,17,371,60,376,1,3%
2015-11,המרכז,2530,באר יעקב,226,92,134,52,174,45,221,1,2%
2015-11,המרכז,466,בית דגן,101,55,46,11,90,34,100,0,3%
2015-11,המרכז,1066,"בני עי""ש",163,72,91,25,138,60,160,7,4%
2015-11,המרכז,681,גבעת שמואל,260,134,126,83,177,52,255,0,2%
2015-11,המרכז,2550,גדרה,311,128,183,64,247,92,302,6,3%
2015-11,המרכז,627,ג'לג'וליה,92,33,59,2,90,61,87,1,2%
2015-11,המרכז,166,גן יבנה,322,142,180,54,268,70,311,13,3%
2015-11,המרכז,229,גני תקווה,204,83,121,70,134,25,202,0,2%
2015-11,המרכז,9700,הוד השרון,662,259,403,267,395,59,656,10,2%
2015-11,המרכז,1290,זמר,152,49,103,3,149,102,151,4,5%
2015-11,המרכז,2730,טייבה,1234,546,688,14,1220,999,1084,22,6%
2015-11,המרכז,2720,טירה,256,117,139,16,240,108,249,8,2%
2015-11,המרכז,2660,יבנה,783,395,388,114,669,247,777,39,3%
2015-11,המרכז,9400,יהוד,383,193,190,91,292,51,377,11,2%
2015-11,המרכז,1224,כוכב יאיר,85,42,43,40,45,1,85,0,2%
2015-11,המרכז,633,כפר ברא,30,17,13,0,30,11,30,2,2%
2015-11,המרכז,168,כפר יונה,303,133,170,46,257,45,302,5,3%
2015-11,המרכז,6900,כפר סבא,1226,550,676,420,806,138,1206,27,2%
2015-11,המרכז,634,כפר קאסם,218,102,116,9,209,123,211,3,2%
2015-11,המרכז,7000,לוד,2005,942,1063,150,1855,1051,1968,69,6%
2015-11,המרכז,1200,מודיעין-מכבים-רעות*,910,391,519,365,545,59,899,17,2%
2015-11,המרכז,28,מזכרת בתיה,158,74,84,44,114,27,156,4,2%
2015-11,המרכז,7200,נס ציונה,655,310,345,167,488,178,647,12,3%
2015-11,המרכז,7400,נתניה,4373,1997,2376,403,3970,1418,4280,131,4%
2015-11,המרכז,587,סביון*,14,5,9,6,8,0,14,0,1%
2015-11,המרכז,171,פרדסייה,80,35,45,11,69,7,80,0,2%
2015-11,המרכז,7900,פתח תקווה,3902,1741,2161,844,3058,1001,3833,81,3%
2015-11,המרכז,195,קדימה-צורן,255,109,146,46,209,39,252,2,2%
2015-11,המרכז,638,קלנסווה,511,229,282,3,508,382,458,12,5%
2015-11,המרכז,469,קריית עקרון,257,138,119,14,243,117,253,10,4%
2015-11,המרכז,2640,ראש העין,761,352,409,96,665,145,752,14,3%
2015-11,המרכז,8300,ראשון לציון,4244,1879,2365,782,3462,1245,4210,80,3%
2015-11,המרכז,8400,רחובות,2294,1064,1230,503,1791,786,2248,84,3%
2015-11,המרכז,8500,רמלה,1659,773,886,107,1552,688,1588,81,4%
2015-11,המרכז,8700,רעננה,721,332,389,278,443,58,714,10,2%
2015-11,המרכז,1304,שוהם,181,84,97,78,103,11,181,2,2%
2015-11,המרכז,154,תל מונד,144,70,74,38,106,19,144,1,2%
2015-11,הצפון,473,אבו סנאן,604,258,346,11,593,470,600,13,11%
2015-11,הצפון,478,אכסאל,512,233,279,10,502,446,499,5,9%
2015-11,הצפון,529,אעבלין,540,207,333,9,531,451,533,7,10%
2015-11,הצפון,482,בועיינה-נוג'ידאת,353,152,201,8,345,294,341,3,9%
2015-11,הצפון,4001,בוקעאתא,357,136,221,3,354,303,337,0,13%
2015-11,הצפון,998,ביר אל-מכסור,400,162,238,1,399,323,396,2,11%
2015-11,הצפון,480,בית ג'ן,379,130,249,7,372,267,370,5,7%
2015-11,הצפון,9200,בית שאן,823,384,439,22,801,410,806,70,8%
2015-11,הצפון,944,בסמת טבעון,198,91,107,2,196,149,192,1,6%
2015-11,הצפון,483,בענה,348,150,198,6,342,295,345,8,11%
2015-11,הצפון,1292,ג'דיידה-מכר,1220,541,679,11,1209,984,1201,29,13%
2015-11,הצפון,485,ג'ולס,204,54,150,0,204,139,202,3,7%
2015-11,הצפון,487,ג'ש (גוש חלב),67,29,38,3,64,35,64,0,4%
2015-11,הצפון,489,דבורייה,360,159,201,19,341,256,354,5,8%
2015-11,הצפון,490,דייר אל-אסד,360,150,210,10,350,293,359,6,7%
2015-11,הצפון,492,דייר חנא,613,261,352,6,607,493,604,3,13%
2015-11,הצפון,975,זרזיר,268,121,147,5,263,184,261,2,9%
2015-11,הצפון,496,חורפיש,105,45,60,12,93,57,101,2,4%
2015-11,הצפון,2034,חצור הגלילית,271,112,159,11,260,128,258,13,5%
2015-11,הצפון,6700,טבריה,1644,789,855,88,1556,887,1463,80,7%
2015-11,הצפון,962,טובא-זנגרייה,349,158,191,4,345,240,339,2,11%
2015-11,הצפון,498,טורעאן,504,204,300,13,491,399,475,7,8%
2015-11,הצפון,8900,טמרה,1660,750,910,23,1637,1426,1646,15,12%
2015-11,הצפון,1295,יאנוח-ג'ת,155,51,104,2,153,95,152,1,5%
2015-11,הצפון,46,יבנאל,122,73,49,6,116,87,97,2,6%
2015-11,הצפון,499,יפיע,607,268,339,24,583,464,595,9,8%
2015-11,הצפון,240,יקנעם עילית,478,198,280,77,401,123,473,27,4%
2015-11,הצפון,502,ירכא,539,227,312,0,539,402,529,13,9%
2015-11,הצפון,504,כאבול,604,261,343,9,595,512,597,9,12%
2015-11,הצפון,505,כאוכב אבו אל-היג'א,220,89,131,3,217,185,220,0,13%
2015-11,הצפון,1296,כסרא-סמיע,198,87,111,3,195,133,193,7,6%
2015-11,הצפון,978,כעביה-טבאש-חג'אג'רה,198,82,116,5,193,133,193,3,9%
2015-11,הצפון,1263,כפר ורדים,67,31,36,26,41,11,67,0,2%
2015-11,הצפון,507,כפר יאסיף,414,185,229,4,410,303,406,10,8%
2015-11,הצפון,508,כפר כמא,66,29,37,7,59,28,64,2,4%
2015-11,הצפון,509,כפר כנא,1060,444,616,22,1038,913,1006,20,12%
2015-11,הצפון,510,כפר מנדא,835,388,447,6,829,643,819,5,11%
2015-11,הצפון,47,כפר תבור,44,15,29,21,23,2,44,0,2%
2015-11,הצפון,1139,כרמיאל,1534,623,911,257,1277,731,1452,51,6%
2015-11,הצפון,481,מגאר,1336,538,798,19,1317,1133,1315,12,14%
2015-11,הצפון,516,מג'ד אל-כרום,499,232,267,14,485,373,491,15,8%
2015-11,הצפון,874,מגדל העמק,903,367,536,82,821,331,854,95,6%
2015-11,הצפון,4201,מג'דל שמס,463,179,284,12,451,360,436,5,9%
2015-11,הצפון,517,מזרעה,161,66,95,1,160,122,154,1,8%
2015-11,הצפון,4203,מסעדה,197,71,126,5,192,169,190,2,11%
2015-11,הצפון,518,מעיליא,45,26,19,6,39,23,45,0,3%
2015-11,הצפון,1063,מעלות-תרשיחא,857,408,449,105,752,435,842,31,7%
2015-11,הצפון,520,משהד,277,120,157,8,269,223,263,5,8%
2015-11,הצפון,9100,נהרייה,1921,905,1016,200,1721,1035,1856,79,6%
2015-11,הצפון,522,נחף,377,179,198,20,357,302,373,12,8%
2015-11,הצפון,7300,נצרת,3147,1389,1758,126,3021,2468,3071,35,9%
2015-11,הצפון,1061,נצרת עילית,1738,763,975,159,1579,866,1562,117,7%
2015-11,הצפון,525,סאג'ור,107,42,65,5,102,68,105,0,6%
2015-11,הצפון,7500,סח'נין,2173,915,1258,38,2135,1815,2151,24,15%
2015-11,הצפון,4501,ע'ג'ר,93,36,57,1,92,59,93,0,9%
2015-11,הצפון,530,עיילבון,170,78,92,8,162,116,170,2,6%
2015-11,הצפון,511,עילוט,323,131,192,4,319,256,319,2,11%
2015-11,הצפון,532,עין מאהל,497,237,260,12,485,398,485,2,9%
2015-11,הצפון,7600,עכו,3081,1390,1691,132,2949,2219,3015,68,11%
2015-11,הצפון,7700,עפולה,1650,698,952,160,1490,693,1565,100,6%
2015-11,הצפון,531,עראבה,1576,676,900,32,1544,1375,1562,21,15%
2015-11,הצפון,535,פסוטה,91,37,54,4,87,63,90,0,5%
2015-11,הצפון,536,פקיעין (בוקייעה),125,68,57,2,123,74,120,4,4%
2015-11,הצפון,8000,צפת,1358,743,615,65,1293,927,1289,25,10%
2015-11,הצפון,4100,קצרין,217,83,134,31,186,87,214,4,5%
2015-11,הצפון,2800,קריית שמונה,728,325,403,68,660,316,695,37,5%
2015-11,הצפון,543,ראמה,271,117,154,10,261,207,263,2,7%
2015-11,הצפון,26,ראש פינה,49,16,33,12,37,13,48,0,3%
2015-11,הצפון,542,ריינה,609,252,357,11,598,488,579,9,9%
2015-11,הצפון,122,רמת ישי,83,37,46,27,56,10,82,0,2%
2015-11,הצפון,913,שבלי - אום אל-גנם,200,80,120,8,192,137,196,4,8%
2015-11,הצפון,812,שלומי,231,98,133,11,220,103,225,5,6%
2015-11,הצפון,538,שעב,540,222,318,5,535,472,534,0,17%
2015-11,הצפון,8800,שפרעם,1817,734,1083,31,1786,1459,1802,24,10%
2015-11,חיפה,2710,אום אל-פחם,3462,1461,2001,43,3419,2873,3415,18,16%
2015-11,חיפה,1020,אור עקיבא,517,245,272,52,465,172,493,21,5%
2015-11,חיפה,6000,באקה אל-גרביה,627,300,327,8,619,365,623,29,5%
2015-11,חיפה,9800,בנימינה-גבעת עדה*,181,79,102,57,124,58,181,2,3%
2015-11,חיפה,1326,"בסמ""ה",410,190,220,6,404,313,406,4,10%
2015-11,חיפה,541,ג'סר א-זרקא,439,227,212,5,434,312,438,3,8%
2015-11,חיפה,628,ג'ת,215,110,105,6,209,126,213,4,4%
2015-11,חיפה,494,דאלית אל-כרמל,461,186,275,13,448,259,444,8,6%
2015-11,חיפה,9300,זכרון יעקב,258,120,138,80,178,49,255,3,2%
2015-11,חיפה,6500,חדרה,2335,1003,1332,293,2042,832,2196,65,4%
2015-11,חיפה,4000,חיפה,6221,3023,3198,1149,5072,3106,5932,177,4%
2015-11,חיפה,1247,חריש,42,22,20,2,40,22,38,1,3%
2015-11,חיפה,2100,טירת כרמל,705,338,367,48,657,363,693,14,6%
2015-11,חיפה,654,כפר קרע,403,185,218,10,393,230,397,4,5%
2015-11,חיפה,1327,מעלה עירון,850,318,532,11,839,700,840,14,15%
2015-11,חיפה,2500,נשר,424,212,212,79,345,161,417,12,3%
2015-11,חיפה,534,עספיא,309,132,177,17,292,172,291,7,5%
2015-11,חיפה,637,ערערה,562,250,312,7,555,350,552,20,7%
2015-11,חיפה,537,פוריידיס,415,210,205,12,403,259,410,3,7%
2015-11,חיפה,7800,פרדס חנה-כרכור,850,375,475,163,687,259,839,22,4%
2015-11,חיפה,6800,קריית אתא,1530,679,851,120,1410,808,1479,48,5%
2015-11,חיפה,9500,קריית ביאליק,995,413,582,116,879,463,975,28,5%
2015-11,חיפה,2300,קריית טבעון,189,75,114,69,120,39,186,0,2%
2015-11,חיפה,9600,קריית ים,1458,688,770,134,1324,805,1417,51,7%
2015-11,חיפה,8200,קריית מוצקין,1036,448,588,143,893,464,1002,26,4%
2015-11,חיפה,922,רכסים,167,71,96,12,155,83,153,1,4%
2015-11,ירושלים,472,אבו גוש,244,119,125,7,237,178,244,5,8%
2015-11,ירושלים,2610,בית שמש,1328,592,736,96,1232,484,1294,55,4%
2015-11,ירושלים,3000,ירושלים,12362,5575,6787,1341,11021,7570,12095,166,4%
2015-11,ירושלים,1015,מבשרת ציון,369,192,177,77,292,135,360,4,3%
2015-11,ירושלים,1137,קריית יערים,35,14,21,6,29,18,35,0,3%
2015-11,תל אביב,2400,אור יהודה,720,366,354,50,670,165,689,42,4%
2015-11,תל אביב,565,אזור,191,87,104,27,164,32,189,2,3%
2015-11,תל אביב,6100,בני ברק,1968,930,1038,86,1882,911,1867,26,3%
2015-11,תל אביב,6200,בת ים,2868,1347,1521,400,2468,996,2746,85,4%
2015-11,תל אביב,6300,גבעתיים,736,325,411,325,411,81,731,5,2%
2015-11,תל אביב,6400,הרצלייה,1067,457,610,355,712,36,1054,39,2%
2015-11,תל אביב,6600,חולון,3085,1385,1700,487,2598,684,3029,68,3%
2015-11,תל אביב,2620,קריית אונו,377,153,224,159,218,38,370,5,2%
2015-11,תל אביב,8600,רמת גן,1927,903,1024,657,1270,403,1895,30,2%
2015-11,תל אביב,2650,רמת השרון,369,153,216,171,198,9,366,9,2%
2015-11,תל אביב,5000,תל אביב -יפו,7122,3514,3608,2392,4730,1874,7007,105,3%
2015-12,אזור יהודה והשומרון,3760,אורנית,105,58,47,36,69,4,105,1,2%
2015-12,אזור יהודה והשומרון,3750,אלפי מנשה,87,43,44,22,65,0,87,1,2%
2015-12,אזור יהודה והשומרון,3560,אלקנה,40,19,21,16,24,0,40,0,2%
2015-12,אזור יהודה והשומרון,3650,אפרת,86,50,36,40,46,2,84,2,2%
2015-12,אזור יהודה והשומרון,3570,אריאל,321,155,166,79,242,44,319,11,3%
2015-12,אזור יהודה והשומרון,3574,בית אל,56,34,22,14,42,19,55,1,2%
2015-12,אזור יהודה והשומרון,3652,בית אריה,52,19,33,15,37,2,52,0,2%
2015-12,אזור יהודה והשומרון,3780,ביתר עילית,571,281,290,8,563,260,568,3,5%
2015-12,אזור יהודה והשומרון,3730,גבעת זאב,210,92,118,41,169,42,205,5,3%
2015-12,אזור יהודה והשומרון,3769,הר אדר,40,15,25,23,17,4,40,0,2%
2015-12,אזור יהודה והשומרון,3797,מודיעין עילית,352,132,220,15,337,48,348,6,3%
2015-12,אזור יהודה והשומרון,3616,מעלה אדומים,667,299,368,83,584,186,657,20,3%
2015-12,אזור יהודה והשומרון,3660,עמנואל,71,39,32,3,68,38,70,1,6%
2015-12,אזור יהודה והשומרון,3557,קדומים,41,25,16,15,26,5,40,0,2%
2015-12,אזור יהודה והשומרון,3611,קריית ארבע,108,58,50,12,96,52,107,3,3%
2015-12,אזור יהודה והשומרון,3640,קרני שומרון,79,44,35,23,56,5,79,2,2%
2015-12,הדרום,31,אופקים,1002,418,584,50,952,585,977,33,8%
2015-12,הדרום,2600,אילת,1323,649,674,61,1262,478,1265,56,4%
2015-12,הדרום,70,אשדוד,5623,2410,3213,656,4967,2744,5398,178,5%
2015-12,הדרום,7100,אשקלון,3851,1643,2208,400,3451,1981,3371,125,5%
2015-12,הדרום,9000,באר שבע,6307,2791,3516,800,5507,3459,6013,151,6%
2015-12,הדרום,2200,דימונה,1892,849,1043,96,1796,1249,1809,49,10%
2015-12,הדרום,1303,חורה,710,295,415,2,708,626,695,5,18%
2015-12,הדרום,831,ירוחם,390,214,176,13,377,220,373,17,8%
2015-12,הדרום,1059,כסיפה,985,394,591,0,985,893,978,4,21%
2015-12,הדרום,1271,להבים,43,22,21,19,24,5,42,0,1%
2015-12,הדרום,1060,לקיה,781,345,436,1,780,723,767,10,19%
2015-12,הדרום,1268,מיתר,65,30,35,26,39,8,65,1,2%
2015-12,הדרום,99,מצפה רמון,273,118,155,23,250,165,262,12,11%
2015-12,הדרום,246,נתיבות,955,422,533,42,913,478,904,45,7%
2015-12,הדרום,666,עומר,52,19,33,28,24,2,52,0,1%
2015-12,הדרום,2560,ערד,752,356,396,93,659,363,730,39,6%
2015-12,הדרום,1192,ערערה-בנגב,1054,439,615,3,1051,970,1037,3,25%
2015-12,הדרום,2630,קריית גת,1862,795,1067,112,1750,944,1793,47,6%
2015-12,הדרום,1034,קריית מלאכי,935,428,507,22,913,466,898,79,8%
2015-12,הדרום,1161,רהט,2785,1185,1600,4,2781,2312,2742,64,15%
2015-12,הדרום,1286,שגב-שלום,454,169,285,3,451,386,446,6,17%
2015-12,הדרום,1031,שדרות,973,447,526,47,926,562,904,26,7%
2015-12,הדרום,1054,תל שבע,984,447,537,4,980,893,971,20,21%
2015-12,המרכז,182,אבן יהודה,136,62,74,34,102,18,134,3,2%
2015-12,המרכז,41,אליכין,78,45,33,11,67,18,76,3,4%
2015-12,המרכז,1309,אלעד,364,167,197,18,346,59,353,3,3%
2015-12,המרכז,2530,באר יעקב,231,95,136,55,176,44,225,5,2%
2015-12,המרכז,466,בית דגן,91,53,38,8,83,33,89,2,3%
2015-12,המרכז,1066,"בני עי""ש",160,66,94,26,134,63,154,4,4%
2015-12,המרכז,681,גבעת שמואל,262,136,126,81,181,54,258,2,2%
2015-12,המרכז,2550,גדרה,316,130,186,61,255,93,307,16,3%
2015-12,המרכז,627,ג'לג'וליה,87,32,55,4,83,58,83,2,2%
2015-12,המרכז,166,גן יבנה,308,131,177,51,257,74,298,11,3%
2015-12,המרכז,229,גני תקווה,185,76,109,60,125,27,183,1,2%
2015-12,המרכז,9700,הוד השרון,636,262,374,264,372,57,629,14,2%
2015-12,המרכז,1290,זמר,143,43,100,3,140,101,142,0,5%
2015-12,המרכז,2730,טייבה,1238,547,691,15,1223,975,1108,29,7%
2015-12,המרכז,2720,טירה,234,112,122,13,221,102,228,8,2%
2015-12,המרכז,2660,יבנה,735,370,365,117,618,243,728,35,3%
2015-12,המרכז,9400,יהוד,401,197,204,95,306,52,393,15,2%
2015-12,המרכז,1224,כוכב יאיר,86,45,41,43,43,3,85,0,2%
2015-12,המרכז,633,כפר ברא,30,15,15,1,29,12,29,2,2%
2015-12,המרכז,168,כפר יונה,318,142,176,49,269,44,317,8,3%
2015-12,המרכז,6900,כפר סבא,1218,577,641,419,799,137,1190,24,2%
2015-12,המרכז,634,כפר קאסם,238,110,128,7,231,131,232,0,3%
2015-12,המרכז,7000,לוד,1917,894,1023,130,1787,1017,1882,54,5%
2015-12,המרכז,1200,מודיעין-מכבים-רעות*,918,390,528,378,540,59,911,27,2%
2015-12,המרכז,28,מזכרת בתיה,156,70,86,47,109,29,155,3,2%
2015-12,המרכז,7200,נס ציונה,653,315,338,176,477,176,642,18,3%
2015-12,המרכז,7400,נתניה,4203,1951,2252,403,3800,1398,4098,124,4%
2015-12,המרכז,587,סביון*,15,7,8,8,7,0,15,0,1%
2015-12,המרכז,171,פרדסייה,82,38,44,12,70,7,82,0,2%
2015-12,המרכז,7900,פתח תקווה,3816,1707,2109,850,2966,1005,3731,60,3%
2015-12,המרכז,195,קדימה-צורן,244,100,144,46,198,37,241,3,2%
2015-12,המרכז,638,קלנסווה,512,239,273,4,508,375,467,13,6%
2015-12,המרכז,469,קריית עקרון,245,130,115,19,226,114,237,9,4%
2015-12,המרכז,2640,ראש העין,706,349,357,107,599,143,697,23,3%
2015-12,המרכז,8300,ראשון לציון,4180,1843,2337,736,3444,1248,4137,93,3%
2015-12,המרכז,8400,רחובות,2231,1031,1200,480,1751,799,2173,68,3%
2015-12,המרכז,8500,רמלה,1575,764,811,100,1475,673,1516,63,4%
2015-12,המרכז,8700,רעננה,709,328,381,280,429,55,694,6,2%
2015-12,המרכז,1304,שוהם,170,88,82,76,94,12,169,0,2%
2015-12,המרכז,154,תל מונד,151,78,73,43,108,21,150,1,2%
2015-12,הצפון,473,אבו סנאן,612,263,349,8,604,482,606,13,11%
2015-12,הצפון,478,אכסאל,515,234,281,9,506,447,505,2,9%
2015-12,הצפון,529,אעבלין,536,213,323,7,529,452,527,2,9%
2015-12,הצפון,482,בועיינה-נוג'ידאת,343,147,196,9,334,285,329,8,9%
2015-12,הצפון,4001,בוקעאתא,370,139,231,4,366,312,349,0,13%
2015-12,הצפון,998,ביר אל-מכסור,401,168,233,1,400,320,393,1,11%
2015-12,הצפון,480,בית ג'ן,380,123,257,3,377,266,375,3,7%
2015-12,הצפון,9200,בית שאן,808,358,450,19,789,394,791,57,8%
2015-12,הצפון,944,בסמת טבעון,203,97,106,2,201,151,195,2,6%
2015-12,הצפון,483,בענה,358,156,202,5,353,303,354,12,11%
2015-12,הצפון,1292,ג'דיידה-מכר,1191,530,661,11,1180,975,1179,25,13%
2015-12,הצפון,485,ג'ולס,245,70,175,0,245,141,243,7,8%
2015-12,הצפון,487,ג'ש (גוש חלב),68,27,41,5,63,33,65,1,4%
2015-12,הצפון,489,דבורייה,346,151,195,16,330,257,342,1,8%
2015-12,הצפון,490,דייר אל-אסד,353,146,207,10,343,292,352,10,7%
2015-12,הצפון,492,דייר חנא,634,272,362,7,627,489,625,7,13%
2015-12,הצפון,975,זרזיר,280,128,152,3,277,190,274,12,9%
2015-12,הצפון,496,חורפיש,115,49,66,10,105,60,107,1,4%
2015-12,הצפון,2034,חצור הגלילית,269,114,155,10,259,128,255,4,5%
2015-12,הצפון,6700,טבריה,1646,799,847,85,1561,882,1466,65,7%
2015-12,הצפון,962,טובא-זנגרייה,361,166,195,5,356,243,351,0,12%
2015-12,הצפון,498,טורעאן,500,204,296,18,482,387,475,3,8%
2015-12,הצפון,8900,טמרה,1659,764,895,20,1639,1431,1624,16,12%
2015-12,הצפון,1295,יאנוח-ג'ת,143,49,94,2,141,93,139,3,5%
2015-12,הצפון,46,יבנאל,128,77,51,6,122,87,105,3,7%
2015-12,הצפון,499,יפיע,599,259,340,16,583,458,587,8,8%
2015-12,הצפון,240,יקנעם עילית,461,195,266,71,390,111,455,27,4%
2015-12,הצפון,502,ירכא,528,210,318,0,528,409,516,12,9%
2015-12,הצפון,504,כאבול,596,261,335,8,588,512,585,3,12%
2015-12,הצפון,505,כאוכב אבו אל-היג'א,224,93,131,2,222,190,222,1,13%
2015-12,הצפון,1296,כסרא-סמיע,221,84,137,5,216,153,205,7,6%
2015-12,הצפון,978,כעביה-טבאש-חג'אג'רה,194,82,112,7,187,130,190,2,8%
2015-12,הצפון,1263,כפר ורדים,63,27,36,26,37,7,61,0,2%
2015-12,הצפון,507,כפר יאסיף,412,179,233,6,406,300,402,9,8%
2015-12,הצפון,508,כפר כמא,65,28,37,7,58,28,62,0,4%
2015-12,הצפון,509,כפר כנא,1104,468,636,22,1082,918,1042,12,12%
2015-12,הצפון,510,כפר מנדא,816,391,425,6,810,648,791,1,11%
2015-12,הצפון,47,כפר תבור,34,14,20,16,18,1,34,0,2%
2015-12,הצפון,1139,כרמיאל,1497,610,887,241,1256,712,1429,57,6%
2015-12,הצפון,481,מגאר,1366,555,811,19,1347,1146,1311,6,14%
2015-12,הצפון,516,מג'ד אל-כרום,489,234,255,13,476,370,483,7,8%
2015-12,הצפון,874,מגדל העמק,851,367,484,85,766,315,799,73,6%
2015-12,הצפון,4201,מג'דל שמס,452,175,277,11,441,354,431,5,9%
2015-12,הצפון,517,מזרעה,156,63,93,1,155,126,150,1,8%
2015-12,הצפון,4203,מסעדה,207,76,131,5,202,174,195,3,12%
2015-12,הצפון,518,מעיליא,47,26,21,6,41,22,47,2,3%
2015-12,הצפון,1063,מעלות-תרשיחא,849,404,445,106,743,439,819,30,7%
2015-12,הצפון,520,משהד,266,117,149,6,260,213,257,6,8%
2015-12,הצפון,9100,נהרייה,1922,916,1006,206,1716,1035,1850,85,6%
2015-12,הצפון,522,נחף,379,174,205,15,364,307,375,8,8%
2015-12,הצפון,7300,נצרת,3079,1376,1703,119,2960,2399,3006,28,9%
2015-12,הצפון,1061,נצרת עילית,1657,724,933,161,1496,874,1482,87,6%
2015-12,הצפון,525,סאג'ור,109,41,68,6,103,68,106,5,6%
2015-12,הצפון,7500,סח'נין,2146,930,1216,36,2110,1785,2111,15,15%
2015-12,הצפון,4501,ע'ג'ר,89,37,52,3,86,59,89,0,9%
2015-12,הצפון,530,עיילבון,165,78,87,6,159,115,160,3,6%
2015-12,הצפון,511,עילוט,324,130,194,4,320,265,314,1,11%
2015-12,הצפון,532,עין מאהל,521,245,276,13,508,394,508,3,10%
2015-12,הצפון,7600,עכו,3084,1404,1680,119,2965,2205,3001,59,11%
2015-12,הצפון,7700,עפולה,1605,666,939,156,1449,667,1517,99,6%
2015-12,הצפון,531,עראבה,1572,683,889,36,1536,1336,1547,16,15%
2015-12,הצפון,535,פסוטה,102,41,61,4,98,59,98,1,6%
2015-12,הצפון,536,פקיעין (בוקייעה),124,63,61,3,121,75,117,1,4%
2015-12,הצפון,8000,צפת,1363,758,605,67,1296,941,1294,20,10%
2015-12,הצפון,4100,קצרין,220,80,140,34,186,93,216,2,5%
2015-12,הצפון,2800,קריית שמונה,735,333,402,69,666,306,707,30,5%
2015-12,הצפון,543,ראמה,273,114,159,12,261,207,266,4,7%
2015-12,הצפון,26,ראש פינה,50,19,31,9,41,17,49,1,3%
2015-12,הצפון,542,ריינה,591,257,334,12,579,468,563,14,8%
2015-12,הצפון,122,רמת ישי,96,41,55,35,61,9,94,0,2%
2015-12,הצפון,913,שבלי - אום אל-גנם,204,82,122,7,197,133,201,1,8%
2015-12,הצפון,812,שלומי,225,94,131,13,212,99,218,4,6%
2015-12,הצפון,538,שעב,533,219,314,4,529,467,524,2,17%
2015-12,הצפון,8800,שפרעם,1796,724,1072,29,1767,1445,1760,23,10%
2015-12,חיפה,2710,אום אל-פחם,3447,1476,1971,45,3402,2859,3392,32,16%
2015-12,חיפה,1020,אור עקיבא,499,224,275,49,450,168,476,19,5%
2015-12,חיפה,6000,באקה אל-גרביה,643,318,325,11,632,370,638,22,6%
2015-12,חיפה,9800,בנימינה-גבעת עדה*,179,79,100,55,124,58,179,0,3%
2015-12,חיפה,1326,"בסמ""ה",400,183,217,4,396,306,398,1,10%
2015-12,חיפה,541,ג'סר א-זרקא,462,244,218,5,457,324,460,7,8%
2015-12,חיפה,628,ג'ת,214,110,104,7,207,124,212,6,4%
2015-12,חיפה,494,דאלית אל-כרמל,482,194,288,14,468,253,462,8,6%
2015-12,חיפה,9300,זכרון יעקב,268,120,148,89,179,50,261,1,2%
2015-12,חיפה,6500,חדרה,2321,1022,1299,280,2041,843,2170,70,4%
2015-12,חיפה,4000,חיפה,6181,3033,3148,1151,5030,3172,5827,152,4%
2015-12,חיפה,1247,חריש,48,24,24,0,48,22,40,1,3%
2015-12,חיפה,2100,טירת כרמל,722,349,373,42,680,370,699,26,7%
2015-12,חיפה,654,כפר קרע,397,191,206,9,388,228,393,8,5%
2015-12,חיפה,1327,מעלה עירון,845,318,527,13,832,697,835,7,14%
2015-12,חיפה,2500,נשר,419,206,213,72,347,160,407,8,3%
2015-12,חיפה,534,עספיא,299,128,171,18,281,172,277,8,5%
2015-12,חיפה,637,ערערה,557,242,315,3,554,343,550,22,7%
2015-12,חיפה,537,פוריידיס,429,215,214,12,417,277,421,2,8%
2015-12,חיפה,7800,פרדס חנה-כרכור,863,383,480,168,695,269,843,22,4%
2015-12,חיפה,6800,קריית אתא,1494,657,837,119,1375,782,1448,45,5%
2015-12,חיפה,9500,קריית ביאליק,992,420,572,109,883,453,975,37,5%
2015-12,חיפה,2300,קריית טבעון,173,65,108,59,114,37,170,1,2%
2015-12,חיפה,9600,קריית ים,1460,671,789,135,1325,800,1402,44,7%
2015-12,חיפה,8200,קריית מוצקין,1026,456,570,146,880,462,994,26,4%
2015-12,חיפה,922,רכסים,176,81,95,13,163,80,162,0,5%
2015-12,ירושלים,472,אבו גוש,252,128,124,7,245,176,250,6,8%
2015-12,ירושלים,2610,בית שמש,1241,570,671,91,1150,486,1194,31,4%
2015-12,ירושלים,3000,ירושלים,12302,5625,6677,1323,10979,7597,12030,165,4%
2015-12,ירושלים,1015,מבשרת ציון,371,189,182,83,288,131,362,13,3%
2015-12,ירושלים,1137,קריית יערים,36,12,24,6,30,17,36,0,3%
2015-12,תל אביב,2400,אור יהודה,705,365,340,45,660,177,680,41,4%
2015-12,תל אביב,565,אזור,187,83,104,27,160,27,186,3,3%
2015-12,תל אביב,6100,בני ברק,1898,919,979,84,1814,869,1800,18,3%
2015-12,תל אביב,6200,בת ים,2826,1333,1493,379,2447,990,2689,88,4%
2015-12,תל אביב,6300,גבעתיים,729,330,399,317,412,81,724,4,2%
2015-12,תל אביב,6400,הרצלייה,1006,435,571,334,672,41,992,40,2%
2015-12,תל אביב,6600,חולון,3037,1393,1644,477,2560,679,2994,49,3%
2015-12,תל אביב,2620,קריית אונו,379,174,205,153,226,39,378,6,2%
2015-12,תל אביב,8600,רמת גן,1969,942,1027,656,1313,399,1939,29,2%
2015-12,תל אביב,2650,רמת השרון,351,157,194,161,190,10,347,10,2%
2015-12,תל אביב,5000,תל אביב -יפו,7124,3496,3628,2380,4744,1869,6983,111,3%
2016-01,אזור יהודה והשומרון,3760,אורנית,105,54,51,36,69,2,105,2,2%
2016-01,אזור יהודה והשומרון,3750,אלפי מנשה,97,45,52,22,75,1,97,1,2%
2016-01,אזור יהודה והשומרון,3560,אלקנה,40,22,18,14,26,0,40,0,2%
2016-01,אזור יהודה והשומרון,3650,אפרת,82,42,40,42,40,2,82,0,2%
2016-01,אזור יהודה והשומרון,3570,אריאל,302,134,168,79,223,42,301,8,3%
2016-01,אזור יהודה והשומרון,3574,בית אל,49,31,18,12,37,21,47,1,2%
2016-01,אזור יהודה והשומרון,3652,בית אריה,60,23,37,16,44,3,60,0,2%
2016-01,אזור יהודה והשומרון,3780,ביתר עילית,552,269,283,8,544,254,549,5,5%
2016-01,אזור יהודה והשומרון,3730,גבעת זאב,204,95,109,35,169,41,200,7,3%
2016-01,אזור יהודה והשומרון,3769,הר אדר,41,17,24,23,18,4,41,0,2%
2016-01,אזור יהודה והשומרון,3797,מודיעין עילית,360,131,229,17,343,46,354,4,3%
2016-01,אזור יהודה והשומרון,3616,מעלה אדומים,646,281,365,90,556,174,635,21,3%
2016-01,אזור יהודה והשומרון,3660,עמנואל,59,36,23,2,57,33,59,3,5%
2016-01,אזור יהודה והשומרון,3557,קדומים,41,25,16,15,26,5,41,0,2%
2016-01,אזור יהודה והשומרון,3611,קריית ארבע,100,55,45,10,90,53,98,4,3%
2016-01,אזור יהודה והשומרון,3640,קרני שומרון,73,37,36,22,51,7,71,4,2%
2016-01,הדרום,31,אופקים,1021,419,602,51,970,592,988,49,8%
2016-01,הדרום,2600,אילת,1481,721,760,71,1410,489,1420,46,4%
2016-01,הדרום,70,אשדוד,5657,2379,3278,668,4989,2733,5410,173,5%
2016-01,הדרום,7100,אשקלון,3768,1606,2162,394,3374,1958,3287,135,5%
2016-01,הדרום,9000,באר שבע,6219,2773,3446,793,5426,3417,5920,170,6%
2016-01,הדרום,2200,דימונה,1909,827,1082,101,1808,1249,1819,62,10%
2016-01,הדרום,1303,חורה,692,286,406,1,691,610,678,17,17%
2016-01,הדרום,831,ירוחם,372,198,174,14,358,217,356,43,8%
2016-01,הדרום,1059,כסיפה,1025,420,605,0,1025,905,1017,18,22%
2016-01,הדרום,1271,להבים,41,26,15,19,22,4,41,0,1%
2016-01,הדרום,1060,לקיה,752,331,421,2,750,693,738,14,18%
2016-01,הדרום,1268,מיתר,67,32,35,27,40,7,66,2,2%
2016-01,הדרום,99,מצפה רמון,265,117,148,23,242,163,257,11,10%
2016-01,הדרום,246,נתיבות,916,409,507,40,876,463,868,59,6%
2016-01,הדרום,666,עומר,59,22,37,31,28,2,59,1,1%
2016-01,הדרום,2560,ערד,763,358,405,94,669,377,731,41,6%
2016-01,הדרום,1192,ערערה-בנגב,1075,450,625,4,1071,984,1052,21,25%
2016-01,הדרום,2630,קריית גת,1867,783,1084,112,1755,914,1803,72,6%
2016-01,הדרום,1034,קריית מלאכי,897,411,486,19,878,463,860,81,8%
2016-01,הדרום,1161,רהט,2768,1176,1592,4,2764,2286,2724,55,15%
2016-01,הדרום,1286,שגב-שלום,446,167,279,3,443,377,437,18,17%
2016-01,הדרום,1031,שדרות,932,426,506,50,882,547,865,26,7%
2016-01,הדרום,1054,תל שבע,960,425,535,4,956,871,943,27,20%
2016-01,המרכז,182,אבן יהודה,159,69,90,40,119,18,157,2,2%
2016-01,המרכז,41,אליכין,75,43,32,10,65,19,72,3,4%
2016-01,המרכז,1309,אלעד,375,175,200,23,352,55,366,3,3%
2016-01,המרכז,2530,באר יעקב,226,105,121,59,167,44,220,3,2%
2016-01,המרכז,466,בית דגן,85,52,33,8,77,31,84,1,2%
2016-01,המרכז,1066,"בני עי""ש",161,75,86,28,133,55,157,3,4%
2016-01,המרכז,681,גבעת שמואל,262,139,123,84,178,49,257,0,2%
2016-01,המרכז,2550,גדרה,306,133,173,66,240,89,297,14,3%
2016-01,המרכז,627,ג'לג'וליה,91,37,54,2,89,58,89,2,2%
2016-01,המרכז,166,גן יבנה,307,125,182,54,253,72,299,12,3%
2016-01,המרכז,229,גני תקווה,187,84,103,67,120,29,184,0,2%
2016-01,המרכז,9700,הוד השרון,638,278,360,261,377,58,630,10,2%
2016-01,המרכז,1290,זמר,137,43,94,3,134,97,136,7,5%
2016-01,המרכז,2730,טייבה,1246,547,699,10,1236,976,1108,41,7%
2016-01,המרכז,2720,טירה,213,103,110,14,199,98,207,17,2%
2016-01,המרכז,2660,יבנה,736,364,372,119,617,239,729,27,3%
2016-01,המרכז,9400,יהוד,403,201,202,98,305,49,398,12,3%
2016-01,המרכז,1224,כוכב יאיר,98,47,51,46,52,2,98,1,2%
2016-01,המרכז,633,כפר ברא,26,13,13,1,25,12,25,1,2%
2016-01,המרכז,168,כפר יונה,310,137,173,49,261,43,309,10,3%
2016-01,המרכז,6900,כפר סבא,1210,551,659,397,813,118,1185,23,2%
2016-01,המרכז,634,כפר קאסם,234,108,126,7,227,132,228,2,3%
2016-01,המרכז,7000,לוד,1966,921,1045,140,1826,1029,1920,57,5%
2016-01,המרכז,1200,מודיעין-מכבים-רעות*,920,400,520,371,549,67,906,20,2%
2016-01,המרכז,28,מזכרת בתיה,146,60,86,45,101,28,145,4,2%
2016-01,המרכז,7200,נס ציונה,667,302,365,182,485,169,655,18,3%
2016-01,המרכז,7400,נתניה,4180,1940,2240,412,3768,1386,4065,79,4%
2016-01,המרכז,587,סביון*,13,5,8,7,6,0,13,0,1%
2016-01,המרכז,171,פרדסייה,80,36,44,15,65,4,80,0,2%
2016-01,המרכז,7900,פתח תקווה,3720,1667,2053,810,2910,991,3637,57,3%
2016-01,המרכז,195,קדימה-צורן,240,94,146,39,201,43,235,0,2%
2016-01,המרכז,638,קלנסווה,506,240,266,5,501,370,471,13,6%
2016-01,המרכז,469,קריית עקרון,232,126,106,18,214,103,228,11,4%
2016-01,המרכז,2640,ראש העין,727,357,370,103,624,139,718,32,3%
2016-01,המרכז,8300,ראשון לציון,4199,1852,2347,768,3431,1226,4156,96,3%
2016-01,המרכז,8400,רחובות,2177,1040,1137,498,1679,776,2124,89,3%
2016-01,המרכז,8500,רמלה,1594,771,823,103,1491,676,1530,57,4%
2016-01,המרכז,8700,רעננה,699,325,374,273,426,57,685,7,2%
2016-01,המרכז,1304,שוהם,176,87,89,73,103,10,175,0,2%
2016-01,המרכז,154,תל מונד,144,69,75,40,104,20,144,1,2%
2016-01,הצפון,473,אבו סנאן,608,259,349,6,602,489,601,8,11%
2016-01,הצפון,478,אכסאל,522,242,280,7,515,447,511,3,9%
2016-01,הצפון,529,אעבלין,524,209,315,5,519,443,512,11,9%
2016-01,הצפון,482,בועיינה-נוג'ידאת,377,162,215,9,368,293,361,5,10%
2016-01,הצפון,4001,בוקעאתא,365,136,229,4,361,307,352,0,13%
2016-01,הצפון,998,ביר אל-מכסור,393,161,232,2,391,312,389,2,11%
2016-01,הצפון,480,בית ג'ן,396,139,257,4,392,275,386,5,7%
2016-01,הצפון,9200,בית שאן,798,366,432,20,778,391,777,52,8%
2016-01,הצפון,944,בסמת טבעון,196,92,104,4,192,149,187,0,6%
2016-01,הצפון,483,בענה,357,152,205,3,354,316,345,9,11%
2016-01,הצפון,1292,ג'דיידה-מכר,1214,538,676,10,1204,999,1190,29,13%
2016-01,הצפון,485,ג'ולס,244,72,172,0,244,145,241,3,8%
2016-01,הצפון,487,ג'ש (גוש חלב),71,27,44,4,67,32,67,1,4%
2016-01,הצפון,489,דבורייה,351,153,198,14,337,260,344,3,8%
2016-01,הצפון,490,דייר אל-אסד,358,152,206,9,349,299,350,5,7%
2016-01,הצפון,492,דייר חנא,635,280,355,6,629,496,623,3,13%
2016-01,הצפון,975,זרזיר,273,117,156,2,271,182,267,14,9%
2016-01,הצפון,496,חורפיש,104,49,55,10,94,56,101,0,4%
2016-01,הצפון,2034,חצור הגלילית,267,120,147,7,260,127,250,2,5%
2016-01,הצפון,6700,טבריה,1672,810,862,87,1585,874,1469,75,7%
2016-01,הצפון,962,טובא-זנגרייה,384,180,204,4,380,256,373,0,12%
2016-01,הצפון,498,טורעאן,517,223,294,20,497,396,484,8,9%
2016-01,הצפון,8900,טמרה,1651,778,873,21,1630,1413,1607,21,12%
2016-01,הצפון,1295,יאנוח-ג'ת,144,51,93,5,139,95,143,1,5%
2016-01,הצפון,46,יבנאל,136,87,49,5,131,88,109,3,7%
2016-01,הצפון,499,יפיע,605,273,332,14,591,459,595,7,8%
2016-01,הצפון,240,יקנעם עילית,446,186,260,81,365,115,440,28,4%
2016-01,הצפון,502,ירכא,548,226,322,1,547,420,539,19,9%
2016-01,הצפון,504,כאבול,580,261,319,8,572,494,568,7,12%
2016-01,הצפון,505,כאוכב אבו אל-היג'א,225,93,132,3,222,191,217,1,13%
2016-01,הצפון,1296,כסרא-סמיע,197,83,114,6,191,135,191,4,6%
2016-01,הצפון,978,כעביה-טבאש-חג'אג'רה,201,88,113,8,193,126,193,3,9%
2016-01,הצפון,1263,כפר ורדים,73,33,40,29,44,5,72,2,2%
2016-01,הצפון,507,כפר יאסיף,427,192,235,3,424,317,418,8,8%
2016-01,הצפון,508,כפר כמא,69,32,37,6,63,27,69,1,4%
2016-01,הצפון,509,כפר כנא,1126,488,638,19,1107,935,1044,31,12%
2016-01,הצפון,510,כפר מנדא,817,393,424,7,810,658,783,7,11%
2016-01,הצפון,47,כפר תבור,40,18,22,20,20,1,40,0,2%
2016-01,הצפון,1139,כרמיאל,1492,615,877,254,1238,698,1437,49,6%
2016-01,הצפון,481,מגאר,1381,576,805,22,1359,1158,1321,17,14%
2016-01,הצפון,516,מג'ד אל-כרום,489,235,254,10,479,373,477,13,7%
2016-01,הצפון,874,מגדל העמק,860,384,476,80,780,309,803,76,6%
2016-01,הצפון,4201,מג'דל שמס,445,167,278,11,434,351,426,11,9%
2016-01,הצפון,517,מזרעה,154,66,88,2,152,118,148,3,8%
2016-01,הצפון,4203,מסעדה,210,77,133,5,205,177,200,4,12%
2016-01,הצפון,518,מעיליא,41,24,17,7,34,20,41,0,3%
2016-01,הצפון,1063,מעלות-תרשיחא,824,398,426,99,725,423,807,35,7%
2016-01,הצפון,520,משהד,267,114,153,7,260,215,253,9,8%
2016-01,הצפון,9100,נהרייה,1921,928,993,220,1701,1002,1849,75,6%
2016-01,הצפון,522,נחף,401,181,220,18,383,317,389,10,8%
2016-01,הצפון,7300,נצרת,3062,1360,1702,121,2941,2399,2982,33,9%
2016-01,הצפון,1061,נצרת עילית,1699,750,949,179,1520,877,1510,104,6%
2016-01,הצפון,525,סאג'ור,114,41,73,4,110,74,112,3,6%
2016-01,הצפון,7500,סח'נין,2164,959,1205,32,2132,1811,2126,17,15%
2016-01,הצפון,4501,ע'ג'ר,95,38,57,2,93,60,94,0,9%
2016-01,הצפון,530,עיילבון,173,81,92,5,168,122,167,1,6%
2016-01,הצפון,511,עילוט,314,123,191,4,310,264,309,4,11%
2016-01,הצפון,532,עין מאהל,513,251,262,10,503,391,495,2,10%
2016-01,הצפון,7600,עכו,3136,1421,1715,130,3006,2224,3047,61,11%
2016-01,הצפון,7700,עפולה,1609,699,910,153,1456,651,1528,84,6%
2016-01,הצפון,531,עראבה,1558,676,882,30,1528,1341,1528,5,15%
2016-01,הצפון,535,פסוטה,103,43,60,3,100,55,100,3,6%
2016-01,הצפון,536,פקיעין (בוקייעה),123,61,62,7,116,72,120,1,4%
2016-01,הצפון,8000,צפת,1345,730,615,77,1268,963,1263,12,9%
2016-01,הצפון,4100,קצרין,218,81,137,34,184,90,214,8,5%
2016-01,הצפון,2800,קריית שמונה,778,371,407,66,712,313,747,30,6%
2016-01,הצפון,543,ראמה,265,108,157,10,255,200,261,5,7%
2016-01,הצפון,26,ראש פינה,52,20,32,10,42,19,52,1,3%
2016-01,הצפון,542,ריינה,597,263,334,11,586,468,560,6,8%
2016-01,הצפון,122,רמת ישי,94,43,51,34,60,7,92,0,2%
2016-01,הצפון,913,שבלי - אום אל-גנם,215,92,123,6,209,142,210,2,8%
2016-01,הצפון,812,שלומי,232,99,133,13,219,100,227,7,6%
2016-01,הצפון,538,שעב,536,224,312,4,532,474,525,3,17%
2016-01,הצפון,8800,שפרעם,1793,718,1075,33,1760,1439,1755,37,10%
2016-01,חיפה,2710,אום אל-פחם,3356,1430,1926,43,3313,2789,3304,55,16%
2016-01,חיפה,1020,אור עקיבא,501,224,277,53,448,160,485,20,5%
2016-01,חיפה,6000,באקה אל-גרביה,614,313,301,12,602,355,607,24,5%
2016-01,חיפה,9800,בנימינה-גבעת עדה*,185,78,107,58,127,60,185,2,3%
2016-01,חיפה,1326,"בסמ""ה",404,183,221,5,399,306,401,6,10%
2016-01,חיפה,541,ג'סר א-זרקא,456,237,219,5,451,327,451,5,8%
2016-01,חיפה,628,ג'ת,209,110,99,9,200,117,207,6,4%
2016-01,חיפה,494,דאלית אל-כרמל,472,187,285,20,452,257,447,11,6%
2016-01,חיפה,9300,זכרון יעקב,267,122,145,86,181,48,260,1,2%
2016-01,חיפה,6500,חדרה,2332,1040,1292,268,2064,834,2183,74,4%
2016-01,חיפה,4000,חיפה,6141,3022,3119,1161,4980,3100,5803,160,4%
2016-01,חיפה,1247,חריש,60,32,28,0,60,26,54,2,4%
2016-01,חיפה,2100,טירת כרמל,677,338,339,39,638,361,659,19,6%
2016-01,חיפה,654,כפר קרע,386,182,204,15,371,229,381,11,5%
2016-01,חיפה,1327,מעלה עירון,831,314,517,10,821,680,821,17,14%
2016-01,חיפה,2500,נשר,409,199,210,74,335,151,396,4,3%
2016-01,חיפה,534,עספיא,292,131,161,15,277,168,272,5,5%
2016-01,חיפה,637,ערערה,550,239,311,2,548,346,543,19,7%
2016-01,חיפה,537,פוריידיס,425,216,209,13,412,274,418,2,8%
2016-01,חיפה,7800,פרדס חנה-כרכור,836,364,472,175,661,261,819,15,4%
2016-01,חיפה,6800,קריית אתא,1517,694,823,116,1401,764,1481,48,5%
2016-01,חיפה,9500,קריית ביאליק,989,404,585,116,873,455,969,34,5%
2016-01,חיפה,2300,קריית טבעון,179,72,107,66,113,38,176,3,2%
2016-01,חיפה,9600,קריית ים,1416,661,755,127,1289,796,1376,41,6%
2016-01,חיפה,8200,קריית מוצקין,1008,445,563,142,866,448,972,28,4%
2016-01,חיפה,922,רכסים,162,77,85,12,150,77,151,0,4%
2016-01,ירושלים,472,אבו גוש,255,129,126,7,248,179,254,2,8%
2016-01,ירושלים,2610,בית שמש,1222,544,678,90,1132,472,1184,48,4%
2016-01,ירושלים,3000,ירושלים,12243,5578,6665,1337,10906,7572,11943,195,4%
2016-01,ירושלים,1015,מבשרת ציון,368,183,185,80,288,127,357,5,3%
2016-01,ירושלים,1137,קריית יערים,38,14,24,7,31,16,38,0,3%
2016-01,תל אביב,2400,אור יהודה,732,361,371,42,690,174,710,33,4%
2016-01,תל אביב,565,אזור,201,90,111,30,171,27,201,2,3%
2016-01,תל אביב,6100,בני ברק,1876,925,951,82,1794,854,1771,24,3%
2016-01,תל אביב,6200,בת ים,2852,1342,1510,375,2477,977,2726,61,4%
2016-01,תל אביב,6300,גבעתיים,718,313,405,311,407,76,713,5,2%
2016-01,תל אביב,6400,הרצלייה,990,438,552,312,678,29,979,33,2%
2016-01,תל אביב,6600,חולון,2998,1387,1611,466,2532,682,2933,62,3%
2016-01,תל אביב,2620,קריית אונו,397,179,218,151,246,37,395,2,2%
2016-01,תל אביב,8600,רמת גן,1958,930,1028,685,1273,376,1925,45,2%
2016-01,תל אביב,2650,רמת השרון,370,152,218,160,210,13,363,10,2%
2016-01,תל אביב,5000,תל אביב -יפו,7160,3503,3657,2353,4807,1876,7016,108,3%
2016-02,אזור יהודה והשומרון,3760,אורנית,105,51,54,35,70,3,105,0,2%
2016-02,אזור יהודה והשומרון,3750,אלפי מנשה,100,48,52,23,77,2,99,0,2%
2016-02,אזור יהודה והשומרון,3560,אלקנה,39,17,22,15,24,0,38,1,2%
2016-02,אזור יהודה והשומרון,3650,אפרת,72,36,36,40,32,2,72,1,2%
2016-02,אזור יהודה והשומרון,3570,אריאל,297,131,166,76,221,41,296,10,3%
2016-02,אזור יהודה והשומרון,3574,בית אל,50,27,23,13,37,17,49,1,2%
2016-02,אזור יהודה והשומרון,3652,בית אריה,56,18,38,14,42,2,56,0,2%
2016-02,אזור יהודה והשומרון,3780,ביתר עילית,516,250,266,7,509,230,513,6,4%
2016-02,אזור יהודה והשומרון,3730,גבעת זאב,203,99,104,39,164,38,202,3,3%
2016-02,אזור יהודה והשומרון,3769,הר אדר,42,17,25,23,19,4,42,0,2%
2016-02,אזור יהודה והשומרון,3797,מודיעין עילית,362,116,246,24,338,40,361,4,3%
2016-02,אזור יהודה והשומרון,3616,מעלה אדומים,618,265,353,91,527,170,611,17,3%
2016-02,אזור יהודה והשומרון,3660,עמנואל,58,29,29,0,58,32,55,1,5%
2016-02,אזור יהודה והשומרון,3557,קדומים,36,22,14,11,25,4,36,0,2%
2016-02,אזור יהודה והשומרון,3611,קריית ארבע,105,53,52,11,94,52,104,6,3%
2016-02,אזור יהודה והשומרון,3640,קרני שומרון,72,37,35,20,52,5,72,0,2%
2016-02,הדרום,31,אופקים,976,409,567,53,923,565,946,49,8%
2016-02,הדרום,2600,אילת,1455,721,734,72,1383,484,1400,41,4%
2016-02,הדרום,70,אשדוד,5591,2373,3218,685,4906,2676,5360,139,5%
2016-02,הדרום,7100,אשקלון,3757,1580,2177,394,3363,1918,3243,125,5%
2016-02,הדרום,9000,באר שבע,6102,2711,3391,796,5306,3317,5812,172,6%
2016-02,הדרום,2200,דימונה,1854,810,1044,97,1757,1218,1764,48,10%
2016-02,הדרום,1303,חורה,670,275,395,1,669,596,658,8,17%
2016-02,הדרום,831,ירוחם,374,209,165,15,359,218,359,35,8%
2016-02,הדרום,1059,כסיפה,1049,433,616,3,1046,924,1036,9,22%
2016-02,הדרום,1271,להבים,42,23,19,22,20,3,41,1,1%
2016-02,הדרום,1060,לקיה,728,315,413,2,726,661,714,6,18%
2016-02,הדרום,1268,מיתר,65,27,38,25,40,8,63,1,1%
2016-02,הדרום,99,מצפה רמון,264,116,148,24,240,155,254,17,10%
2016-02,הדרום,246,נתיבות,918,421,497,36,882,472,873,65,6%
2016-02,הדרום,666,עומר,53,19,34,30,23,2,53,1,1%
2016-02,הדרום,2560,ערד,728,338,390,80,648,361,696,47,6%
2016-02,הדרום,1192,ערערה-בנגב,1067,441,626,5,1062,984,1052,2,25%
2016-02,הדרום,2630,קריית גת,1896,765,1131,116,1780,925,1814,47,6%
2016-02,הדרום,1034,קריית מלאכי,904,406,498,23,881,445,864,77,8%
2016-02,הדרום,1161,רהט,2663,1137,1526,7,2656,2246,2623,82,14%
2016-02,הדרום,1286,שגב-שלום,427,156,271,3,424,362,417,5,16%
2016-02,הדרום,1031,שדרות,929,436,493,56,873,529,861,22,7%
2016-02,הדרום,1054,תל שבע,921,407,514,4,917,844,899,15,19%
2016-02,המרכז,182,אבן יהודה,150,64,86,41,109,15,150,1,2%
2016-02,המרכז,41,אליכין,70,40,30,7,63,20,67,2,4%
2016-02,המרכז,1309,אלעד,356,177,179,24,332,48,350,4,3%
2016-02,המרכז,2530,באר יעקב,234,92,142,59,175,42,231,5,3%
2016-02,המרכז,466,בית דגן,81,51,30,4,77,33,79,4,2%
2016-02,המרכז,1066,"בני עי""ש",159,72,87,33,126,50,158,6,4%
2016-02,המרכז,681,גבעת שמואל,240,129,111,74,166,48,234,1,2%
2016-02,המרכז,2550,גדרה,317,134,183,64,253,80,310,11,3%
2016-02,המרכז,627,ג'לג'וליה,91,38,53,3,88,60,86,2,2%
2016-02,המרכז,166,גן יבנה,293,133,160,50,243,69,283,9,3%
2016-02,המרכז,229,גני תקווה,181,86,95,65,116,26,181,1,2%
2016-02,המרכז,9700,הוד השרון,623,266,357,252,371,53,614,13,2%
2016-02,המרכז,1290,זמר,144,49,95,3,141,89,143,7,5%
2016-02,המרכז,2730,טייבה,1267,549,718,12,1255,973,1107,40,7%
2016-02,המרכז,2720,טירה,224,113,111,11,213,93,219,9,2%
2016-02,המרכז,2660,יבנה,738,365,373,116,622,234,733,27,3%
2016-02,המרכז,9400,יהוד,378,175,203,93,285,44,372,7,2%
2016-02,המרכז,1224,כוכב יאיר,90,40,50,44,46,2,90,1,2%
2016-02,המרכז,633,כפר ברא,23,12,11,1,22,11,22,0,2%
2016-02,המרכז,168,כפר יונה,313,144,169,54,259,41,310,2,3%
2016-02,המרכז,6900,כפר סבא,1215,567,648,398,817,124,1195,24,2%
2016-02,המרכז,634,כפר קאסם,244,107,137,12,232,135,233,2,3%
2016-02,המרכז,7000,לוד,1946,915,1031,136,1810,1013,1910,61,5%
2016-02,המרכז,1200,מודיעין-מכבים-רעות*,935,400,535,357,578,65,920,18,2%
2016-02,המרכז,28,מזכרת בתיה,141,56,85,41,100,26,141,2,2%
2016-02,המרכז,7200,נס ציונה,638,291,347,179,459,156,633,13,3%
2016-02,המרכז,7400,נתניה,4152,1970,2182,440,3712,1372,4061,100,4%
2016-02,המרכז,587,סביון*,15,2,13,9,6,0,15,0,1%
2016-02,המרכז,171,פרדסייה,85,36,49,16,69,7,85,0,2%
2016-02,המרכז,7900,פתח תקווה,3701,1651,2050,801,2900,963,3591,53,3%
2016-02,המרכז,195,קדימה-צורן,225,89,136,47,178,34,224,0,2%
2016-02,המרכז,638,קלנסווה,511,243,268,6,505,376,468,16,6%
2016-02,המרכז,469,קריית עקרון,226,127,99,22,204,92,223,10,4%
2016-02,המרכז,2640,ראש העין,697,345,352,87,610,137,688,23,3%
2016-02,המרכז,8300,ראשון לציון,4155,1834,2321,792,3363,1192,4118,98,3%
2016-02,המרכז,8400,רחובות,2124,987,1137,500,1624,731,2068,84,3%
2016-02,המרכז,8500,רמלה,1554,763,791,104,1450,656,1490,63,4%
2016-02,המרכז,8700,רעננה,666,307,359,257,409,51,660,16,2%
2016-02,המרכז,1304,שוהם,179,87,92,80,99,9,178,1,2%
2016-02,המרכז,154,תל מונד,138,63,75,40,98,18,137,0,2%
2016-02,הצפון,473,אבו סנאן,618,268,350,6,612,495,611,9,11%
2016-02,הצפון,478,אכסאל,529,254,275,7,522,445,519,6,9%
2016-02,הצפון,529,אעבלין,533,225,308,8,525,446,521,13,9%
2016-02,הצפון,482,בועיינה-נוג'ידאת,353,155,198,11,342,284,338,4,9%
2016-02,הצפון,4001,בוקעאתא,370,135,235,3,367,307,360,3,13%
2016-02,הצפון,998,ביר אל-מכסור,383,155,228,3,380,303,379,1,10%
2016-02,הצפון,480,בית ג'ן,403,129,274,6,397,273,390,2,7%
2016-02,הצפון,9200,בית שאן,819,371,448,23,796,381,796,61,8%
2016-02,הצפון,944,בסמת טבעון,195,94,101,4,191,142,188,2,6%
2016-02,הצפון,483,בענה,355,148,207,7,348,306,350,19,11%
2016-02,הצפון,1292,ג'דיידה-מכר,1212,532,680,8,1204,995,1188,20,13%
2016-02,הצפון,485,ג'ולס,240,78,162,0,240,145,237,8,8%
2016-02,הצפון,487,ג'ש (גוש חלב),66,27,39,4,62,31,63,1,4%
2016-02,הצפון,489,דבורייה,356,158,198,15,341,256,352,4,8%
2016-02,הצפון,490,דייר אל-אסד,363,153,210,10,353,289,357,6,7%
2016-02,הצפון,492,דייר חנא,636,280,356,6,630,496,626,2,13%
2016-02,הצפון,975,זרזיר,269,115,154,2,267,184,261,10,9%
2016-02,הצפון,496,חורפיש,111,57,54,9,102,59,107,3,4%
2016-02,הצפון,2034,חצור הגלילית,271,119,152,10,261,137,250,4,5%
2016-02,הצפון,6700,טבריה,1636,773,863,82,1554,831,1438,61,7%
2016-02,הצפון,962,טובא-זנגרייה,378,176,202,4,374,262,368,1,12%
2016-02,הצפון,498,טורעאן,494,220,274,14,480,386,470,10,8%
2016-02,הצפון,8900,טמרה,1621,761,860,21,1600,1390,1583,16,12%
2016-02,הצפון,1295,יאנוח-ג'ת,158,55,103,6,152,94,154,5,6%
2016-02,הצפון,46,יבנאל,128,82,46,6,122,73,102,1,7%
2016-02,הצפון,499,יפיע,622,275,347,19,603,467,609,9,8%
2016-02,הצפון,240,יקנעם עילית,482,205,277,84,398,118,477,28,4%
2016-02,הצפון,502,ירכא,535,219,316,2,533,420,526,8,9%
2016-02,הצפון,504,כאבול,578,264,314,10,568,499,565,4,12%
2016-02,הצפון,505,כאוכב אבו אל-היג'א,222,90,132,5,217,186,217,0,13%
2016-02,הצפון,1296,כסרא-סמיע,201,83,118,6,195,138,193,3,6%
2016-02,הצפון,978,כעביה-טבאש-חג'אג'רה,186,73,113,6,180,127,183,2,8%
2016-02,הצפון,1263,כפר ורדים,67,32,35,25,42,7,65,0,2%
2016-02,הצפון,507,כפר יאסיף,436,189,247,3,433,319,423,20,8%
2016-02,הצפון,508,כפר כמא,59,27,32,5,54,27,59,3,4%
2016-02,הצפון,509,כפר כנא,1079,482,597,25,1054,901,1003,19,11%
2016-02,הצפון,510,כפר מנדא,801,391,410,9,792,656,774,6,11%
2016-02,הצפון,47,כפר תבור,41,19,22,23,18,1,40,0,2%
2016-02,הצפון,1139,כרמיאל,1502,610,892,243,1259,715,1435,45,6%
2016-02,הצפון,481,מגאר,1335,550,785,22,1313,1112,1286,13,14%
2016-02,הצפון,516,מג'ד אל-כרום,489,235,254,10,479,366,479,8,7%
2016-02,הצפון,874,מגדל העמק,897,396,501,91,806,313,848,77,6%
2016-02,הצפון,4201,מג'דל שמס,445,164,281,10,435,353,422,2,9%
2016-02,הצפון,517,מזרעה,163,71,92,3,160,122,155,0,8%
2016-02,הצפון,4203,מסעדה,208,76,132,4,204,175,197,1,12%
2016-02,הצפון,518,מעיליא,41,21,20,7,34,22,41,1,3%
2016-02,הצפון,1063,מעלות-תרשיחא,820,398,422,100,720,415,805,36,7%
2016-02,הצפון,520,משהד,259,111,148,8,251,214,242,6,8%
2016-02,הצפון,9100,נהרייה,1895,913,982,202,1693,969,1814,74,6%
2016-02,הצפון,522,נחף,406,193,213,21,385,312,400,8,8%
2016-02,הצפון,7300,נצרת,3087,1361,1726,115,2972,2383,3027,29,9%
2016-02,הצפון,1061,נצרת עילית,1672,753,919,169,1503,862,1496,91,6%
2016-02,הצפון,525,סאג'ור,116,44,72,3,113,76,115,0,6%
2016-02,הצפון,7500,סח'נין,2124,930,1194,36,2088,1778,2090,4,15%
2016-02,הצפון,4501,ע'ג'ר,99,43,56,3,96,61,97,1,9%
2016-02,הצפון,530,עיילבון,176,83,93,6,170,113,172,0,6%
2016-02,הצפון,511,עילוט,307,118,189,5,302,258,300,1,11%
2016-02,הצפון,532,עין מאהל,504,248,256,12,492,380,489,3,9%
2016-02,הצפון,7600,עכו,3059,1402,1657,123,2936,2208,2963,59,11%
2016-02,הצפון,7700,עפולה,1595,680,915,156,1439,639,1509,86,6%
2016-02,הצפון,531,עראבה,1581,694,887,38,1543,1355,1547,4,15%
2016-02,הצפון,535,פסוטה,105,51,54,3,102,58,104,3,6%
2016-02,הצפון,536,פקיעין (בוקייעה),120,62,58,6,114,74,119,1,4%
2016-02,הצפון,8000,צפת,1313,703,610,78,1235,935,1219,20,9%
2016-02,הצפון,4100,קצרין,226,85,141,35,191,94,221,5,6%
2016-02,הצפון,2800,קריית שמונה,783,362,421,63,720,323,752,32,6%
2016-02,הצפון,543,ראמה,277,117,160,11,266,201,271,1,7%
2016-02,הצפון,26,ראש פינה,47,17,30,10,37,19,45,0,3%
2016-02,הצפון,542,ריינה,590,252,338,9,581,464,558,8,8%
2016-02,הצפון,122,רמת ישי,89,37,52,34,55,9,87,1,2%
2016-02,הצפון,913,שבלי - אום אל-גנם,211,89,122,6,205,139,210,1,8%
2016-02,הצפון,812,שלומי,224,94,130,13,211,96,218,10,6%
2016-02,הצפון,538,שעב,523,212,311,5,518,465,518,1,17%
2016-02,הצפון,8800,שפרעם,1795,725,1070,33,1762,1399,1761,34,10%
2016-02,חיפה,2710,אום אל-פחם,3320,1407,1913,48,3272,2773,3268,38,16%
2016-02,חיפה,1020,אור עקיבא,470,220,250,44,426,149,457,21,5%
2016-02,חיפה,6000,באקה אל-גרביה,637,323,314,15,622,360,628,23,5%
2016-02,חיפה,9800,בנימינה-גבעת עדה*,185,77,108,61,124,64,182,0,3%
2016-02,חיפה,1326,"בסמ""ה",396,179,217,6,390,302,392,4,10%
2016-02,חיפה,541,ג'סר א-זרקא,457,239,218,5,452,333,449,8,8%
2016-02,חיפה,628,ג'ת,201,99,102,6,195,112,197,10,4%
2016-02,חיפה,494,דאלית אל-כרמל,479,197,282,16,463,261,451,7,6%
2016-02,חיפה,9300,זכרון יעקב,262,121,141,85,177,52,257,1,2%
2016-02,חיפה,6500,חדרה,2313,1024,1289,266,2047,813,2174,74,4%
2016-02,חיפה,4000,חיפה,6034,3019,3015,1131,4903,3029,5724,166,4%
2016-02,חיפה,1247,חריש,56,30,26,0,56,22,52,1,3%
2016-02,חיפה,2100,טירת כרמל,640,320,320,35,605,357,625,23,6%
2016-02,חיפה,654,כפר קרע,386,186,200,17,369,237,379,14,5%
2016-02,חיפה,1327,מעלה עירון,813,312,501,11,802,669,805,9,14%
2016-02,חיפה,2500,נשר,413,210,203,79,334,141,399,7,3%
2016-02,חיפה,534,עספיא,290,125,165,16,274,163,270,11,5%
2016-02,חיפה,637,ערערה,548,241,307,6,542,355,536,15,7%
2016-02,חיפה,537,פוריידיס,417,221,196,12,405,275,408,2,7%
2016-02,חיפה,7800,פרדס חנה-כרכור,834,370,464,171,663,265,812,29,4%
2016-02,חיפה,6800,קריית אתא,1563,711,852,123,1440,785,1515,53,5%
2016-02,חיפה,9500,קריית ביאליק,989,413,576,117,872,463,969,31,5%
2016-02,חיפה,2300,קריית טבעון,175,70,105,63,112,36,172,2,2%
2016-02,חיפה,9600,קריית ים,1385,652,733,124,1261,772,1350,45,6%
2016-02,חיפה,8200,קריית מוצקין,1018,456,562,143,875,440,982,31,4%
2016-02,חיפה,922,רכסים,171,85,86,11,160,81,156,1,5%
2016-02,ירושלים,472,אבו גוש,262,137,125,7,255,188,260,2,9%
2016-02,ירושלים,2610,בית שמש,1187,528,659,81,1106,463,1140,39,4%
2016-02,ירושלים,3000,ירושלים,12168,5555,6613,1327,10841,7519,11859,165,4%
2016-02,ירושלים,1015,מבשרת ציון,362,179,183,91,271,121,353,6,3%
2016-02,ירושלים,1137,קריית יערים,43,17,26,9,34,16,43,0,3%
2016-02,תל אביב,2400,אור יהודה,727,356,371,47,680,165,696,35,4%
2016-02,תל אביב,565,אזור,191,84,107,30,161,27,189,3,3%
2016-02,תל אביב,6100,בני ברק,1850,934,916,83,1767,841,1743,25,3%
2016-02,תל אביב,6200,בת ים,2819,1349,1470,380,2439,978,2703,78,4%
2016-02,תל אביב,6300,גבעתיים,699,298,401,323,376,79,697,6,2%
2016-02,תל אביב,6400,הרצלייה,1000,437,563,328,672,25,986,32,2%
2016-02,תל אביב,6600,חולון,2924,1358,1566,438,2486,654,2855,63,3%
2016-02,תל אביב,2620,קריית אונו,377,159,218,137,240,43,374,6,2%
2016-02,תל אביב,8600,רמת גן,1930,899,1031,668,1262,364,1893,39,2%
2016-02,תל אביב,2650,רמת השרון,362,158,204,154,208,9,358,4,2%
2016-02,תל אביב,5000,תל אביב -יפו,7158,3529,3629,2392,4766,1812,7041,160,3%
2016-03,אזור יהודה והשומרון,3760,אורנית,96,47,49,38,58,4,95,0,2%
2016-03,אזור יהודה והשומרון,3750,אלפי מנשה,91,41,50,27,64,3,90,1,2%
2016-03,אזור יהודה והשומרון,3560,אלקנה,32,12,20,11,21,0,32,0,2%
2016-03,אזור יהודה והשומרון,3650,אפרת,74,36,38,38,36,2,74,1,2%
2016-03,אזור יהודה והשומרון,3570,אריאל,313,134,179,73,240,41,311,11,3%
2016-03,אזור יהודה והשומרון,3574,בית אל,53,27,26,16,37,20,51,0,2%
2016-03,אזור יהודה והשומרון,3652,בית אריה,61,19,42,17,44,1,61,1,2%
2016-03,אזור יהודה והשומרון,3780,ביתר עילית,503,229,274,8,495,223,499,7,4%
2016-03,אזור יהודה והשומרון,3730,גבעת זאב,202,91,111,46,156,36,199,3,3%
2016-03,אזור יהודה והשומרון,3769,הר אדר,41,14,27,21,20,3,41,0,2%
2016-03,אזור יהודה והשומרון,3797,מודיעין עילית,351,108,243,22,329,38,347,5,3%
2016-03,אזור יהודה והשומרון,3616,מעלה אדומים,635,283,352,85,550,173,631,18,3%
2016-03,אזור יהודה והשומרון,3660,עמנואל,60,32,28,0,60,33,59,2,5%
2016-03,אזור יהודה והשומרון,3557,קדומים,39,24,15,9,30,5,39,0,2%
2016-03,אזור יהודה והשומרון,3611,קריית ארבע,102,53,49,11,91,52,100,4,3%
2016-03,אזור יהודה והשומרון,3640,קרני שומרון,68,33,35,19,49,5,68,1,2%
2016-03,הדרום,31,אופקים,939,400,539,55,884,565,902,41,7%
2016-03,הדרום,2600,אילת,1329,665,664,68,1261,464,1279,53,4%
2016-03,הדרום,70,אשדוד,5549,2378,3171,678,4871,2595,5289,160,5%
2016-03,הדרום,7100,אשקלון,3719,1540,2179,388,3331,1897,3209,135,5%
2016-03,הדרום,9000,באר שבע,5993,2649,3344,783,5210,3296,5688,177,6%
2016-03,הדרום,2200,דימונה,1866,817,1049,97,1769,1193,1773,73,10%
2016-03,הדרום,1303,חורה,644,262,382,2,642,575,632,5,16%
2016-03,הדרום,831,ירוחם,360,197,163,15,345,216,349,28,8%
2016-03,הדרום,1059,כסיפה,1033,412,621,3,1030,922,1022,8,22%
2016-03,הדרום,1271,להבים,38,18,20,20,18,2,38,0,1%
2016-03,הדרום,1060,לקיה,735,313,422,2,733,650,725,4,18%
2016-03,הדרום,1268,מיתר,65,28,37,24,41,7,64,1,2%
2016-03,הדרום,99,מצפה רמון,225,91,134,20,205,149,221,12,9%
2016-03,הדרום,246,נתיבות,886,408,478,32,854,469,837,64,6%
2016-03,הדרום,666,עומר,61,24,37,30,31,2,60,1,1%
2016-03,הדרום,2560,ערד,707,331,376,78,629,352,679,47,6%
2016-03,הדרום,1192,ערערה-בנגב,1078,441,637,4,1074,969,1062,1,25%
2016-03,הדרום,2630,קריית גת,1825,739,1086,118,1707,907,1753,71,6%
2016-03,הדרום,1034,קריית מלאכי,826,372,454,16,810,404,788,78,7%
2016-03,הדרום,1161,רהט,2655,1131,1524,11,2644,2214,2619,42,14%
2016-03,הדרום,1286,שגב-שלום,426,159,267,3,423,366,416,9,16%
2016-03,הדרום,1031,שדרות,915,410,505,53,862,532,840,28,7%
2016-03,הדרום,1054,תל שבע,903,403,500,6,897,821,878,22,19%
2016-03,המרכז,182,אבן יהודה,144,70,74,39,105,14,144,0,2%
2016-03,המרכז,41,אליכין,64,32,32,8,56,18,62,7,3%
2016-03,המרכז,1309,אלעד,340,170,170,24,316,50,336,3,3%
2016-03,המרכז,2530,באר יעקב,233,85,148,63,170,43,232,7,3%
2016-03,המרכז,466,בית דגן,87,46,41,6,81,33,85,3,2%
2016-03,המרכז,1066,"בני עי""ש",149,72,77,35,114,46,148,4,4%
2016-03,המרכז,681,גבעת שמואל,241,128,113,74,167,51,233,3,2%
2016-03,המרכז,2550,גדרה,326,135,191,75,251,78,318,8,3%
2016-03,המרכז,627,ג'לג'וליה,108,49,59,3,105,68,102,1,3%
2016-03,המרכז,166,גן יבנה,284,123,161,44,240,64,275,7,2%
2016-03,המרכז,229,גני תקווה,181,86,95,59,122,28,180,1,2%
2016-03,המרכז,9700,הוד השרון,599,264,335,246,353,54,594,8,2%
2016-03,המרכז,1290,זמר,146,45,101,4,142,91,145,6,5%
2016-03,המרכז,2730,טייבה,1256,542,714,15,1241,972,1103,45,7%
2016-03,המרכז,2720,טירה,230,113,117,9,221,95,224,19,2%
2016-03,המרכז,2660,יבנה,694,333,361,107,587,220,688,23,3%
2016-03,המרכז,9400,יהוד,384,181,203,94,290,48,380,6,2%
2016-03,המרכז,1224,כוכב יאיר,86,43,43,49,37,2,86,0,2%
2016-03,המרכז,633,כפר ברא,24,12,12,1,23,13,23,0,2%
2016-03,המרכז,168,כפר יונה,324,145,179,55,269,43,321,6,3%
2016-03,המרכז,6900,כפר סבא,1187,536,651,403,784,119,1169,31,2%
2016-03,המרכז,634,כפר קאסם,228,102,126,11,217,130,221,6,3%
2016-03,המרכז,7000,לוד,1888,869,1019,133,1755,991,1838,58,5%
2016-03,המרכז,1200,מודיעין-מכבים-רעות*,913,390,523,351,562,60,902,16,2%
2016-03,המרכז,28,מזכרת בתיה,134,60,74,45,89,26,132,1,2%
2016-03,המרכז,7200,נס ציונה,627,283,344,177,450,161,618,15,3%
2016-03,המרכז,7400,נתניה,4095,1944,2151,470,3625,1371,4004,82,4%
2016-03,המרכז,587,סביון*,15,1,14,8,7,0,15,0,1%
2016-03,המרכז,171,פרדסייה,78,37,41,18,60,5,77,0,2%
2016-03,המרכז,7900,פתח תקווה,3651,1635,2016,780,2871,960,3562,54,3%
2016-03,המרכז,195,קדימה-צורן,233,96,137,56,177,38,230,0,2%
2016-03,המרכז,638,קלנסווה,495,232,263,6,489,372,453,15,5%
2016-03,המרכז,469,קריית עקרון,236,131,105,24,212,87,231,12,4%
2016-03,המרכז,2640,ראש העין,673,334,339,89,584,138,661,17,3%
2016-03,המרכז,8300,ראשון לציון,4110,1814,2296,785,3325,1204,4070,106,3%
2016-03,המרכז,8400,רחובות,2086,949,1137,474,1612,707,2033,67,3%
2016-03,המרכז,8500,רמלה,1535,753,782,96,1439,659,1474,71,4%
2016-03,המרכז,8700,רעננה,660,296,364,260,400,45,653,4,2%
2016-03,המרכז,1304,שוהם,172,86,86,75,97,10,170,1,2%
2016-03,המרכז,154,תל מונד,134,59,75,44,90,16,134,2,2%
2016-03,הצפון,473,אבו סנאן,610,256,354,6,604,487,603,14,11%
2016-03,הצפון,478,אכסאל,530,252,278,9,521,437,523,5,9%
2016-03,הצפון,529,אעבלין,514,221,293,7,507,428,504,4,9%
2016-03,הצפון,482,בועיינה-נוג'ידאת,343,144,199,10,333,262,334,3,9%
2016-03,הצפון,4001,בוקעאתא,370,132,238,4,366,309,360,0,13%
2016-03,הצפון,998,ביר אל-מכסור,380,154,226,5,375,296,374,0,10%
2016-03,הצפון,480,בית ג'ן,403,122,281,9,394,275,391,1,7%
2016-03,הצפון,9200,בית שאן,771,359,412,20,751,371,744,74,7%
2016-03,הצפון,944,בסמת טבעון,197,93,104,4,193,141,189,2,6%
2016-03,הצפון,483,בענה,334,140,194,9,325,285,329,12,10%
2016-03,הצפון,1292,ג'דיידה-מכר,1216,529,687,5,1211,988,1195,25,13%
2016-03,הצפון,485,ג'ולס,227,71,156,0,227,142,225,8,8%
2016-03,הצפון,487,ג'ש (גוש חלב),67,31,36,6,61,32,64,2,4%
2016-03,הצפון,489,דבורייה,349,149,200,16,333,256,345,4,8%
2016-03,הצפון,490,דייר אל-אסד,351,151,200,11,340,280,347,13,7%
2016-03,הצפון,492,דייר חנא,632,283,349,7,625,504,621,8,13%
2016-03,הצפון,975,זרזיר,248,107,141,3,245,174,244,9,8%
2016-03,הצפון,496,חורפיש,114,54,60,10,104,66,108,5,4%
2016-03,הצפון,2034,חצור הגלילית,267,119,148,14,253,143,243,8,5%
2016-03,הצפון,6700,טבריה,1604,768,836,84,1520,800,1425,87,7%
2016-03,הצפון,962,טובא-זנגרייה,383,175,208,5,378,265,370,0,12%
2016-03,הצפון,498,טורעאן,470,202,268,15,455,372,451,6,8%
2016-03,הצפון,8900,טמרה,1577,736,841,20,1557,1361,1548,20,11%
2016-03,הצפון,1295,יאנוח-ג'ת,167,60,107,6,161,95,164,7,6%
2016-03,הצפון,46,יבנאל,118,72,46,7,111,68,94,2,6%
2016-03,הצפון,499,יפיע,618,281,337,19,599,456,609,8,8%
2016-03,הצפון,240,יקנעם עילית,487,214,273,91,396,120,479,24,4%
2016-03,הצפון,502,ירכא,536,220,316,0,536,419,529,6,9%
2016-03,הצפון,504,כאבול,566,261,305,13,553,487,554,4,12%
2016-03,הצפון,505,כאוכב אבו אל-היג'א,226,89,137,7,219,186,221,1,13%
2016-03,הצפון,1296,כסרא-סמיע,212,91,121,5,207,148,200,3,6%
2016-03,הצפון,978,כעביה-טבאש-חג'אג'רה,183,81,102,4,179,125,179,2,8%
2016-03,הצפון,1263,כפר ורדים,67,30,37,28,39,5,66,1,2%
2016-03,הצפון,507,כפר יאסיף,424,185,239,4,420,313,413,12,8%
2016-03,הצפון,508,כפר כמא,61,30,31,4,57,28,60,0,4%
2016-03,הצפון,509,כפר כנא,1024,456,568,24,1000,828,974,22,11%
2016-03,הצפון,510,כפר מנדא,760,375,385,9,751,625,744,6,10%
2016-03,הצפון,47,כפר תבור,43,20,23,20,23,1,42,1,2%
2016-03,הצפון,1139,כרמיאל,1470,573,897,240,1230,711,1397,45,5%
2016-03,הצפון,481,מגאר,1317,548,769,17,1300,1107,1270,10,14%
2016-03,הצפון,516,מג'ד אל-כרום,481,231,250,8,473,359,469,19,7%
2016-03,הצפון,874,מגדל העמק,868,400,468,80,788,310,818,74,6%
2016-03,הצפון,4201,מג'דל שמס,451,171,280,9,442,361,424,5,9%
2016-03,הצפון,517,מזרעה,164,71,93,3,161,122,158,5,8%
2016-03,הצפון,4203,מסעדה,209,78,131,5,204,172,197,4,12%
2016-03,הצפון,518,מעיליא,48,25,23,4,44,25,46,0,3%
2016-03,הצפון,1063,מעלות-תרשיחא,814,405,409,87,727,427,790,40,7%
2016-03,הצפון,520,משהד,264,109,155,7,257,202,255,5,8%
2016-03,הצפון,9100,נהרייה,1828,884,944,200,1628,965,1763,75,6%
2016-03,הצפון,522,נחף,395,190,205,17,378,307,387,14,8%
2016-03,הצפון,7300,נצרת,3101,1379,1722,127,2974,2383,3046,35,9%
2016-03,הצפון,1061,נצרת עילית,1585,724,861,166,1419,810,1416,93,6%
2016-03,הצפון,525,סאג'ור,116,44,72,3,113,72,114,0,6%
2016-03,הצפון,7500,סח'נין,2137,924,1213,37,2100,1797,2095,18,15%
2016-03,הצפון,4501,ע'ג'ר,95,40,55,3,92,61,94,1,9%
2016-03,הצפון,530,עיילבון,169,81,88,5,164,108,165,1,6%
2016-03,הצפון,511,עילוט,324,125,199,5,319,266,321,0,11%
2016-03,הצפון,532,עין מאהל,462,227,235,11,451,354,452,1,9%
2016-03,הצפון,7600,עכו,3043,1408,1635,136,2907,2190,2942,70,11%
2016-03,הצפון,7700,עפולה,1537,665,872,161,1376,627,1447,89,6%
2016-03,הצפון,531,עראבה,1574,685,889,36,1538,1355,1542,11,15%
2016-03,הצפון,535,פסוטה,110,56,54,2,108,62,108,1,6%
2016-03,הצפון,536,פקיעין (בוקייעה),120,67,53,6,114,75,116,1,4%
2016-03,הצפון,8000,צפת,1265,703,562,83,1182,900,1176,22,9%
2016-03,הצפון,4100,קצרין,204,75,129,36,168,90,200,4,5%
2016-03,הצפון,2800,קריית שמונה,772,355,417,63,709,311,739,38,6%
2016-03,הצפון,543,ראמה,276,113,163,8,268,204,272,4,7%
2016-03,הצפון,26,ראש פינה,46,17,29,9,37,19,45,0,3%
2016-03,הצפון,542,ריינה,553,243,310,9,544,437,533,8,8%
2016-03,הצפון,122,רמת ישי,100,43,57,36,64,10,97,1,2%
2016-03,הצפון,913,שבלי - אום אל-גנם,209,83,126,5,204,136,207,3,8%
2016-03,הצפון,812,שלומי,221,95,126,16,205,103,215,6,6%
2016-03,הצפון,538,שעב,538,221,317,3,535,479,529,3,17%
2016-03,הצפון,8800,שפרעם,1726,699,1027,32,1694,1345,1696,31,10%
2016-03,חיפה,2710,אום אל-פחם,3236,1370,1866,46,3190,2717,3181,44,16%
2016-03,חיפה,1020,אור עקיבא,477,232,245,47,430,134,462,12,5%
2016-03,חיפה,6000,באקה אל-גרביה,589,291,298,17,572,353,581,30,5%
2016-03,חיפה,9800,בנימינה-גבעת עדה*,175,72,103,54,121,57,174,2,2%
2016-03,חיפה,1326,"בסמ""ה",403,181,222,7,396,301,396,6,10%
2016-03,חיפה,541,ג'סר א-זרקא,451,233,218,5,446,322,448,12,8%
2016-03,חיפה,628,ג'ת,206,101,105,9,197,112,203,4,4%
2016-03,חיפה,494,דאלית אל-כרמל,471,178,293,15,456,255,439,7,6%
2016-03,חיפה,9300,זכרון יעקב,264,117,147,81,183,47,260,3,2%
2016-03,חיפה,6500,חדרה,2226,972,1254,239,1987,812,2079,62,4%
2016-03,חיפה,4000,חיפה,5879,2938,2941,1088,4791,2974,5589,181,4%
2016-03,חיפה,1247,חריש,64,36,28,2,62,24,56,1,4%
2016-03,חיפה,2100,טירת כרמל,637,314,323,34,603,353,619,18,6%
2016-03,חיפה,654,כפר קרע,389,183,206,17,372,245,378,9,5%
2016-03,חיפה,1327,מעלה עירון,806,310,496,11,795,668,789,12,14%
2016-03,חיפה,2500,נשר,424,218,206,86,338,143,407,10,3%
2016-03,חיפה,534,עספיא,305,133,172,18,287,163,284,8,5%
2016-03,חיפה,637,ערערה,557,246,311,9,548,364,535,12,7%
2016-03,חיפה,537,פוריידיס,403,219,184,11,392,271,397,3,7%
2016-03,חיפה,7800,פרדס חנה-כרכור,830,371,459,165,665,249,808,34,4%
2016-03,חיפה,6800,קריית אתא,1510,695,815,111,1399,763,1472,37,5%
2016-03,חיפה,9500,קריית ביאליק,987,416,571,102,885,468,965,31,5%
2016-03,חיפה,2300,קריית טבעון,177,72,105,58,119,40,174,4,2%
2016-03,חיפה,9600,קריית ים,1383,646,737,128,1255,804,1338,41,6%
2016-03,חיפה,8200,קריית מוצקין,1012,457,555,149,863,437,979,29,4%
2016-03,חיפה,922,רכסים,167,82,85,10,157,80,150,3,4%
2016-03,ירושלים,472,אבו גוש,261,130,131,7,254,190,259,2,8%
2016-03,ירושלים,2610,בית שמש,1156,522,634,83,1073,455,1119,34,4%
2016-03,ירושלים,3000,ירושלים,12041,5478,6563,1324,10717,7511,11752,155,4%
2016-03,ירושלים,1015,מבשרת ציון,366,179,187,86,280,121,360,7,3%
2016-03,ירושלים,1137,קריית יערים,52,18,34,12,40,16,52,2,4%
2016-03,תל אביב,2400,אור יהודה,705,353,352,55,650,173,671,40,4%
2016-03,תל אביב,565,אזור,194,92,102,31,163,31,190,3,3%
2016-03,תל אביב,6100,בני ברק,1818,908,910,84,1734,837,1715,21,3%
2016-03,תל אביב,6200,בת ים,2789,1282,1507,373,2416,974,2667,93,4%
2016-03,תל אביב,6300,גבעתיים,695,304,391,321,374,77,691,9,2%
2016-03,תל אביב,6400,הרצלייה,1034,454,580,345,689,35,1021,29,2%
2016-03,תל אביב,6600,חולון,2911,1351,1560,426,2485,680,2829,44,3%
2016-03,תל אביב,2620,קריית אונו,373,169,204,143,230,46,369,5,2%
2016-03,תל אביב,8600,רמת גן,1863,872,991,646,1217,362,1825,32,2%
2016-03,תל אביב,2650,רמת השרון,377,165,212,154,223,12,371,14,2%
2016-03,תל אביב,5000,תל אביב -יפו,7056,3529,3527,2322,4734,1802,6927,149,3%
2016-04,אזור יהודה והשומרון,3760,אורנית,86,46,40,30,56,1,86,0,2%
2016-04,אזור יהודה והשומרון,3750,אלפי מנשה,67,33,34,19,48,2,67,3,2%
2016-04,אזור יהודה והשומרון,3560,אלקנה,26,8,18,12,14,0,26,0,1%
2016-04,אזור יהודה והשומרון,3650,אפרת,62,26,36,34,28,2,62,1,2%
2016-04,אזור יהודה והשומרון,3570,אריאל,281,120,161,74,207,39,278,10,3%
2016-04,אזור יהודה והשומרון,3574,בית אל,43,22,21,10,33,17,41,0,2%
2016-04,אזור יהודה והשומרון,3652,בית אריה,47,15,32,18,29,0,47,0,2%
2016-04,אזור יהודה והשומרון,3780,ביתר עילית,481,219,262,9,472,220,477,1,4%
2016-04,אזור יהודה והשומרון,3730,גבעת זאב,188,85,103,42,146,34,187,1,2%
2016-04,אזור יהודה והשומרון,3769,הר אדר,34,11,23,15,19,3,34,0,2%
2016-04,אזור יהודה והשומרון,3797,מודיעין עילית,332,103,229,20,312,30,331,0,3%
2016-04,אזור יהודה והשומרון,3616,מעלה אדומים,539,248,291,76,463,159,535,14,3%
2016-04,אזור יהודה והשומרון,3660,עמנואל,51,29,22,0,51,31,51,0,5%
2016-04,אזור יהודה והשומרון,3557,קדומים,36,23,13,7,29,5,35,1,2%
2016-04,אזור יהודה והשומרון,3611,קריית ארבע,91,45,46,11,80,50,88,2,3%
2016-04,אזור יהודה והשומרון,3640,קרני שומרון,63,29,34,18,45,6,63,2,2%
2016-04,הדרום,31,אופקים,859,355,504,53,806,551,824,23,7%
2016-04,הדרום,2600,אילת,1094,580,514,52,1042,423,1052,40,3%
2016-04,הדרום,70,אשדוד,4922,2101,2821,614,4308,2395,4723,76,4%
2016-04,הדרום,7100,אשקלון,3349,1404,1945,375,2974,1749,2875,92,4%
2016-04,הדרום,9000,באר שבע,5349,2367,2982,743,4606,3008,5092,89,5%
2016-04,הדרום,2200,דימונה,1629,709,920,96,1533,1100,1559,43,9%
2016-04,הדרום,1303,חורה,597,229,368,3,594,539,585,3,15%
2016-04,הדרום,831,ירוחם,332,178,154,10,322,210,322,17,7%
2016-04,הדרום,1059,כסיפה,1000,391,609,2,998,901,992,7,21%
2016-04,הדרום,1271,להבים,36,16,20,24,12,2,36,0,1%
2016-04,הדרום,1060,לקיה,673,275,398,2,671,605,660,4,17%
2016-04,הדרום,1268,מיתר,64,25,39,25,39,7,62,2,1%
2016-04,הדרום,99,מצפה רמון,196,75,121,17,179,135,189,12,8%
2016-04,הדרום,246,נתיבות,796,355,441,37,759,445,757,38,6%
2016-04,הדרום,666,עומר,52,18,34,27,25,2,52,1,1%
2016-04,הדרום,2560,ערד,631,299,332,71,560,329,603,32,5%
2016-04,הדרום,1192,ערערה-בנגב,1009,402,607,1,1008,934,996,18,24%
2016-04,הדרום,2630,קריית גת,1604,640,964,104,1500,849,1540,36,6%
2016-04,הדרום,1034,קריית מלאכי,679,294,385,17,662,375,655,33,6%
2016-04,הדרום,1161,רהט,2500,1033,1467,10,2490,2119,2473,43,14%
2016-04,הדרום,1286,שגב-שלום,368,117,251,2,366,326,358,6,14%
2016-04,הדרום,1031,שדרות,846,378,468,53,793,504,775,12,6%
2016-04,הדרום,1054,תל שבע,799,334,465,4,795,728,778,13,17%
2016-04,המרכז,182,אבן יהודה,129,64,65,39,90,11,128,0,2%
2016-04,המרכז,41,אליכין,47,25,22,6,41,16,45,1,2%
2016-04,המרכז,1309,אלעד,306,149,157,26,280,47,299,1,2%
2016-04,המרכז,2530,באר יעקב,203,77,126,53,150,43,201,6,2%
2016-04,המרכז,466,בית דגן,78,42,36,7,71,29,78,3,2%
2016-04,המרכז,1066,"בני עי""ש",149,70,79,34,115,44,148,2,4%
2016-04,המרכז,681,גבעת שמואל,214,113,101,72,142,43,208,0,2%
2016-04,המרכז,2550,גדרה,287,115,172,67,220,73,283,4,2%
2016-04,המרכז,627,ג'לג'וליה,88,38,50,3,85,55,87,1,2%
2016-04,המרכז,166,גן יבנה,247,99,148,40,207,58,240,3,2%
2016-04,המרכז,229,גני תקווה,149,77,72,45,104,21,149,1,2%
2016-04,המרכז,9700,הוד השרון,525,229,296,230,295,46,521,10,2%
2016-04,המרכז,1290,זמר,141,45,96,3,138,88,139,5,5%
2016-04,המרכז,2730,טייבה,1193,522,671,16,1177,924,1012,34,6%
2016-04,המרכז,2720,טירה,187,90,97,7,180,78,181,2,2%
2016-04,המרכז,2660,יבנה,577,270,307,91,486,189,577,11,3%
2016-04,המרכז,9400,יהוד,342,158,184,92,250,47,339,2,2%
2016-04,המרכז,1224,כוכב יאיר,79,41,38,47,32,1,79,0,1%
2016-04,המרכז,633,כפר ברא,25,12,13,1,24,13,23,0,2%
2016-04,המרכז,168,כפר יונה,291,126,165,45,246,40,287,2,3%
2016-04,המרכז,6900,כפר סבא,1076,485,591,391,685,101,1065,22,2%
2016-04,המרכז,634,כפר קאסם,207,91,116,12,195,118,199,0,2%
2016-04,המרכז,7000,לוד,1709,793,916,125,1584,926,1676,37,5%
2016-04,המרכז,1200,מודיעין-מכבים-רעות*,779,360,419,298,481,57,769,17,2%
2016-04,המרכז,28,מזכרת בתיה,125,58,67,48,77,23,125,3,2%
2016-04,המרכז,7200,נס ציונה,588,263,325,182,406,145,578,6,2%
2016-04,המרכז,7400,נתניה,3624,1705,1919,494,3130,1241,3563,50,3%
2016-04,המרכז,587,סביון*,15,2,13,8,7,0,15,0,1%
2016-04,המרכז,171,פרדסייה,83,37,46,21,62,4,83,0,2%
2016-04,המרכז,7900,פתח תקווה,3330,1469,1861,746,2584,877,3274,21,3%
2016-04,המרכז,195,קדימה-צורן,238,93,145,62,176,39,235,1,2%
2016-04,המרכז,638,קלנסווה,460,220,240,5,455,344,409,9,5%
2016-04,המרכז,469,קריית עקרון,212,118,94,21,191,85,206,9,4%
2016-04,המרכז,2640,ראש העין,566,288,278,81,485,128,560,11,2%
2016-04,המרכז,8300,ראשון לציון,3687,1649,2038,782,2905,1068,3659,54,3%
2016-04,המרכז,8400,רחובות,1841,842,999,434,1407,653,1807,35,3%
2016-04,המרכז,8500,רמלה,1367,659,708,95,1272,615,1306,51,4%
2016-04,המרכז,8700,רעננה,578,262,316,235,343,40,571,6,2%
2016-04,המרכז,1304,שוהם,162,76,86,74,88,8,162,0,1%
2016-04,המרכז,154,תל מונד,121,57,64,44,77,13,121,0,2%
2016-04,הצפון,473,אבו סנאן,586,240,346,3,583,481,579,9,10%
2016-04,הצפון,478,אכסאל,504,240,264,7,497,424,500,2,9%
2016-04,הצפון,529,אעבלין,498,219,279,9,489,417,493,5,9%
2016-04,הצפון,482,בועיינה-נוג'ידאת,313,133,180,8,305,242,306,7,8%
2016-04,הצפון,4001,בוקעאתא,360,131,229,2,358,302,351,0,13%
2016-04,הצפון,998,ביר אל-מכסור,372,149,223,5,367,287,368,2,10%
2016-04,הצפון,480,בית ג'ן,396,113,283,5,391,256,387,0,7%
2016-04,הצפון,9200,בית שאן,636,280,356,19,617,348,624,42,6%
2016-04,הצפון,944,בסמת טבעון,185,85,100,3,182,134,181,2,6%
2016-04,הצפון,483,בענה,295,125,170,9,286,254,293,4,9%
2016-04,הצפון,1292,ג'דיידה-מכר,1134,501,633,3,1131,941,1114,20,13%
2016-04,הצפון,485,ג'ולס,211,65,146,0,211,138,209,6,7%
2016-04,הצפון,487,ג'ש (גוש חלב),71,31,40,7,64,33,69,2,4%
2016-04,הצפון,489,דבורייה,326,137,189,11,315,247,322,1,8%
2016-04,הצפון,490,דייר אל-אסד,320,140,180,12,308,255,317,5,6%
2016-04,הצפון,492,דייר חנא,620,274,346,7,613,494,611,1,13%
2016-04,הצפון,975,זרזיר,224,96,128,4,220,149,221,2,7%
2016-04,הצפון,496,חורפיש,104,46,58,13,91,65,98,2,4%
2016-04,הצפון,2034,חצור הגלילית,241,105,136,10,231,134,219,8,5%
2016-04,הצפון,6700,טבריה,1405,681,724,72,1333,740,1231,51,6%
2016-04,הצפון,962,טובא-זנגרייה,351,159,192,5,346,245,341,4,11%
2016-04,הצפון,498,טורעאן,420,177,243,11,409,334,412,5,7%
2016-04,הצפון,8900,טמרה,1497,681,816,14,1483,1306,1467,11,11%
2016-04,הצפון,1295,יאנוח-ג'ת,146,52,94,4,142,88,142,5,5%
2016-04,הצפון,46,יבנאל,113,74,39,9,104,66,90,1,6%
2016-04,הצפון,499,יפיע,589,258,331,15,574,450,576,9,7%
2016-04,הצפון,240,יקנעם עילית,423,178,245,95,328,98,421,26,4%
2016-04,הצפון,502,ירכא,515,211,304,1,514,407,506,4,9%
2016-04,הצפון,504,כאבול,522,240,282,13,509,456,515,1,11%
2016-04,הצפון,505,כאוכב אבו אל-היג'א,222,91,131,5,217,185,216,1,13%
2016-04,הצפון,1296,כסרא-סמיע,207,77,130,4,203,151,185,6,5%
2016-04,הצפון,978,כעביה-טבאש-חג'אג'רה,159,64,95,3,156,118,157,0,7%
2016-04,הצפון,1263,כפר ורדים,53,25,28,25,28,5,52,0,2%
2016-04,הצפון,507,כפר יאסיף,395,169,226,4,391,293,386,11,8%
2016-04,הצפון,508,כפר כמא,51,22,29,2,49,27,49,0,3%
2016-04,הצפון,509,כפר כנא,927,406,521,17,910,765,890,19,10%
2016-04,הצפון,510,כפר מנדא,719,344,375,8,711,594,702,1,10%
2016-04,הצפון,47,כפר תבור,38,16,22,20,18,1,37,0,2%
2016-04,הצפון,1139,כרמיאל,1352,518,834,228,1124,674,1288,21,5%
2016-04,הצפון,481,מגאר,1278,520,758,17,1261,1053,1238,0,14%
2016-04,הצפון,516,מג'ד אל-כרום,454,216,238,8,446,341,447,17,7%
2016-04,הצפון,874,מגדל העמק,736,337,399,66,670,284,696,53,5%
2016-04,הצפון,4201,מג'דל שמס,422,160,262,9,413,332,405,1,9%
2016-04,הצפון,517,מזרעה,143,56,87,3,140,112,138,5,7%
2016-04,הצפון,4203,מסעדה,196,70,126,4,192,158,184,0,11%
2016-04,הצפון,518,מעיליא,46,24,22,5,41,27,44,1,3%
2016-04,הצפון,1063,מעלות-תרשיחא,756,372,384,85,671,398,733,24,6%
2016-04,הצפון,520,משהד,245,99,146,7,238,181,237,3,8%
2016-04,הצפון,9100,נהרייה,1620,774,846,187,1433,891,1563,61,5%
2016-04,הצפון,522,נחף,378,182,196,19,359,290,373,15,8%
2016-04,הצפון,7300,נצרת,2909,1282,1627,103,2806,2284,2874,19,8%
2016-04,הצפון,1061,נצרת עילית,1408,653,755,164,1244,751,1251,75,5%
2016-04,הצפון,525,סאג'ור,123,43,80,5,118,67,121,2,7%
2016-04,הצפון,7500,סח'נין,2065,885,1180,35,2030,1746,2027,17,15%
2016-04,הצפון,4501,ע'ג'ר,92,38,54,1,91,59,90,1,9%
2016-04,הצפון,530,עיילבון,154,70,84,2,152,111,151,0,6%
2016-04,הצפון,511,עילוט,310,120,190,5,305,259,306,3,11%
2016-04,הצפון,532,עין מאהל,424,204,220,7,417,336,412,2,8%
2016-04,הצפון,7600,עכו,2822,1301,1521,120,2702,2082,2737,59,10%
2016-04,הצפון,7700,עפולה,1327,556,771,153,1174,590,1266,47,5%
2016-04,הצפון,531,עראבה,1519,657,862,27,1492,1332,1488,12,15%
2016-04,הצפון,535,פסוטה,110,51,59,4,106,63,106,3,6%
2016-04,הצפון,536,פקיעין (בוקייעה),122,66,56,5,117,75,117,0,4%
2016-04,הצפון,8000,צפת,1118,629,489,78,1040,810,1054,17,8%
2016-04,הצפון,4100,קצרין,169,57,112,28,141,75,167,2,4%
2016-04,הצפון,2800,קריית שמונה,671,312,359,54,617,286,647,28,5%
2016-04,הצפון,543,ראמה,253,106,147,6,247,190,250,1,7%
2016-04,הצפון,26,ראש פינה,41,17,24,8,33,17,39,1,2%
2016-04,הצפון,542,ריינה,498,207,291,6,492,397,477,5,7%
2016-04,הצפון,122,רמת ישי,88,35,53,34,54,9,85,2,2%
2016-04,הצפון,913,שבלי - אום אל-גנם,196,74,122,3,193,129,193,1,8%
2016-04,הצפון,812,שלומי,196,87,109,11,185,92,190,8,5%
2016-04,הצפון,538,שעב,518,203,315,3,515,460,510,1,17%
2016-04,הצפון,8800,שפרעם,1612,648,964,23,1589,1280,1581,29,9%
2016-04,חיפה,2710,אום אל-פחם,3007,1252,1755,47,2960,2536,2959,15,15%
2016-04,חיפה,1020,אור עקיבא,419,198,221,39,380,126,410,8,4%
2016-04,חיפה,6000,באקה אל-גרביה,560,263,297,18,542,352,553,23,5%
2016-04,חיפה,9800,בנימינה-גבעת עדה*,159,62,97,50,109,47,158,1,2%
2016-04,חיפה,1326,"בסמ""ה",382,169,213,6,376,291,377,2,10%
2016-04,חיפה,541,ג'סר א-זרקא,395,206,189,3,392,287,393,6,7%
2016-04,חיפה,628,ג'ת,194,92,102,7,187,117,191,8,4%
2016-04,חיפה,494,דאלית אל-כרמל,437,166,271,11,426,240,409,4,5%
2016-04,חיפה,9300,זכרון יעקב,224,104,120,82,142,39,222,1,2%
2016-04,חיפה,6500,חדרה,1996,844,1152,215,1781,757,1860,21,4%
2016-04,חיפה,4000,חיפה,5287,2647,2640,984,4303,2747,5030,106,4%
2016-04,חיפה,1247,חריש,66,36,30,0,66,24,62,0,4%
2016-04,חיפה,2100,טירת כרמל,586,293,293,33,553,328,573,17,5%
2016-04,חיפה,654,כפר קרע,346,154,192,13,333,225,341,8,4%
2016-04,חיפה,1327,מעלה עירון,757,289,468,8,749,626,745,8,13%
2016-04,חיפה,2500,נשר,378,197,181,83,295,138,366,10,3%
2016-04,חיפה,534,עספיא,284,115,169,17,267,158,258,2,5%
2016-04,חיפה,637,ערערה,534,233,301,10,524,354,520,8,7%
2016-04,חיפה,537,פוריידיס,364,192,172,11,353,255,356,2,6%
2016-04,חיפה,7800,פרדס חנה-כרכור,716,316,400,148,568,219,699,16,4%
2016-04,חיפה,6800,קריית אתא,1347,617,730,99,1248,724,1318,20,4%
2016-04,חיפה,9500,קריית ביאליק,909,382,527,96,813,452,892,26,4%
2016-04,חיפה,2300,קריית טבעון,158,63,95,54,104,38,156,0,2%
2016-04,חיפה,9600,קריית ים,1259,589,670,111,1148,754,1214,25,6%
2016-04,חיפה,8200,קריית מוצקין,875,390,485,140,735,406,846,14,4%
2016-04,חיפה,922,רכסים,147,75,72,9,138,67,131,0,4%
2016-04,ירושלים,472,אבו גוש,228,112,116,6,222,181,226,2,7%
2016-04,ירושלים,2610,בית שמש,979,439,540,67,912,386,950,21,3%
2016-04,ירושלים,3000,ירושלים,11082,4994,6088,1169,9913,7202,10838,90,4%
2016-04,ירושלים,1015,מבשרת ציון,321,155,166,75,246,121,313,3,2%
2016-04,ירושלים,1137,קריית יערים,45,16,29,12,33,14,45,1,3%
2016-04,תל אביב,2400,אור יהודה,595,291,304,57,538,154,574,15,3%
2016-04,תל אביב,565,אזור,179,88,91,31,148,33,178,0,3%
2016-04,תל אביב,6100,בני ברק,1641,831,810,77,1564,780,1527,16,3%
2016-04,תל אביב,6200,בת ים,2500,1142,1358,362,2138,933,2380,41,3%
2016-04,תל אביב,6300,גבעתיים,604,272,332,283,321,66,604,1,2%
2016-04,תל אביב,6400,הרצלייה,885,388,497,324,561,21,877,19,2%
2016-04,תל אביב,6600,חולון,2619,1189,1430,406,2213,602,2582,29,3%
2016-04,תל אביב,2620,קריית אונו,340,152,188,136,204,37,339,1,2%
2016-04,תל אביב,8600,רמת גן,1622,743,879,575,1047,309,1592,24,2%
2016-04,תל אביב,2650,רמת השרון,348,158,190,149,199,5,348,4,2%
2016-04,תל אביב,5000,תל אביב -יפו,6219,3133,3086,2141,4078,1649,6121,86,2%
2016-05,אזור יהודה והשומרון,3760,אורנית,112,59,53,37,75,1,111,0,2%
2016-05,אזור יהודה והשומרון,3750,אלפי מנשה,80,38,42,23,57,0,80,1,2%
2016-05,אזור יהודה והשומרון,3560,אלקנה,33,11,22,19,14,0,33,1,2%
2016-05,אזור יהודה והשומרון,3650,אפרת,74,28,46,44,30,2,74,0,2%
2016-05,אזור יהודה והשומרון,3570,אריאל,311,137,174,80,231,38,310,13,3%
2016-05,אזור יהודה והשומרון,3574,בית אל,45,22,23,9,36,20,42,1,2%
2016-05,אזור יהודה והשומרון,3652,בית אריה,46,15,31,15,31,0,45,0,2%
2016-05,אזור יהודה והשומרון,3780,ביתר עילית,532,254,278,10,522,226,528,8,4%
2016-05,אזור יהודה והשומרון,3730,גבעת זאב,195,84,111,43,152,34,193,2,3%
2016-05,אזור יהודה והשומרון,3769,הר אדר,37,14,23,17,20,3,37,1,2%
2016-05,אזור יהודה והשומרון,3797,מודיעין עילית,370,119,251,23,347,39,366,6,3%
2016-05,אזור יהודה והשומרון,3616,מעלה אדומים,600,263,337,87,513,168,595,17,3%
2016-05,אזור יהודה והשומרון,3660,עמנואל,50,28,22,0,50,30,50,0,5%
2016-05,אזור יהודה והשומרון,3557,קדומים,39,20,19,8,31,4,38,1,2%
2016-05,אזור יהודה והשומרון,3611,קריית ארבע,98,50,48,15,83,55,93,3,3%
2016-05,אזור יהודה והשומרון,3640,קרני שומרון,70,32,38,20,50,7,69,1,2%
2016-05,הדרום,31,אופקים,977,409,568,57,920,549,947,48,8%
2016-05,הדרום,2600,אילת,1155,590,565,54,1101,441,1114,55,3%
2016-05,הדרום,70,אשדוד,5414,2296,3118,686,4728,2474,5165,143,5%
2016-05,הדרום,7100,אשקלון,3767,1556,2211,424,3343,1825,3262,135,5%
2016-05,הדרום,9000,באר שבע,5770,2562,3208,762,5008,3120,5480,163,5%
2016-05,הדרום,2200,דימונה,1757,754,1003,99,1658,1144,1677,62,9%
2016-05,הדרום,1303,חורה,603,243,360,2,601,546,590,8,15%
2016-05,הדרום,831,ירוחם,394,213,181,15,379,224,374,44,8%
2016-05,הדרום,1059,כסיפה,991,376,615,4,987,895,982,11,21%
2016-05,הדרום,1271,להבים,44,18,26,22,22,3,44,0,1%
2016-05,הדרום,1060,לקיה,684,288,396,2,682,611,670,14,17%
2016-05,הדרום,1268,מיתר,65,26,39,23,42,7,63,1,1%
2016-05,הדרום,99,מצפה רמון,220,90,130,19,201,138,207,17,9%
2016-05,הדרום,246,נתיבות,966,437,529,47,919,466,915,70,7%
2016-05,הדרום,666,עומר,59,18,41,27,32,3,58,1,1%
2016-05,הדרום,2560,ערד,687,328,359,73,614,350,655,46,5%
2016-05,הדרום,1192,ערערה-בנגב,1043,427,616,2,1041,963,1028,2,25%
2016-05,הדרום,2630,קריית גת,1764,706,1058,113,1651,899,1686,69,6%
2016-05,הדרום,1034,קריית מלאכי,844,374,470,23,821,389,811,75,7%
2016-05,הדרום,1161,רהט,2594,1068,1526,11,2583,2109,2554,74,14%
2016-05,הדרום,1286,שגב-שלום,380,129,251,2,378,333,370,7,15%
2016-05,הדרום,1031,שדרות,951,437,514,56,895,525,866,31,7%
2016-05,הדרום,1054,תל שבע,798,335,463,5,793,722,771,6,17%
2016-05,המרכז,182,אבן יהודה,143,73,70,43,100,16,143,0,2%
2016-05,המרכז,41,אליכין,52,25,27,7,45,17,49,0,3%
2016-05,המרכז,1309,אלעד,348,165,183,29,319,50,339,6,3%
2016-05,המרכז,2530,באר יעקב,235,86,149,70,165,45,232,4,3%
2016-05,המרכז,466,בית דגן,90,47,43,5,85,35,88,1,2%
2016-05,המרכז,1066,"בני עי""ש",155,71,84,31,124,45,152,8,4%
2016-05,המרכז,681,גבעת שמואל,217,113,104,72,145,46,210,1,2%
2016-05,המרכז,2550,גדרה,299,117,182,71,228,79,294,9,3%
2016-05,המרכז,627,ג'לג'וליה,92,42,50,3,89,58,90,1,2%
2016-05,המרכז,166,גן יבנה,288,132,156,50,238,63,280,4,2%
2016-05,המרכז,229,גני תקווה,168,87,81,62,106,21,167,1,2%
2016-05,המרכז,9700,הוד השרון,587,247,340,254,333,51,577,7,2%
2016-05,המרכז,1290,זמר,146,48,98,3,143,91,144,8,5%
2016-05,המרכז,2730,טייבה,1220,539,681,16,1204,937,1033,31,6%
2016-05,המרכז,2720,טירה,190,93,97,13,177,71,185,9,2%
2016-05,המרכז,2660,יבנה,695,321,374,107,588,213,686,34,3%
2016-05,המרכז,9400,יהוד,387,178,209,102,285,61,378,6,2%
2016-05,המרכז,1224,כוכב יאיר,91,48,43,56,35,2,91,0,2%
2016-05,המרכז,633,כפר ברא,24,11,13,1,23,14,22,2,2%
2016-05,המרכז,168,כפר יונה,315,132,183,49,266,39,314,2,3%
2016-05,המרכז,6900,כפר סבא,1197,549,648,455,742,108,1172,35,2%
2016-05,המרכז,634,כפר קאסם,218,95,123,14,204,118,210,2,2%
2016-05,המרכז,7000,לוד,1848,846,1002,140,1708,965,1807,56,5%
2016-05,המרכז,1200,מודיעין-מכבים-רעות*,876,409,467,337,539,55,858,23,2%
2016-05,המרכז,28,מזכרת בתיה,132,58,74,52,80,23,132,1,2%
2016-05,המרכז,7200,נס ציונה,642,294,348,200,442,150,635,13,3%
2016-05,המרכז,7400,נתניה,4056,1861,2195,556,3500,1307,3968,66,4%
2016-05,המרכז,587,סביון*,13,2,11,9,4,0,13,0,1%
2016-05,המרכז,171,פרדסייה,85,33,52,21,64,7,84,0,2%
2016-05,המרכז,7900,פתח תקווה,3690,1626,2064,842,2848,948,3604,47,3%
2016-05,המרכז,195,קדימה-צורן,260,100,160,72,188,37,257,2,2%
2016-05,המרכז,638,קלנסווה,470,225,245,7,463,344,421,10,5%
2016-05,המרכז,469,קריית עקרון,226,125,101,23,203,91,219,12,4%
2016-05,המרכז,2640,ראש העין,639,313,326,96,543,121,631,24,3%
2016-05,המרכז,8300,ראשון לציון,4117,1831,2286,871,3246,1146,4071,89,3%
2016-05,המרכז,8400,רחובות,2129,979,1150,500,1629,692,2072,73,3%
2016-05,המרכז,8500,רמלה,1552,731,821,109,1443,657,1478,68,4%
2016-05,המרכז,8700,רעננה,621,290,331,266,355,40,617,3,2%
2016-05,המרכז,1304,שוהם,187,82,105,84,103,8,185,0,2%
2016-05,המרכז,154,תל מונד,136,72,64,47,89,16,135,0,2%
2016-05,הצפון,473,אבו סנאן,596,247,349,5,591,473,588,10,10%
2016-05,הצפון,478,אכסאל,510,244,266,10,500,421,506,5,9%
2016-05,הצפון,529,אעבלין,496,209,287,8,488,414,488,7,9%
2016-05,הצפון,482,בועיינה-נוג'ידאת,287,128,159,8,279,227,284,9,8%
2016-05,הצפון,4001,בוקעאתא,374,143,231,2,372,311,355,6,13%
2016-05,הצפון,998,ביר אל-מכסור,361,145,216,4,357,286,355,2,10%
2016-05,הצפון,480,בית ג'ן,394,117,277,9,385,259,381,4,7%
2016-05,הצפון,9200,בית שאן,750,322,428,17,733,354,732,57,7%
2016-05,הצפון,944,בסמת טבעון,183,82,101,3,180,138,179,2,6%
2016-05,הצפון,483,בענה,305,133,172,9,296,256,302,12,9%
2016-05,הצפון,1292,ג'דיידה-מכר,1149,503,646,6,1143,942,1124,25,13%
2016-05,הצפון,485,ג'ולס,211,64,147,0,211,137,209,5,7%
2016-05,הצפון,487,ג'ש (גוש חלב),70,30,40,5,65,31,67,0,4%
2016-05,הצפון,489,דבורייה,332,137,195,16,316,247,325,3,8%
2016-05,הצפון,490,דייר אל-אסד,320,137,183,13,307,253,317,5,6%
2016-05,הצפון,492,דייר חנא,627,267,360,7,620,502,614,3,13%
2016-05,הצפון,975,זרזיר,232,101,131,4,228,155,229,3,8%
2016-05,הצפון,496,חורפיש,106,51,55,9,97,68,102,4,4%
2016-05,הצפון,2034,חצור הגלילית,268,112,156,15,253,131,250,8,5%
2016-05,הצפון,6700,טבריה,1494,700,794,77,1417,762,1297,51,6%
2016-05,הצפון,962,טובא-זנגרייה,370,157,213,4,366,247,360,5,12%
2016-05,הצפון,498,טורעאן,425,180,245,13,412,344,416,3,7%
2016-05,הצפון,8900,טמרה,1496,678,818,14,1482,1303,1473,25,11%
2016-05,הצפון,1295,יאנוח-ג'ת,158,51,107,6,152,92,151,3,5%
2016-05,הצפון,46,יבנאל,127,79,48,10,117,79,101,5,7%
2016-05,הצפון,499,יפיע,569,247,322,13,556,438,556,7,7%
2016-05,הצפון,240,יקנעם עילית,462,190,272,94,368,105,458,27,4%
2016-05,הצפון,502,ירכא,527,217,310,1,526,405,519,9,9%
2016-05,הצפון,504,כאבול,526,243,283,12,514,454,518,7,11%
2016-05,הצפון,505,כאוכב אבו אל-היג'א,221,91,130,5,216,185,215,1,13%
2016-05,הצפון,1296,כסרא-סמיע,234,88,146,3,231,156,207,2,6%
2016-05,הצפון,978,כעביה-טבאש-חג'אג'רה,157,67,90,4,153,113,156,0,7%
2016-05,הצפון,1263,כפר ורדים,65,34,31,30,35,4,63,0,2%
2016-05,הצפון,507,כפר יאסיף,416,174,242,4,412,303,402,16,8%
2016-05,הצפון,508,כפר כמא,57,23,34,3,54,26,56,1,3%
2016-05,הצפון,509,כפר כנא,922,404,518,24,898,762,882,15,10%
2016-05,הצפון,510,כפר מנדא,715,345,370,10,705,599,692,4,10%
2016-05,הצפון,47,כפר תבור,34,15,19,16,18,1,33,1,2%
2016-05,הצפון,1139,כרמיאל,1509,587,922,261,1248,708,1429,42,6%
2016-05,הצפון,481,מגאר,1340,557,783,23,1317,1090,1293,12,14%
2016-05,הצפון,516,מג'ד אל-כרום,446,209,237,7,439,326,438,16,7%
2016-05,הצפון,874,מגדל העמק,829,356,473,67,762,303,776,76,6%
2016-05,הצפון,4201,מג'דל שמס,419,163,256,10,409,324,401,13,9%
2016-05,הצפון,517,מזרעה,161,66,95,3,158,120,155,2,8%
2016-05,הצפון,4203,מסעדה,195,63,132,3,192,154,182,6,11%
2016-05,הצפון,518,מעיליא,54,27,27,5,49,25,53,1,3%
2016-05,הצפון,1063,מעלות-תרשיחא,804,390,414,85,719,416,769,39,6%
2016-05,הצפון,520,משהד,244,97,147,6,238,186,236,8,7%
2016-05,הצפון,9100,נהרייה,1783,843,940,198,1585,941,1704,73,6%
2016-05,הצפון,522,נחף,366,176,190,21,345,277,361,10,7%
2016-05,הצפון,7300,נצרת,2948,1317,1631,100,2848,2301,2893,28,8%
2016-05,הצפון,1061,נצרת עילית,1525,696,829,158,1367,769,1341,88,6%
2016-05,הצפון,525,סאג'ור,120,42,78,5,115,64,119,1,7%
2016-05,הצפון,7500,סח'נין,2083,904,1179,38,2045,1767,2046,25,15%
2016-05,הצפון,4501,ע'ג'ר,87,36,51,2,85,60,85,0,8%
2016-05,הצפון,530,עיילבון,154,70,84,1,153,108,150,1,6%
2016-05,הצפון,511,עילוט,311,122,189,4,307,253,309,7,11%
2016-05,הצפון,532,עין מאהל,396,190,206,8,388,315,385,4,8%
2016-05,הצפון,7600,עכו,2908,1341,1567,133,2775,2119,2832,63,11%
2016-05,הצפון,7700,עפולה,1520,645,875,169,1351,629,1431,77,6%
2016-05,הצפון,531,עראבה,1547,670,877,29,1518,1348,1515,18,15%
2016-05,הצפון,535,פסוטה,107,52,55,4,103,62,105,4,6%
2016-05,הצפון,536,פקיעין (בוקייעה),131,70,61,3,128,85,123,2,5%
2016-05,הצפון,8000,צפת,1152,640,512,85,1067,812,1095,19,8%
2016-05,הצפון,4100,קצרין,185,68,117,27,158,83,181,3,5%
2016-05,הצפון,2800,קריית שמונה,736,336,400,51,685,293,707,35,5%
2016-05,הצפון,543,ראמה,254,100,154,5,249,191,246,1,6%
2016-05,הצפון,26,ראש פינה,42,15,27,10,32,16,41,0,3%
2016-05,הצפון,542,ריינה,508,218,290,5,503,398,490,5,7%
2016-05,הצפון,122,רמת ישי,95,37,58,40,55,15,91,1,2%
2016-05,הצפון,913,שבלי - אום אל-גנם,193,74,119,3,190,130,191,3,8%
2016-05,הצפון,812,שלומי,205,88,117,13,192,94,200,10,6%
2016-05,הצפון,538,שעב,526,215,311,5,521,463,518,5,17%
2016-05,הצפון,8800,שפרעם,1612,650,962,24,1588,1277,1580,27,9%
2016-05,חיפה,2710,אום אל-פחם,3018,1250,1768,44,2974,2548,2955,39,15%
2016-05,חיפה,1020,אור עקיבא,493,227,266,52,441,137,477,18,5%
2016-05,חיפה,6000,באקה אל-גרביה,578,264,314,16,562,354,573,37,5%
2016-05,חיפה,9800,בנימינה-גבעת עדה*,185,73,112,59,126,52,180,1,3%
2016-05,חיפה,1326,"בסמ""ה",395,170,225,7,388,300,387,7,10%
2016-05,חיפה,541,ג'סר א-זרקא,430,216,214,3,427,281,426,15,7%
2016-05,חיפה,628,ג'ת,204,90,114,3,201,127,199,8,4%
2016-05,חיפה,494,דאלית אל-כרמל,460,179,281,11,449,255,424,8,5%
2016-05,חיפה,9300,זכרון יעקב,227,103,124,79,148,44,222,3,2%
2016-05,חיפה,6500,חדרה,2231,919,1312,237,1994,803,2076,64,4%
2016-05,חיפה,4000,חיפה,5689,2744,2945,1073,4616,2933,5348,141,4%
2016-05,חיפה,1247,חריש,70,40,30,2,68,26,60,0,4%
2016-05,חיפה,2100,טירת כרמל,628,313,315,34,594,334,609,19,6%
2016-05,חיפה,654,כפר קרע,367,167,200,13,354,225,360,11,4%
2016-05,חיפה,1327,מעלה עירון,764,295,469,10,754,627,748,12,13%
2016-05,חיפה,2500,נשר,417,202,215,92,325,146,401,9,3%
2016-05,חיפה,534,עספיא,292,124,168,16,276,155,271,6,5%
2016-05,חיפה,637,ערערה,535,231,304,10,525,354,523,16,7%
2016-05,חיפה,537,פוריידיס,357,185,172,11,346,246,349,1,6%
2016-05,חיפה,7800,פרדס חנה-כרכור,793,349,444,158,635,234,765,29,4%
2016-05,חיפה,6800,קריית אתא,1481,676,805,116,1365,768,1436,45,5%
2016-05,חיפה,9500,קריית ביאליק,950,389,561,105,845,447,931,24,4%
2016-05,חיפה,2300,קריית טבעון,165,69,96,60,105,39,163,1,2%
2016-05,חיפה,9600,קריית ים,1348,629,719,118,1230,770,1302,45,6%
2016-05,חיפה,8200,קריית מוצקין,946,423,523,160,786,405,917,33,4%
2016-05,חיפה,922,רכסים,153,69,84,10,143,68,139,1,4%
2016-05,ירושלים,472,אבו גוש,236,120,116,5,231,182,232,3,8%
2016-05,ירושלים,2610,בית שמש,1187,526,661,83,1104,440,1145,34,4%
2016-05,ירושלים,3000,ירושלים,11857,5320,6537,1345,10512,7375,11558,166,4%
2016-05,ירושלים,1015,מבשרת ציון,353,167,186,84,269,126,345,2,3%
2016-05,ירושלים,1137,קריית יערים,48,17,31,12,36,16,48,0,4%
2016-05,תל אביב,2400,אור יהודה,675,317,358,72,603,174,640,31,3%
2016-05,תל אביב,565,אזור,195,96,99,29,166,37,192,2,3%
2016-05,תל אביב,6100,בני ברק,1838,899,939,99,1739,817,1715,29,3%
2016-05,תל אביב,6200,בת ים,2700,1231,1469,375,2325,970,2562,68,4%
2016-05,תל אביב,6300,גבעתיים,705,330,375,327,378,73,702,3,2%
2016-05,תל אביב,6400,הרצלייה,971,426,545,366,605,29,961,28,2%
2016-05,תל אביב,6600,חולון,2876,1330,1546,441,2435,650,2829,52,3%
2016-05,תל אביב,2620,קריית אונו,370,158,212,152,218,38,368,1,2%
2016-05,תל אביב,8600,רמת גן,1867,870,997,661,1206,336,1824,19,2%
2016-05,תל אביב,2650,רמת השרון,377,173,204,166,211,7,376,3,2%
2016-05,תל אביב,5000,תל אביב -יפו,6956,3481,3475,2485,4471,1797,6831,121,3%
2016-06,אזור יהודה והשומרון,3760,אורנית,104,52,52,33,71,1,104,0,2%
2016-06,אזור יהודה והשומרון,3750,אלפי מנשה,85,33,52,23,62,1,85,0,2%
2016-06,אזור יהודה והשומרון,3560,אלקנה,32,11,21,17,15,0,32,0,2%
2016-06,אזור יהודה והשומרון,3650,אפרת,76,24,52,42,34,6,76,4,2%
2016-06,אזור יהודה והשומרון,3570,אריאל,285,123,162,80,205,33,283,11,3%
2016-06,אזור יהודה והשומרון,3574,בית אל,47,22,25,12,35,18,46,1,2%
2016-06,אזור יהודה והשומרון,3652,בית אריה,49,16,33,16,33,1,49,1,2%
2016-06,אזור יהודה והשומרון,3780,ביתר עילית,515,243,272,10,505,228,509,4,4%
2016-06,אזור יהודה והשומרון,3730,גבעת זאב,199,86,113,42,157,35,196,2,3%
2016-06,אזור יהודה והשומרון,3769,הר אדר,32,15,17,17,15,3,32,0,2%
2016-06,אזור יהודה והשומרון,3797,מודיעין עילית,428,109,319,20,408,37,424,5,3%
2016-06,אזור יהודה והשומרון,3616,מעלה אדומים,611,258,353,95,516,173,606,14,3%
2016-06,אזור יהודה והשומרון,3660,עמנואל,56,31,25,0,56,28,56,1,5%
2016-06,אזור יהודה והשומרון,3557,קדומים,39,25,14,12,27,4,38,1,2%
2016-06,אזור יהודה והשומרון,3611,קריית ארבע,93,52,41,15,78,50,90,2,3%
2016-06,אזור יהודה והשומרון,3640,קרני שומרון,65,32,33,18,47,6,65,1,2%
2016-06,הדרום,31,אופקים,957,402,555,54,903,544,924,48,7%
2016-06,הדרום,2600,אילת,1099,558,541,55,1044,419,1060,55,3%
2016-06,הדרום,70,אשדוד,5391,2214,3177,677,4714,2508,5128,134,5%
2016-06,הדרום,7100,אשקלון,3719,1527,2192,417,3302,1811,3232,118,5%
2016-06,הדרום,9000,באר שבע,5677,2494,3183,768,4909,3091,5383,160,5%
2016-06,הדרום,2200,דימונה,1731,746,985,92,1639,1150,1645,62,9%
2016-06,הדרום,1303,חורה,581,225,356,2,579,530,568,11,15%
2016-06,הדרום,831,ירוחם,372,197,175,11,361,223,355,31,8%
2016-06,הדרום,1059,כסיפה,982,370,612,3,979,887,972,7,21%
2016-06,הדרום,1271,להבים,48,22,26,20,28,3,47,0,1%
2016-06,הדרום,1060,לקיה,677,286,391,0,677,604,663,7,17%
2016-06,הדרום,1268,מיתר,67,27,40,25,42,6,67,2,2%
2016-06,הדרום,99,מצפה רמון,214,86,128,16,198,136,205,17,8%
2016-06,הדרום,246,נתיבות,991,448,543,44,947,455,929,87,7%
2016-06,הדרום,666,עומר,58,15,43,21,37,4,57,1,1%
2016-06,הדרום,2560,ערד,670,328,342,69,601,335,639,46,5%
2016-06,הדרום,1192,ערערה-בנגב,1055,440,615,3,1052,966,1037,0,25%
2016-06,הדרום,2630,קריית גת,1700,676,1024,108,1592,863,1628,55,6%
2016-06,הדרום,1034,קריית מלאכי,806,362,444,22,784,357,775,74,7%
2016-06,הדרום,1161,רהט,2639,1109,1530,9,2630,2081,2597,49,14%
2016-06,הדרום,1286,שגב-שלום,394,119,275,3,391,325,382,4,15%
2016-06,הדרום,1031,שדרות,930,430,500,59,871,508,854,26,7%
2016-06,הדרום,1054,תל שבע,784,333,451,3,781,704,760,10,17%
2016-06,המרכז,182,אבן יהודה,154,76,78,45,109,13,154,1,2%
2016-06,המרכז,41,אליכין,60,30,30,11,49,18,56,0,3%
2016-06,המרכז,1309,אלעד,345,167,178,29,316,42,330,5,3%
2016-06,המרכז,2530,באר יעקב,245,86,159,63,182,49,240,7,3%
2016-06,המרכז,466,בית דגן,90,47,43,5,85,32,89,3,3%
2016-06,המרכז,1066,"בני עי""ש",145,67,78,31,114,40,144,3,4%
2016-06,המרכז,681,גבעת שמואל,221,114,107,69,152,45,212,1,2%
2016-06,המרכז,2550,גדרה,284,107,177,65,219,76,277,4,2%
2016-06,המרכז,627,ג'לג'וליה,94,33,61,3,91,60,92,1,3%
2016-06,המרכז,166,גן יבנה,275,125,150,45,230,60,270,10,2%
2016-06,המרכז,229,גני תקווה,170,81,89,62,108,22,170,1,2%
2016-06,המרכז,9700,הוד השרון,586,252,334,252,334,47,575,10,2%
2016-06,המרכז,1290,זמר,151,54,97,3,148,93,149,3,5%
2016-06,המרכז,2730,טייבה,1194,533,661,18,1176,906,1023,53,6%
2016-06,המרכז,2720,טירה,202,94,108,14,188,82,196,5,2%
2016-06,המרכז,2660,יבנה,720,332,388,107,613,220,710,24,3%
2016-06,המרכז,9400,יהוד,365,168,197,92,273,53,359,8,2%
2016-06,המרכז,1224,כוכב יאיר,77,42,35,43,34,0,77,2,1%
2016-06,המרכז,633,כפר ברא,23,11,12,1,22,14,22,0,2%
2016-06,המרכז,168,כפר יונה,304,131,173,52,252,40,303,5,3%
2016-06,המרכז,6900,כפר סבא,1124,513,611,431,693,102,1102,32,2%
2016-06,המרכז,634,כפר קאסם,220,92,128,11,209,116,211,0,2%
2016-06,המרכז,7000,לוד,1780,820,960,124,1656,946,1739,51,5%
2016-06,המרכז,1200,מודיעין-מכבים-רעות*,821,386,435,310,511,58,805,23,2%
2016-06,המרכז,28,מזכרת בתיה,128,54,74,50,78,22,126,1,2%
2016-06,המרכז,7200,נס ציונה,627,273,354,187,440,151,622,9,3%
2016-06,המרכז,7400,נתניה,3949,1846,2103,526,3423,1294,3862,57,4%
2016-06,המרכז,587,סביון*,13,1,12,8,5,0,13,0,1%
2016-06,המרכז,171,פרדסייה,78,34,44,21,57,7,78,1,2%
2016-06,המרכז,7900,פתח תקווה,3641,1620,2021,807,2834,917,3550,45,3%
2016-06,המרכז,195,קדימה-צורן,255,100,155,72,183,36,251,5,2%
2016-06,המרכז,638,קלנסווה,451,232,219,7,444,324,409,12,5%
2016-06,המרכז,469,קריית עקרון,225,124,101,18,207,87,220,6,4%
2016-06,המרכז,2640,ראש העין,603,293,310,105,498,125,594,19,3%
2016-06,המרכז,8300,ראשון לציון,3927,1779,2148,789,3138,1114,3881,114,3%
2016-06,המרכז,8400,רחובות,2088,933,1155,503,1585,665,2038,69,3%
2016-06,המרכז,8500,רמלה,1492,715,777,104,1388,619,1431,70,4%
2016-06,המרכז,8700,רעננה,621,298,323,258,363,41,617,19,2%
2016-06,המרכז,1304,שוהם,172,74,98,77,95,9,170,0,2%
2016-06,המרכז,154,תל מונד,126,65,61,47,79,19,125,1,2%
2016-06,הצפון,473,אבו סנאן,586,242,344,4,582,476,580,8,10%
2016-06,הצפון,478,אכסאל,498,240,258,9,489,413,494,4,9%
2016-06,הצפון,529,אעבלין,497,217,280,9,488,409,488,5,9%
2016-06,הצפון,482,בועיינה-נוג'ידאת,274,125,149,6,268,217,270,5,7%
2016-06,הצפון,4001,בוקעאתא,368,142,226,1,367,304,354,2,13%
2016-06,הצפון,998,ביר אל-מכסור,356,145,211,4,352,276,350,0,10%
2016-06,הצפון,480,בית ג'ן,375,110,265,6,369,251,360,1,7%
2016-06,הצפון,9200,בית שאן,758,347,411,20,738,354,730,56,7%
2016-06,הצפון,944,בסמת טבעון,182,85,97,2,180,140,174,2,6%
2016-06,הצפון,483,בענה,307,135,172,7,300,258,302,15,9%
2016-06,הצפון,1292,ג'דיידה-מכר,1143,500,643,5,1138,933,1121,30,13%
2016-06,הצפון,485,ג'ולס,208,68,140,1,207,136,206,5,7%
2016-06,הצפון,487,ג'ש (גוש חלב),67,28,39,4,63,31,66,1,4%
2016-06,הצפון,489,דבורייה,321,136,185,19,302,243,316,3,8%
2016-06,הצפון,490,דייר אל-אסד,319,139,180,13,306,251,316,11,6%
2016-06,הצפון,492,דייר חנא,627,261,366,9,618,506,614,8,13%
2016-06,הצפון,975,זרזיר,237,105,132,3,234,153,232,6,8%
2016-06,הצפון,496,חורפיש,109,54,55,7,102,65,105,5,4%
2016-06,הצפון,2034,חצור הגלילית,275,119,156,16,259,131,258,12,5%
2016-06,הצפון,6700,טבריה,1492,709,783,78,1414,754,1309,60,6%
2016-06,הצפון,962,טובא-זנגרייה,363,161,202,4,359,243,354,5,12%
2016-06,הצפון,498,טורעאן,427,186,241,10,417,342,416,5,7%
2016-06,הצפון,8900,טמרה,1465,643,822,9,1456,1276,1440,18,11%
2016-06,הצפון,1295,יאנוח-ג'ת,154,48,106,5,149,88,148,6,5%
2016-06,הצפון,46,יבנאל,120,72,48,9,111,78,96,3,6%
2016-06,הצפון,499,יפיע,570,247,323,14,556,438,558,6,7%
2016-06,הצפון,240,יקנעם עילית,444,191,253,92,352,101,443,28,4%
2016-06,הצפון,502,ירכא,523,215,308,0,523,414,509,9,9%
2016-06,הצפון,504,כאבול,521,243,278,11,510,439,512,4,11%
2016-06,הצפון,505,כאוכב אבו אל-היג'א,222,94,128,3,219,191,216,3,13%
2016-06,הצפון,1296,כסרא-סמיע,201,82,119,2,199,138,183,6,5%
2016-06,הצפון,978,כעביה-טבאש-חג'אג'רה,154,63,91,3,151,109,150,3,7%
2016-06,הצפון,1263,כפר ורדים,62,29,33,31,31,4,61,1,2%
2016-06,הצפון,507,כפר יאסיף,418,176,242,4,414,303,405,4,8%
2016-06,הצפון,508,כפר כמא,51,21,30,4,47,24,50,1,3%
2016-06,הצפון,509,כפר כנא,904,401,503,21,883,741,868,13,10%
2016-06,הצפון,510,כפר מנדא,733,362,371,11,722,604,712,3,10%
2016-06,הצפון,47,כפר תבור,33,16,17,12,21,1,32,0,1%
2016-06,הצפון,1139,כרמיאל,1443,577,866,248,1195,682,1370,39,5%
2016-06,הצפון,481,מגאר,1300,529,771,20,1280,1055,1257,17,14%
2016-06,הצפון,516,מג'ד אל-כרום,451,218,233,9,442,331,441,17,7%
2016-06,הצפון,874,מגדל העמק,763,312,451,68,695,308,708,51,5%
2016-06,הצפון,4201,מג'דל שמס,400,159,241,9,391,325,378,5,8%
2016-06,הצפון,517,מזרעה,161,65,96,3,158,119,157,9,8%
2016-06,הצפון,4203,מסעדה,192,61,131,3,189,157,179,3,11%
2016-06,הצפון,518,מעיליא,54,25,29,7,47,26,52,0,3%
2016-06,הצפון,1063,מעלות-תרשיחא,765,369,396,93,672,406,732,34,6%
2016-06,הצפון,520,משהד,222,86,136,4,218,176,216,3,7%
2016-06,הצפון,9100,נהרייה,1747,826,921,191,1556,928,1671,75,5%
2016-06,הצפון,522,נחף,369,180,189,20,349,278,365,17,7%
2016-06,הצפון,7300,נצרת,2905,1290,1615,98,2807,2270,2840,22,8%
2016-06,הצפון,1061,נצרת עילית,1491,671,820,151,1340,750,1326,95,6%
2016-06,הצפון,525,סאג'ור,118,40,78,4,114,64,117,1,7%
2016-06,הצפון,7500,סח'נין,2075,901,1174,35,2040,1764,2036,19,15%
2016-06,הצפון,4501,ע'ג'ר,85,35,50,1,84,60,84,0,8%
2016-06,הצפון,530,עיילבון,153,64,89,2,151,112,150,0,6%
2016-06,הצפון,511,עילוט,309,120,189,5,304,254,307,2,11%
2016-06,הצפון,532,עין מאהל,384,187,197,5,379,309,373,2,7%
2016-06,הצפון,7600,עכו,2867,1314,1553,127,2740,2097,2781,69,11%
2016-06,הצפון,7700,עפולה,1455,603,852,170,1285,611,1378,85,6%
2016-06,הצפון,531,עראבה,1549,683,866,31,1518,1351,1520,10,15%
2016-06,הצפון,535,פסוטה,100,48,52,7,93,58,97,5,6%
2016-06,הצפון,536,פקיעין (בוקייעה),138,74,64,3,135,85,130,5,5%
2016-06,הצפון,8000,צפת,1091,606,485,77,1014,779,1021,22,8%
2016-06,הצפון,4100,קצרין,173,62,111,25,148,81,171,3,4%
2016-06,הצפון,2800,קריית שמונה,693,317,376,48,645,291,665,28,5%
2016-06,הצפון,543,ראמה,236,96,140,6,230,179,232,1,6%
2016-06,הצפון,26,ראש פינה,45,16,29,9,36,18,43,1,3%
2016-06,הצפון,542,ריינה,509,219,290,5,504,395,488,12,7%
2016-06,הצפון,122,רמת ישי,88,36,52,42,46,13,85,1,2%
2016-06,הצפון,913,שבלי - אום אל-גנם,191,75,116,3,188,124,190,0,7%
2016-06,הצפון,812,שלומי,200,91,109,13,187,101,193,9,5%
2016-06,הצפון,538,שעב,528,217,311,4,524,467,520,3,17%
2016-06,הצפון,8800,שפרעם,1599,631,968,23,1576,1281,1565,33,9%
2016-06,חיפה,2710,אום אל-פחם,2945,1211,1734,39,2906,2501,2893,40,14%
2016-06,חיפה,1020,אור עקיבא,483,217,266,57,426,138,466,12,5%
2016-06,חיפה,6000,באקה אל-גרביה,582,263,319,14,568,355,574,28,5%
2016-06,חיפה,9800,בנימינה-גבעת עדה*,181,72,109,52,129,51,178,2,3%
2016-06,חיפה,1326,"בסמ""ה",383,162,221,7,376,287,378,8,10%
2016-06,חיפה,541,ג'סר א-זרקא,408,208,200,2,406,256,405,23,7%
2016-06,חיפה,628,ג'ת,203,88,115,2,201,124,199,14,4%
2016-06,חיפה,494,דאלית אל-כרמל,453,182,271,11,442,238,431,10,6%
2016-06,חיפה,9300,זכרון יעקב,217,103,114,71,146,46,212,4,2%
2016-06,חיפה,6500,חדרה,2206,897,1309,234,1972,796,2048,48,4%
2016-06,חיפה,4000,חיפה,5464,2630,2834,1018,4446,2880,5114,127,4%
2016-06,חיפה,1247,חריש,74,36,38,0,74,28,64,3,4%
2016-06,חיפה,2100,טירת כרמל,611,309,302,31,580,333,594,20,6%
2016-06,חיפה,654,כפר קרע,381,172,209,12,369,235,371,8,4%
2016-06,חיפה,1327,מעלה עירון,764,298,466,10,754,618,751,8,13%
2016-06,חיפה,2500,נשר,437,222,215,89,348,160,417,10,3%
2016-06,חיפה,534,עספיא,287,118,169,17,270,152,269,5,5%
2016-06,חיפה,637,ערערה,530,227,303,12,518,365,517,15,6%
2016-06,חיפה,537,פוריידיס,329,171,158,8,321,222,323,0,6%
2016-06,חיפה,7800,פרדס חנה-כרכור,777,342,435,161,616,221,757,29,4%
2016-06,חיפה,6800,קריית אתא,1461,670,791,118,1343,780,1404,40,5%
2016-06,חיפה,9500,קריית ביאליק,966,389,577,104,862,450,938,30,4%
2016-06,חיפה,2300,קריית טבעון,145,65,80,54,91,34,142,1,2%
2016-06,חיפה,9600,קריית ים,1318,617,701,114,1204,761,1264,39,6%
2016-06,חיפה,8200,קריית מוצקין,929,411,518,155,774,399,890,18,4%
2016-06,חיפה,922,רכסים,140,70,70,11,129,66,126,0,4%
2016-06,ירושלים,472,אבו גוש,234,118,116,6,228,176,232,2,8%
2016-06,ירושלים,2610,בית שמש,1176,486,690,88,1088,433,1133,39,4%
2016-06,ירושלים,3000,ירושלים,11476,5135,6341,1295,10181,7206,11193,188,4%
2016-06,ירושלים,1015,מבשרת ציון,325,155,170,79,246,121,318,3,2%
2016-06,ירושלים,1137,קריית יערים,48,16,32,12,36,16,48,1,4%
2016-06,תל אביב,2400,אור יהודה,680,321,359,67,613,173,653,22,3%
2016-06,תל אביב,565,אזור,183,93,90,32,151,31,182,6,3%
2016-06,תל אביב,6100,בני ברק,1784,883,901,89,1695,788,1659,24,3%
2016-06,תל אביב,6200,בת ים,2642,1209,1433,368,2274,945,2507,94,4%
2016-06,תל אביב,6300,גבעתיים,704,322,382,343,361,76,701,5,2%
2016-06,תל אביב,6400,הרצלייה,1037,467,570,372,665,37,1027,32,2%
2016-06,תל אביב,6600,חולון,2833,1303,1530,441,2392,663,2774,67,3%
2016-06,תל אביב,2620,קריית אונו,341,154,187,148,193,39,339,1,2%
2016-06,תל אביב,8600,רמת גן,1889,872,1017,690,1199,332,1847,25,2%
2016-06,תל אביב,2650,רמת השרון,377,162,215,160,217,6,375,5,2%
2016-06,תל אביב,5000,תל אביב -יפו,6858,3428,3430,2424,4434,1752,6738,105,3%
2016-07,אזור יהודה והשומרון,3760,אורנית,96,47,49,36,60,2,96,1,2%
2016-07,אזור יהודה והשומרון,3750,אלפי מנשה,83,33,50,21,62,2,83,1,2%
2016-07,אזור יהודה והשומרון,3560,אלקנה,32,11,21,19,13,0,32,1,2%
2016-07,אזור יהודה והשומרון,3650,אפרת,88,32,56,38,50,6,84,1,2%
2016-07,אזור יהודה והשומרון,3570,אריאל,305,137,168,85,220,32,302,14,3%
2016-07,אזור יהודה והשומרון,3574,בית אל,46,23,23,12,34,16,46,0,2%
2016-07,אזור יהודה והשומרון,3652,בית אריה,45,17,28,16,29,1,45,1,2%
2016-07,אזור יהודה והשומרון,3780,ביתר עילית,771,274,497,14,757,221,766,17,6%
2016-07,אזור יהודה והשומרון,3730,גבעת זאב,195,82,113,41,154,35,193,3,3%
2016-07,אזור יהודה והשומרון,3769,הר אדר,31,12,19,15,16,3,31,0,2%
2016-07,אזור יהודה והשומרון,3797,מודיעין עילית,781,137,644,28,753,41,776,6,6%
2016-07,אזור יהודה והשומרון,3616,מעלה אדומים,679,276,403,99,580,185,673,14,3%
2016-07,אזור יהודה והשומרון,3660,עמנואל,70,38,32,1,69,27,69,0,6%
2016-07,אזור יהודה והשומרון,3557,קדומים,47,27,20,14,33,4,46,1,2%
2016-07,אזור יהודה והשומרון,3611,קריית ארבע,109,58,51,14,95,43,106,2,3%
2016-07,אזור יהודה והשומרון,3640,קרני שומרון,64,32,32,17,47,4,62,1,2%
2016-07,הדרום,31,אופקים,1121,439,682,46,1075,548,1087,43,9%
2016-07,הדרום,2600,אילת,1154,546,608,60,1094,412,1108,42,3%
2016-07,הדרום,70,אשדוד,5794,2313,3481,711,5083,2461,5523,119,5%
2016-07,הדרום,7100,אשקלון,3898,1558,2340,481,3417,1797,3392,90,5%
2016-07,הדרום,9000,באר שבע,5874,2576,3298,775,5099,3074,5572,141,5%
2016-07,הדרום,2200,דימונה,1901,777,1124,96,1805,1163,1802,62,10%
2016-07,הדרום,1303,חורה,575,211,364,2,573,514,566,6,15%
2016-07,הדרום,831,ירוחם,437,201,236,13,424,225,411,24,9%
2016-07,הדרום,1059,כסיפה,1003,382,621,3,1000,874,994,7,21%
2016-07,הדרום,1271,להבים,56,26,30,29,27,2,56,0,2%
2016-07,הדרום,1060,לקיה,717,301,416,1,716,612,704,3,18%
2016-07,הדרום,1268,מיתר,69,24,45,25,44,6,69,1,2%
2016-07,הדרום,99,מצפה רמון,237,85,152,21,216,145,227,15,9%
2016-07,הדרום,246,נתיבות,1191,478,713,63,1128,455,1140,62,8%
2016-07,הדרום,666,עומר,57,20,37,15,42,3,57,0,1%
2016-07,הדרום,2560,ערד,707,335,372,73,634,342,672,33,6%
2016-07,הדרום,1192,ערערה-בנגב,1057,447,610,4,1053,962,1032,24,25%
2016-07,הדרום,2630,קריית גת,1764,678,1086,104,1660,844,1684,56,6%
2016-07,הדרום,1034,קריית מלאכי,861,378,483,25,836,356,834,78,7%
2016-07,הדרום,1161,רהט,2736,1140,1596,12,2724,2082,2704,72,15%
2016-07,הדרום,1286,שגב-שלום,409,122,287,2,407,310,401,5,16%
2016-07,הדרום,1031,שדרות,978,439,539,68,910,512,900,25,7%
2016-07,הדרום,1054,תל שבע,819,331,488,3,816,719,800,15,18%
2016-07,המרכז,182,אבן יהודה,153,70,83,47,106,16,153,2,2%
2016-07,המרכז,41,אליכין,75,37,38,10,65,21,70,0,4%
2016-07,המרכז,1309,אלעד,549,192,357,32,517,45,536,6,4%
2016-07,המרכז,2530,באר יעקב,270,94,176,62,208,42,265,6,3%
2016-07,המרכז,466,בית דגן,110,58,52,8,102,38,108,2,3%
2016-07,המרכז,1066,"בני עי""ש",150,69,81,28,122,42,149,7,4%
2016-07,המרכז,681,גבעת שמואל,238,120,118,76,162,45,229,2,2%
2016-07,המרכז,2550,גדרה,308,117,191,69,239,73,303,9,3%
2016-07,המרכז,627,ג'לג'וליה,105,36,69,1,104,64,101,1,3%
2016-07,המרכז,166,גן יבנה,289,125,164,55,234,56,283,3,3%
2016-07,המרכז,229,גני תקווה,174,77,97,65,109,22,174,1,2%
2016-07,המרכז,9700,הוד השרון,626,275,351,256,370,46,620,9,2%
2016-07,המרכז,1290,זמר,143,48,95,4,139,88,141,5,5%
2016-07,המרכז,2730,טייבה,1180,521,659,18,1162,878,1012,26,6%
2016-07,המרכז,2720,טירה,198,90,108,11,187,75,194,9,2%
2016-07,המרכז,2660,יבנה,778,333,445,124,654,214,771,23,3%
2016-07,המרכז,9400,יהוד,394,176,218,94,300,51,391,3,2%
2016-07,המרכז,1224,כוכב יאיר,84,45,39,48,36,0,84,2,1%
2016-07,המרכז,633,כפר ברא,24,12,12,0,24,16,22,0,2%
2016-07,המרכז,168,כפר יונה,304,126,178,50,254,35,300,1,3%
2016-07,המרכז,6900,כפר סבא,1165,516,649,419,746,95,1142,23,2%
2016-07,המרכז,634,כפר קאסם,253,100,153,7,246,117,245,2,3%
2016-07,המרכז,7000,לוד,1896,837,1059,131,1765,954,1855,35,5%
2016-07,המרכז,1200,מודיעין-מכבים-רעות*,896,399,497,316,580,55,885,20,2%
2016-07,המרכז,28,מזכרת בתיה,156,69,87,53,103,24,151,2,2%
2016-07,המרכז,7200,נס ציונה,675,281,394,185,490,143,667,8,3%
2016-07,המרכז,7400,נתניה,4146,1847,2299,559,3587,1280,4055,62,4%
2016-07,המרכז,587,סביון*,14,2,12,9,5,0,14,0,1%
2016-07,המרכז,171,פרדסייה,64,28,36,19,45,6,64,0,2%
2016-07,המרכז,7900,פתח תקווה,3838,1666,2172,880,2958,905,3754,45,3%
2016-07,המרכז,195,קדימה-צורן,274,108,166,79,195,37,269,1,3%
2016-07,המרכז,638,קלנסווה,436,226,210,8,428,310,397,15,5%
2016-07,המרכז,469,קריית עקרון,251,118,133,16,235,94,244,5,4%
2016-07,המרכז,2640,ראש העין,688,317,371,112,576,125,681,19,3%
2016-07,המרכז,8300,ראשון לציון,4080,1790,2290,817,3263,1094,4044,74,3%
2016-07,המרכז,8400,רחובות,2432,991,1441,566,1866,666,2382,58,4%
2016-07,המרכז,8500,רמלה,1624,728,896,116,1508,620,1551,57,4%
2016-07,המרכז,8700,רעננה,687,329,358,287,400,44,678,9,2%
2016-07,המרכז,1304,שוהם,178,78,100,76,102,10,177,1,2%
2016-07,המרכז,154,תל מונד,132,59,73,45,87,16,132,1,2%
2016-07,הצפון,473,אבו סנאן,590,238,352,4,586,471,583,8,10%
2016-07,הצפון,478,אכסאל,492,236,256,10,482,390,488,1,9%
2016-07,הצפון,529,אעבלין,475,203,272,9,466,387,467,12,9%
2016-07,הצפון,482,בועיינה-נוג'ידאת,271,122,149,8,263,214,263,2,7%
2016-07,הצפון,4001,בוקעאתא,368,134,234,3,365,296,354,0,13%
2016-07,הצפון,998,ביר אל-מכסור,343,136,207,3,340,261,341,4,9%
2016-07,הצפון,480,בית ג'ן,370,110,260,8,362,252,361,2,7%
2016-07,הצפון,9200,בית שאן,812,368,444,23,789,363,787,59,8%
2016-07,הצפון,944,בסמת טבעון,185,90,95,2,183,134,179,4,6%
2016-07,הצפון,483,בענה,325,143,182,8,317,269,317,3,10%
2016-07,הצפון,1292,ג'דיידה-מכר,1145,492,653,4,1141,932,1125,13,13%
2016-07,הצפון,485,ג'ולס,204,65,139,1,203,131,201,8,7%
2016-07,הצפון,487,ג'ש (גוש חלב),61,21,40,5,56,28,60,2,4%
2016-07,הצפון,489,דבורייה,324,134,190,20,304,244,320,3,8%
2016-07,הצפון,490,דייר אל-אסד,337,143,194,16,321,256,330,12,7%
2016-07,הצפון,492,דייר חנא,627,262,365,9,618,498,618,3,13%
2016-07,הצפון,975,זרזיר,253,111,142,3,250,150,248,2,8%
2016-07,הצפון,496,חורפיש,123,62,61,8,115,64,119,4,4%
2016-07,הצפון,2034,חצור הגלילית,290,115,175,20,270,131,275,7,6%
2016-07,הצפון,6700,טבריה,1541,705,836,83,1458,736,1378,43,6%
2016-07,הצפון,962,טובא-זנגרייה,337,151,186,5,332,233,329,1,11%
2016-07,הצפון,498,טורעאן,424,178,246,8,416,334,417,9,7%
2016-07,הצפון,8900,טמרה,1478,624,854,22,1456,1245,1453,18,11%
2016-07,הצפון,1295,יאנוח-ג'ת,146,50,96,4,142,82,144,9,5%
2016-07,הצפון,46,יבנאל,126,73,53,6,120,83,99,2,6%
2016-07,הצפון,499,יפיע,558,233,325,14,544,429,552,1,7%
2016-07,הצפון,240,יקנעם עילית,457,174,283,88,369,104,453,26,4%
2016-07,הצפון,502,ירכא,521,214,307,0,521,403,510,7,9%
2016-07,הצפון,504,כאבול,522,233,289,13,509,433,514,4,11%
2016-07,הצפון,505,כאוכב אבו אל-היג'א,213,86,127,4,209,181,207,1,12%
2016-07,הצפון,1296,כסרא-סמיע,203,81,122,5,198,137,189,2,6%
2016-07,הצפון,978,כעביה-טבאש-חג'אג'רה,159,68,91,2,157,112,157,2,7%
2016-07,הצפון,1263,כפר ורדים,67,30,37,26,41,3,66,0,2%
2016-07,הצפון,507,כפר יאסיף,413,176,237,5,408,301,401,2,8%
2016-07,הצפון,508,כפר כמא,45,14,31,3,42,23,45,0,3%
2016-07,הצפון,509,כפר כנא,894,389,505,20,874,700,864,10,10%
2016-07,הצפון,510,כפר מנדא,757,359,398,15,742,610,742,6,10%
2016-07,הצפון,47,כפר תבור,33,13,20,12,21,1,32,0,1%
2016-07,הצפון,1139,כרמיאל,1475,591,884,248,1227,667,1392,30,5%
2016-07,הצפון,481,מגאר,1314,523,791,26,1288,1064,1275,11,14%
2016-07,הצפון,516,מג'ד אל-כרום,501,212,289,12,489,334,487,11,8%
2016-07,הצפון,874,מגדל העמק,845,345,500,76,769,321,792,75,6%
2016-07,הצפון,4201,מג'דל שמס,411,159,252,9,402,326,391,2,8%
2016-07,הצפון,517,מזרעה,153,64,89,3,150,108,150,1,8%
2016-07,הצפון,4203,מסעדה,199,65,134,5,194,155,185,3,11%
2016-07,הצפון,518,מעיליא,55,26,29,7,48,25,54,1,3%
2016-07,הצפון,1063,מעלות-תרשיחא,814,396,418,87,727,408,777,37,7%
2016-07,הצפון,520,משהד,231,91,140,6,225,176,225,6,7%
2016-07,הצפון,9100,נהרייה,1771,842,929,193,1578,931,1689,78,6%
2016-07,הצפון,522,נחף,356,175,181,17,339,280,343,10,7%
2016-07,הצפון,7300,נצרת,2955,1252,1703,112,2843,2260,2904,7,8%
2016-07,הצפון,1061,נצרת עילית,1516,671,845,151,1365,727,1353,90,6%
2016-07,הצפון,525,סאג'ור,115,43,72,5,110,70,114,3,6%
2016-07,הצפון,7500,סח'נין,2072,878,1194,38,2034,1747,2035,15,15%
2016-07,הצפון,4501,ע'ג'ר,86,36,50,2,84,59,85,1,8%
2016-07,הצפון,530,עיילבון,151,61,90,3,148,107,148,0,6%
2016-07,הצפון,511,עילוט,292,109,183,2,290,244,292,1,10%
2016-07,הצפון,532,עין מאהל,393,190,203,7,386,318,373,2,7%
2016-07,הצפון,7600,עכו,2992,1325,1667,134,2858,2117,2895,67,11%
2016-07,הצפון,7700,עפולה,1551,639,912,180,1371,607,1465,78,6%
2016-07,הצפון,531,עראבה,1553,669,884,38,1515,1352,1527,9,15%
2016-07,הצפון,535,פסוטה,101,42,59,9,92,48,98,4,6%
2016-07,הצפון,536,פקיעין (בוקייעה),138,73,65,4,134,84,132,4,5%
2016-07,הצפון,8000,צפת,1186,605,581,83,1103,755,1114,26,8%
2016-07,הצפון,4100,קצרין,189,72,117,28,161,87,187,2,5%
2016-07,הצפון,2800,קריית שמונה,725,321,404,59,666,286,701,17,5%
2016-07,הצפון,543,ראמה,246,95,151,14,232,181,238,0,6%
2016-07,הצפון,26,ראש פינה,44,16,28,8,36,18,43,1,3%
2016-07,הצפון,542,ריינה,526,216,310,7,519,395,513,6,8%
2016-07,הצפון,122,רמת ישי,90,40,50,38,52,13,88,0,2%
2016-07,הצפון,913,שבלי - אום אל-גנם,209,81,128,5,204,120,207,1,8%
2016-07,הצפון,812,שלומי,204,92,112,11,193,95,192,4,5%
2016-07,הצפון,538,שעב,522,207,315,3,519,462,516,2,17%
2016-07,הצפון,8800,שפרעם,1573,615,958,34,1539,1239,1545,34,9%
2016-07,חיפה,2710,אום אל-פחם,2997,1181,1816,39,2958,2457,2949,41,15%
2016-07,חיפה,1020,אור עקיבא,486,213,273,54,432,127,470,12,5%
2016-07,חיפה,6000,באקה אל-גרביה,579,256,323,17,562,364,573,18,5%
2016-07,חיפה,9800,בנימינה-גבעת עדה*,189,74,115,58,131,47,187,3,3%
2016-07,חיפה,1326,"בסמ""ה",389,170,219,9,380,294,380,1,10%
2016-07,חיפה,541,ג'סר א-זרקא,372,187,185,3,369,231,368,13,6%
2016-07,חיפה,628,ג'ת,197,83,114,3,194,119,195,7,4%
2016-07,חיפה,494,דאלית אל-כרמל,475,181,294,10,465,248,439,5,6%
2016-07,חיפה,9300,זכרון יעקב,232,115,117,71,161,39,228,2,2%
2016-07,חיפה,6500,חדרה,2233,920,1313,234,1999,797,2087,41,4%
2016-07,חיפה,4000,חיפה,5587,2668,2919,1069,4518,2790,5295,109,4%
2016-07,חיפה,1247,חריש,74,30,44,2,72,20,68,0,5%
2016-07,חיפה,2100,טירת כרמל,618,310,308,32,586,327,602,16,6%
2016-07,חיפה,654,כפר קרע,372,170,202,15,357,226,366,2,4%
2016-07,חיפה,1327,מעלה עירון,775,289,486,7,768,606,762,13,13%
2016-07,חיפה,2500,נשר,430,207,223,81,349,156,417,7,3%
2016-07,חיפה,534,עספיא,296,130,166,16,280,151,274,4,5%
2016-07,חיפה,637,ערערה,557,240,317,14,543,364,547,7,7%
2016-07,חיפה,537,פוריידיס,341,166,175,10,331,210,336,6,6%
2016-07,חיפה,7800,פרדס חנה-כרכור,786,336,450,169,617,215,762,24,4%
2016-07,חיפה,6800,קריית אתא,1581,657,924,117,1464,779,1534,37,5%
2016-07,חיפה,9500,קריית ביאליק,987,401,586,114,873,454,962,27,5%
2016-07,חיפה,2300,קריית טבעון,151,67,84,63,88,34,148,1,2%
2016-07,חיפה,9600,קריית ים,1320,612,708,124,1196,749,1274,34,6%
2016-07,חיפה,8200,קריית מוצקין,949,403,546,163,786,405,916,18,4%
2016-07,חיפה,922,רכסים,190,62,128,10,180,72,177,1,5%
2016-07,ירושלים,472,אבו גוש,232,109,123,7,225,177,230,1,8%
2016-07,ירושלים,2610,בית שמש,1563,546,1017,112,1451,464,1514,25,5%
2016-07,ירושלים,3000,ירושלים,12468,5180,7288,1390,11078,7182,12155,119,4%
2016-07,ירושלים,1015,מבשרת ציון,350,165,185,82,268,121,344,6,3%
2016-07,ירושלים,1137,קריית יערים,52,17,35,13,39,14,52,0,4%
2016-07,תל אביב,2400,אור יהודה,744,347,397,69,675,167,719,33,4%
2016-07,תל אביב,565,אזור,190,83,107,34,156,29,189,5,3%
2016-07,תל אביב,6100,בני ברק,2448,888,1560,94,2354,781,2333,17,4%
2016-07,תל אביב,6200,בת ים,2625,1174,1451,373,2252,902,2493,76,4%
2016-07,תל אביב,6300,גבעתיים,743,306,437,340,403,76,741,5,2%
2016-07,תל אביב,6400,הרצלייה,1087,465,622,372,715,28,1083,20,2%
2016-07,תל אביב,6600,חולון,2910,1291,1619,460,2450,629,2861,53,3%
2016-07,תל אביב,2620,קריית אונו,395,156,239,169,226,37,394,0,2%
2016-07,תל אביב,8600,רמת גן,2086,884,1202,708,1378,329,2047,23,3%
2016-07,תל אביב,2650,רמת השרון,390,159,231,150,240,12,386,7,2%
2016-07,תל אביב,5000,תל אביב -יפו,7047,3485,3562,2549,4498,1720,6918,90,3%
2016-08,אזור יהודה והשומרון,3760,אורנית,97,48,49,36,61,2,96,1,2%
2016-08,אזור יהודה והשומרון,3750,אלפי מנשה,87,34,53,23,64,1,87,1,2%
2016-08,אזור יהודה והשומרון,3560,אלקנה,35,13,22,20,15,0,35,1,2%
2016-08,אזור יהודה והשומרון,3650,אפרת,100,46,54,50,50,4,100,1,2%
2016-08,אזור יהודה והשומרון,3570,אריאל,320,148,172,83,237,32,315,12,3%
2016-08,אזור יהודה והשומרון,3574,בית אל,58,32,26,15,43,16,58,0,2%
2016-08,אזור יהודה והשומרון,3652,בית אריה,45,18,27,15,30,1,45,1,2%
2016-08,אזור יהודה והשומרון,3780,ביתר עילית,860,283,577,17,843,218,852,3,7%
2016-08,אזור יהודה והשומרון,3730,גבעת זאב,201,75,126,39,162,36,198,2,3%
2016-08,אזור יהודה והשומרון,3769,הר אדר,28,13,15,10,18,4,28,0,1%
2016-08,אזור יהודה והשומרון,3797,מודיעין עילית,920,144,776,28,892,42,916,3,7%
2016-08,אזור יהודה והשומרון,3616,מעלה אדומים,696,280,416,101,595,195,691,13,3%
2016-08,אזור יהודה והשומרון,3660,עמנואל,71,38,33,1,70,30,71,1,6%
2016-08,אזור יהודה והשומרון,3557,קדומים,45,24,21,14,31,5,43,0,2%
2016-08,אזור יהודה והשומרון,3611,קריית ארבע,110,61,49,17,93,44,108,3,3%
2016-08,אזור יהודה והשומרון,3640,קרני שומרון,69,35,34,16,53,4,69,3,2%
2016-08,הדרום,31,אופקים,1145,414,731,48,1097,536,1112,38,9%
2016-08,הדרום,2600,אילת,1119,524,595,66,1053,384,1072,57,3%
2016-08,הדרום,70,אשדוד,6036,2286,3750,709,5327,2490,5746,151,5%
2016-08,הדרום,7100,אשקלון,4029,1588,2441,487,3542,1777,3529,92,5%
2016-08,הדרום,9000,באר שבע,6013,2567,3446,761,5252,3066,5701,109,6%
2016-08,הדרום,2200,דימונה,1897,767,1130,103,1794,1157,1812,36,10%
2016-08,הדרום,1303,חורה,588,221,367,0,588,520,579,3,15%
2016-08,הדרום,831,ירוחם,439,204,235,13,426,223,418,24,9%
2016-08,הדרום,1059,כסיפה,1002,374,628,3,999,879,996,7,21%
2016-08,הדרום,1271,להבים,56,22,34,28,28,2,56,1,2%
2016-08,הדרום,1060,לקיה,727,308,419,1,726,615,712,7,18%
2016-08,הדרום,1268,מיתר,73,26,47,25,48,4,73,0,2%
2016-08,הדרום,99,מצפה רמון,255,95,160,18,237,149,246,7,10%
2016-08,הדרום,246,נתיבות,1202,452,750,72,1130,466,1133,53,8%
2016-08,הדרום,666,עומר,50,16,34,12,38,4,49,0,1%
2016-08,הדרום,2560,ערד,705,315,390,72,633,341,668,35,5%
2016-08,הדרום,1192,ערערה-בנגב,1067,447,620,5,1062,963,1047,7,25%
2016-08,הדרום,2630,קריית גת,1811,713,1098,104,1707,813,1747,64,6%
2016-08,הדרום,1034,קריית מלאכי,859,370,489,29,830,343,830,77,7%
2016-08,הדרום,1161,רהט,2705,1087,1618,14,2691,2100,2677,76,14%
2016-08,הדרום,1286,שגב-שלום,420,128,292,1,419,317,408,2,16%
2016-08,הדרום,1031,שדרות,1007,453,554,71,936,514,934,24,7%
2016-08,הדרום,1054,תל שבע,844,346,498,2,842,728,820,8,18%
2016-08,המרכז,182,אבן יהודה,157,68,89,51,106,16,157,0,2%
2016-08,המרכז,41,אליכין,72,34,38,7,65,22,69,3,4%
2016-08,המרכז,1309,אלעד,667,219,448,34,633,50,652,5,5%
2016-08,המרכז,2530,באר יעקב,285,99,186,68,217,37,282,4,3%
2016-08,המרכז,466,בית דגן,113,60,53,11,102,37,110,1,3%
2016-08,המרכז,1066,"בני עי""ש",159,69,90,27,132,41,156,8,4%
2016-08,המרכז,681,גבעת שמואל,254,127,127,81,173,47,247,2,2%
2016-08,המרכז,2550,גדרה,338,125,213,72,266,75,331,3,3%
2016-08,המרכז,627,ג'לג'וליה,119,43,76,4,115,67,113,3,3%
2016-08,המרכז,166,גן יבנה,316,135,181,59,257,57,311,3,3%
2016-08,המרכז,229,גני תקווה,180,78,102,65,115,26,179,1,2%
2016-08,המרכז,9700,הוד השרון,672,279,393,248,424,45,665,14,2%
2016-08,המרכז,1290,זמר,145,53,92,5,140,86,144,3,5%
2016-08,המרכז,2730,טייבה,1210,530,680,23,1187,885,1032,32,6%
2016-08,המרכז,2720,טירה,210,87,123,11,199,70,205,9,2%
2016-08,המרכז,2660,יבנה,854,349,505,135,719,217,842,23,4%
2016-08,המרכז,9400,יהוד,425,177,248,93,332,59,417,3,3%
2016-08,המרכז,1224,כוכב יאיר,87,45,42,54,33,0,87,1,2%
2016-08,המרכז,633,כפר ברא,29,15,14,1,28,16,28,1,2%
2016-08,המרכז,168,כפר יונה,325,128,197,55,270,32,322,2,3%
2016-08,המרכז,6900,כפר סבא,1192,520,672,413,779,96,1170,28,2%
2016-08,המרכז,634,כפר קאסם,267,103,164,11,256,120,257,6,3%
2016-08,המרכז,7000,לוד,1964,843,1121,145,1819,938,1924,49,5%
2016-08,המרכז,1200,מודיעין-מכבים-רעות*,954,404,550,333,621,52,946,15,2%
2016-08,המרכז,28,מזכרת בתיה,193,78,115,68,125,26,190,2,3%
2016-08,המרכז,7200,נס ציונה,686,287,399,173,513,150,680,16,3%
2016-08,המרכז,7400,נתניה,4447,1878,2569,542,3905,1308,4344,55,4%
2016-08,המרכז,587,סביון*,13,1,12,8,5,0,13,0,1%
2016-08,המרכז,171,פרדסייה,68,28,40,17,51,6,68,0,2%
2016-08,המרכז,7900,פתח תקווה,4078,1699,2379,897,3181,902,3991,41,3%
2016-08,המרכז,195,קדימה-צורן,279,115,164,83,196,37,276,2,3%
2016-08,המרכז,638,קלנסווה,443,228,215,8,435,317,403,14,5%
2016-08,המרכז,469,קריית עקרון,286,121,165,21,265,95,278,6,5%
2016-08,המרכז,2640,ראש העין,794,325,469,121,673,121,784,17,3%
2016-08,המרכז,8300,ראשון לציון,4222,1809,2413,827,3395,1116,4169,69,3%
2016-08,המרכז,8400,רחובות,2586,996,1590,608,1978,685,2528,55,4%
2016-08,המרכז,8500,רמלה,1670,737,933,120,1550,613,1604,61,4%
2016-08,המרכז,8700,רעננה,691,323,368,282,409,45,684,3,2%
2016-08,המרכז,1304,שוהם,173,77,96,76,97,8,172,0,2%
2016-08,המרכז,154,תל מונד,131,60,71,47,84,15,130,0,2%
2016-08,הצפון,473,אבו סנאן,602,242,360,4,598,481,589,5,10%
2016-08,הצפון,478,אכסאל,503,236,267,8,495,399,498,3,9%
2016-08,הצפון,529,אעבלין,468,193,275,14,454,385,465,14,8%
2016-08,הצפון,482,בועיינה-נוג'ידאת,265,120,145,10,255,214,256,2,7%
2016-08,הצפון,4001,בוקעאתא,367,138,229,3,364,298,357,1,13%
2016-08,הצפון,998,ביר אל-מכסור,334,131,203,3,331,266,330,4,9%
2016-08,הצפון,480,בית ג'ן,385,113,272,11,374,251,374,2,7%
2016-08,הצפון,9200,בית שאן,838,378,460,24,814,359,807,73,8%
2016-08,הצפון,944,בסמת טבעון,174,80,94,2,172,134,166,2,5%
2016-08,הצפון,483,בענה,337,146,191,10,327,267,328,5,10%
2016-08,הצפון,1292,ג'דיידה-מכר,1166,492,674,5,1161,933,1143,17,13%
2016-08,הצפון,485,ג'ולס,203,74,129,2,201,125,201,4,7%
2016-08,הצפון,487,ג'ש (גוש חלב),57,21,36,3,54,27,55,4,3%
2016-08,הצפון,489,דבורייה,321,135,186,20,301,232,318,4,8%
2016-08,הצפון,490,דייר אל-אסד,337,141,196,15,322,257,330,5,7%
2016-08,הצפון,492,דייר חנא,608,257,351,8,600,494,600,6,13%
2016-08,הצפון,975,זרזיר,255,108,147,7,248,150,249,7,8%
2016-08,הצפון,496,חורפיש,124,63,61,10,114,60,120,2,5%
2016-08,הצפון,2034,חצור הגלילית,293,115,178,20,273,131,280,4,6%
2016-08,הצפון,6700,טבריה,1537,688,849,79,1458,725,1375,62,6%
2016-08,הצפון,962,טובא-זנגרייה,327,149,178,5,322,231,316,5,11%
2016-08,הצפון,498,טורעאן,465,186,279,10,455,354,454,10,8%
2016-08,הצפון,8900,טמרה,1465,631,834,25,1440,1238,1445,21,11%
2016-08,הצפון,1295,יאנוח-ג'ת,140,47,93,4,136,82,137,6,5%
2016-08,הצפון,46,יבנאל,129,70,59,5,124,77,108,2,7%
2016-08,הצפון,499,יפיע,562,233,329,18,544,428,553,1,7%
2016-08,הצפון,240,יקנעם עילית,501,204,297,93,408,107,496,25,4%
2016-08,הצפון,502,ירכא,521,217,304,0,521,393,512,4,9%
2016-08,הצפון,504,כאבול,521,231,290,9,512,432,514,9,11%
2016-08,הצפון,505,כאוכב אבו אל-היג'א,213,85,128,3,210,180,207,1,12%
2016-08,הצפון,1296,כסרא-סמיע,190,78,112,8,182,122,180,4,5%
2016-08,הצפון,978,כעביה-טבאש-חג'אג'רה,162,73,89,3,159,117,156,2,7%
2016-08,הצפון,1263,כפר ורדים,65,29,36,27,38,3,64,0,2%
2016-08,הצפון,507,כפר יאסיף,426,170,256,3,423,298,417,7,8%
2016-08,הצפון,508,כפר כמא,49,15,34,4,45,22,49,0,3%
2016-08,הצפון,509,כפר כנא,892,381,511,19,873,704,853,14,10%
2016-08,הצפון,510,כפר מנדא,774,367,407,16,758,619,760,3,11%
2016-08,הצפון,47,כפר תבור,35,14,21,12,23,1,34,0,2%
2016-08,הצפון,1139,כרמיאל,1496,584,912,253,1243,683,1407,43,5%
2016-08,הצפון,481,מגאר,1319,534,785,31,1288,1058,1280,15,14%
2016-08,הצפון,516,מג'ד אל-כרום,509,205,304,15,494,327,498,12,8%
2016-08,הצפון,874,מגדל העמק,908,376,532,76,832,323,851,69,6%
2016-08,הצפון,4201,מג'דל שמס,397,152,245,9,388,326,374,2,8%
2016-08,הצפון,517,מזרעה,158,66,92,1,157,113,151,4,8%
2016-08,הצפון,4203,מסעדה,189,62,127,5,184,154,177,2,11%
2016-08,הצפון,518,מעיליא,58,25,33,5,53,22,57,1,3%
2016-08,הצפון,1063,מעלות-תרשיחא,831,417,414,84,747,396,798,41,7%
2016-08,הצפון,520,משהד,231,96,135,7,224,174,227,2,7%
2016-08,הצפון,9100,נהרייה,1766,827,939,189,1577,918,1686,68,5%
2016-08,הצפון,522,נחף,349,165,184,14,335,279,345,6,7%
2016-08,הצפון,7300,נצרת,3015,1252,1763,113,2902,2291,2959,20,9%
2016-08,הצפון,1061,נצרת עילית,1563,694,869,145,1418,722,1390,96,6%
2016-08,הצפון,525,סאג'ור,117,44,73,4,113,75,115,4,6%
2016-08,הצפון,7500,סח'נין,2073,880,1193,37,2036,1746,2038,15,15%
2016-08,הצפון,4501,ע'ג'ר,90,37,53,2,88,59,89,1,9%
2016-08,הצפון,530,עיילבון,149,59,90,4,145,106,146,1,5%
2016-08,הצפון,511,עילוט,294,112,182,1,293,248,290,5,10%
2016-08,הצפון,532,עין מאהל,406,197,209,7,399,314,389,7,8%
2016-08,הצפון,7600,עכו,2991,1297,1694,140,2851,2088,2911,58,11%
2016-08,הצפון,7700,עפולה,1620,642,978,193,1427,620,1537,81,6%
2016-08,הצפון,531,עראבה,1537,657,880,35,1502,1343,1508,12,15%
2016-08,הצפון,535,פסוטה,95,38,57,8,87,42,91,3,5%
2016-08,הצפון,536,פקיעין (בוקייעה),147,72,75,7,140,82,142,6,5%
2016-08,הצפון,8000,צפת,1199,586,613,86,1113,745,1129,26,9%
2016-08,הצפון,4100,קצרין,191,71,120,31,160,86,189,2,5%
2016-08,הצפון,2800,קריית שמונה,743,321,422,66,677,283,711,34,5%
2016-08,הצפון,543,ראמה,266,109,157,15,251,180,254,4,7%
2016-08,הצפון,26,ראש פינה,42,14,28,5,37,19,39,2,2%
2016-08,הצפון,542,ריינה,543,226,317,9,534,399,522,12,8%
2016-08,הצפון,122,רמת ישי,96,44,52,41,55,12,94,0,2%
2016-08,הצפון,913,שבלי - אום אל-גנם,211,73,138,6,205,129,208,3,8%
2016-08,הצפון,812,שלומי,215,92,123,10,205,98,207,6,6%
2016-08,הצפון,538,שעב,516,203,313,3,513,456,508,1,17%
2016-08,הצפון,8800,שפרעם,1563,614,949,38,1525,1222,1535,25,9%
2016-08,חיפה,2710,אום אל-פחם,3012,1182,1830,38,2974,2474,2967,41,15%
2016-08,חיפה,1020,אור עקיבא,493,215,278,55,438,128,472,21,5%
2016-08,חיפה,6000,באקה אל-גרביה,591,280,311,15,576,360,587,16,5%
2016-08,חיפה,9800,בנימינה-גבעת עדה*,198,81,117,59,139,48,197,1,3%
2016-08,חיפה,1326,"בסמ""ה",389,171,218,10,379,289,384,4,10%
2016-08,חיפה,541,ג'סר א-זרקא,379,191,188,4,375,220,376,15,7%
2016-08,חיפה,628,ג'ת,208,90,118,3,205,121,206,11,4%
2016-08,חיפה,494,דאלית אל-כרמל,478,184,294,11,467,251,441,4,6%
2016-08,חיפה,9300,זכרון יעקב,263,132,131,92,171,40,261,0,2%
2016-08,חיפה,6500,חדרה,2307,943,1364,237,2070,801,2155,53,4%
2016-08,חיפה,4000,חיפה,5811,2729,3082,1131,4680,2797,5492,113,4%
2016-08,חיפה,1247,חריש,74,32,42,8,66,22,68,1,5%
2016-08,חיפה,2100,טירת כרמל,671,319,352,34,637,330,653,26,6%
2016-08,חיפה,654,כפר קרע,385,175,210,16,369,231,380,4,5%
2016-08,חיפה,1327,מעלה עירון,763,281,482,6,757,596,749,7,13%
2016-08,חיפה,2500,נשר,440,205,235,86,354,145,428,3,3%
2016-08,חיפה,534,עספיא,292,132,160,15,277,154,275,1,5%
2016-08,חיפה,637,ערערה,548,233,315,15,533,348,541,20,7%
2016-08,חיפה,537,פוריידיס,329,154,175,8,321,196,323,6,6%
2016-08,חיפה,7800,פרדס חנה-כרכור,780,326,454,165,615,207,764,21,4%
2016-08,חיפה,6800,קריית אתא,1665,700,965,134,1531,771,1623,32,5%
2016-08,חיפה,9500,קריית ביאליק,1006,397,609,119,887,448,974,22,5%
2016-08,חיפה,2300,קריית טבעון,169,74,95,69,100,36,165,1,2%
2016-08,חיפה,9600,קריית ים,1347,610,737,127,1220,732,1307,32,6%
2016-08,חיפה,8200,קריית מוצקין,982,404,578,168,814,408,947,27,4%
2016-08,חיפה,922,רכסים,248,70,178,11,237,70,234,0,7%
2016-08,ירושלים,472,אבו גוש,243,110,133,7,236,179,239,2,8%
2016-08,ירושלים,2610,בית שמש,1597,543,1054,117,1480,447,1556,35,5%
2016-08,ירושלים,3000,ירושלים,13209,5344,7865,1438,11771,7254,12888,122,4%
2016-08,ירושלים,1015,מבשרת ציון,348,167,181,78,270,119,340,5,3%
2016-08,ירושלים,1137,קריית יערים,52,16,36,12,40,12,52,1,4%
2016-08,תל אביב,2400,אור יהודה,802,346,456,67,735,152,772,34,4%
2016-08,תל אביב,565,אזור,182,76,106,30,152,27,182,5,3%
2016-08,תל אביב,6100,בני ברק,2826,911,1915,95,2731,779,2705,17,5%
2016-08,תל אביב,6200,בת ים,2706,1224,1482,375,2331,895,2576,73,4%
2016-08,תל אביב,6300,גבעתיים,735,290,445,330,405,77,731,3,2%
2016-08,תל אביב,6400,הרצלייה,1185,471,714,379,806,25,1177,14,2%
2016-08,תל אביב,6600,חולון,3007,1332,1675,469,2538,627,2944,53,3%
2016-08,תל אביב,2620,קריית אונו,400,153,247,177,223,36,398,0,2%
2016-08,תל אביב,8600,רמת גן,2084,876,1208,671,1413,323,2047,16,3%
2016-08,תל אביב,2650,רמת השרון,423,165,258,163,260,5,422,3,2%
2016-08,תל אביב,5000,תל אביב -יפו,7198,3483,3715,2588,4610,1716,7056,89,3%
2016-09,אזור יהודה והשומרון,3760,אורנית,91,50,41,33,58,3,91,2,2%
2016-09,אזור יהודה והשומרון,3750,אלפי מנשה,84,31,53,25,59,1,84,0,2%
2016-09,אזור יהודה והשומרון,3560,אלקנה,29,13,16,18,11,0,29,0,2%
2016-09,אזור יהודה והשומרון,3650,אפרת,112,56,56,60,52,4,110,0,3%
2016-09,אזור יהודה והשומרון,3570,אריאל,324,147,177,84,240,34,320,14,3%
2016-09,אזור יהודה והשומרון,3574,בית אל,50,22,28,18,32,14,50,1,2%
2016-09,אזור יהודה והשומרון,3652,בית אריה,39,16,23,10,29,1,39,0,2%
2016-09,אזור יהודה והשומרון,3780,ביתר עילית,577,238,339,17,560,201,573,1,5%
2016-09,אזור יהודה והשומרון,3730,גבעת זאב,192,79,113,38,154,36,188,2,3%
2016-09,אזור יהודה והשומרון,3769,הר אדר,28,15,13,11,17,4,28,0,1%
2016-09,אזור יהודה והשומרון,3797,מודיעין עילית,553,117,436,25,528,35,552,2,4%
2016-09,אזור יהודה והשומרון,3616,מעלה אדומים,639,265,374,100,539,193,632,19,3%
2016-09,אזור יהודה והשומרון,3660,עמנואל,74,39,35,1,73,29,73,2,6%
2016-09,אזור יהודה והשומרון,3557,קדומים,40,22,18,12,28,4,39,0,2%
2016-09,אזור יהודה והשומרון,3611,קריית ארבע,100,52,48,11,89,42,99,4,3%
2016-09,אזור יהודה והשומרון,3640,קרני שומרון,76,37,39,19,57,6,75,3,2%
2016-09,הדרום,31,אופקים,1048,405,643,59,989,520,1016,42,8%
2016-09,הדרום,2600,אילת,1037,512,525,62,975,382,979,59,3%
2016-09,הדרום,70,אשדוד,5590,2241,3349,695,4895,2430,5325,173,5%
2016-09,הדרום,7100,אשקלון,3840,1541,2299,463,3377,1764,3372,86,5%
2016-09,הדרום,9000,באר שבע,5754,2452,3302,716,5038,3035,5464,146,5%
2016-09,הדרום,2200,דימונה,1780,774,1006,93,1687,1152,1692,66,9%
2016-09,הדרום,1303,חורה,551,211,340,0,551,500,540,7,14%
2016-09,הדרום,831,ירוחם,417,200,217,19,398,220,397,33,9%
2016-09,הדרום,1059,כסיפה,971,364,607,3,968,859,965,3,21%
2016-09,הדרום,1271,להבים,59,20,39,30,29,4,59,0,2%
2016-09,הדרום,1060,לקיה,690,310,380,1,689,605,674,3,17%
2016-09,הדרום,1268,מיתר,81,30,51,32,49,4,81,2,2%
2016-09,הדרום,99,מצפה רמון,260,91,169,22,238,161,252,13,10%
2016-09,הדרום,246,נתיבות,1086,438,648,59,1027,456,1019,65,7%
2016-09,הדרום,666,עומר,55,17,38,15,40,5,54,2,1%
2016-09,הדרום,2560,ערד,717,318,399,73,644,349,682,43,6%
2016-09,הדרום,1192,ערערה-בנגב,1054,431,623,5,1049,955,1036,0,25%
2016-09,הדרום,2630,קריית גת,1718,677,1041,92,1626,804,1647,67,6%
2016-09,הדרום,1034,קריית מלאכי,811,354,457,21,790,344,778,78,7%
2016-09,הדרום,1161,רהט,2548,996,1552,13,2535,2077,2507,67,14%
2016-09,הדרום,1286,שגב-שלום,365,118,247,2,363,301,359,13,14%
2016-09,הדרום,1031,שדרות,991,433,558,67,924,547,903,26,7%
2016-09,הדרום,1054,תל שבע,779,335,444,1,778,703,754,11,17%
2016-09,המרכז,182,אבן יהודה,166,74,92,55,111,18,165,0,2%
2016-09,המרכז,41,אליכין,58,33,25,7,51,19,56,1,3%
2016-09,המרכז,1309,אלעד,454,167,287,27,427,43,443,12,4%
2016-09,המרכז,2530,באר יעקב,248,81,167,68,180,40,246,5,3%
2016-09,המרכז,466,בית דגן,122,60,62,13,109,38,120,3,3%
2016-09,המרכז,1066,"בני עי""ש",144,66,78,24,120,42,141,7,4%
2016-09,המרכז,681,גבעת שמואל,238,116,122,91,147,48,232,2,2%
2016-09,המרכז,2550,גדרה,321,126,195,65,256,78,312,7,3%
2016-09,המרכז,627,ג'לג'וליה,86,33,53,1,85,55,84,0,2%
2016-09,המרכז,166,גן יבנה,300,123,177,51,249,54,296,8,3%
2016-09,המרכז,229,גני תקווה,180,84,96,76,104,27,178,1,2%
2016-09,המרכז,9700,הוד השרון,633,269,364,270,363,44,626,9,2%
2016-09,המרכז,1290,זמר,135,46,89,4,131,81,134,4,5%
2016-09,המרכז,2730,טייבה,1181,519,662,26,1155,861,1012,29,6%
2016-09,המרכז,2720,טירה,184,84,100,9,175,64,182,3,2%
2016-09,המרכז,2660,יבנה,839,324,515,157,682,212,830,27,4%
2016-09,המרכז,9400,יהוד,386,167,219,92,294,55,378,8,2%
2016-09,המרכז,1224,כוכב יאיר,86,48,38,46,40,0,86,0,2%
2016-09,המרכז,633,כפר ברא,31,17,14,3,28,16,30,1,2%
2016-09,המרכז,168,כפר יונה,312,131,181,59,253,35,311,4,3%
2016-09,המרכז,6900,כפר סבא,1176,516,660,423,753,106,1150,47,2%
2016-09,המרכז,634,כפר קאסם,224,100,124,16,208,124,217,3,2%
2016-09,המרכז,7000,לוד,1812,784,1028,137,1675,923,1764,48,5%
2016-09,המרכז,1200,מודיעין-מכבים-רעות*,868,374,494,320,548,50,862,11,2%
2016-09,המרכז,28,מזכרת בתיה,158,68,90,64,94,26,154,7,2%
2016-09,המרכז,7200,נס ציונה,617,262,355,160,457,150,608,11,3%
2016-09,המרכז,7400,נתניה,4070,1840,2230,501,3569,1298,3977,96,4%
2016-09,המרכז,587,סביון*,17,4,13,8,9,0,17,0,1%
2016-09,המרכז,171,פרדסייה,75,31,44,16,59,9,75,0,2%
2016-09,המרכז,7900,פתח תקווה,3761,1625,2136,869,2892,903,3661,59,3%
2016-09,המרכז,195,קדימה-צורן,271,112,159,79,192,38,267,5,3%
2016-09,המרכז,638,קלנסווה,429,217,212,7,422,312,390,15,5%
2016-09,המרכז,469,קריית עקרון,250,118,132,26,224,97,244,8,4%
2016-09,המרכז,2640,ראש העין,721,334,387,123,598,124,708,26,3%
2016-09,המרכז,8300,ראשון לציון,4127,1751,2376,821,3306,1138,4085,106,3%
2016-09,המרכז,8400,רחובות,2273,998,1275,552,1721,686,2214,68,3%
2016-09,המרכז,8500,רמלה,1563,713,850,123,1440,613,1491,72,4%
2016-09,המרכז,8700,רעננה,656,301,355,271,385,44,650,11,2%
2016-09,המרכז,1304,שוהם,169,69,100,69,100,8,168,2,2%
2016-09,המרכז,154,תל מונד,129,59,70,43,86,17,128,0,2%
2016-09,הצפון,473,אבו סנאן,578,239,339,4,574,469,572,2,10%
2016-09,הצפון,478,אכסאל,486,215,271,7,479,391,478,3,9%
2016-09,הצפון,529,אעבלין,459,182,277,8,451,383,452,8,8%
2016-09,הצפון,482,בועיינה-נוג'ידאת,254,116,138,8,246,207,247,0,7%
2016-09,הצפון,4001,בוקעאתא,367,133,234,4,363,295,357,1,13%
2016-09,הצפון,998,ביר אל-מכסור,342,145,197,2,340,265,339,1,9%
2016-09,הצפון,480,בית ג'ן,355,98,257,9,346,242,345,3,7%
2016-09,הצפון,9200,בית שאן,829,351,478,30,799,355,805,65,8%
2016-09,הצפון,944,בסמת טבעון,165,77,88,3,162,130,154,2,5%
2016-09,הצפון,483,בענה,312,135,177,6,306,262,303,2,9%
2016-09,הצפון,1292,ג'דיידה-מכר,1109,482,627,3,1106,912,1088,17,12%
2016-09,הצפון,485,ג'ולס,191,59,132,1,190,123,190,0,7%
2016-09,הצפון,487,ג'ש (גוש חלב),62,25,37,6,56,29,61,0,4%
2016-09,הצפון,489,דבורייה,309,125,184,19,290,221,306,3,7%
2016-09,הצפון,490,דייר אל-אסד,323,145,178,14,309,265,313,5,6%
2016-09,הצפון,492,דייר חנא,596,246,350,7,589,488,584,2,12%
2016-09,הצפון,975,זרזיר,241,101,140,7,234,154,236,7,8%
2016-09,הצפון,496,חורפיש,112,48,64,8,104,61,108,2,4%
2016-09,הצפון,2034,חצור הגלילית,286,108,178,22,264,129,269,12,6%
2016-09,הצפון,6700,טבריה,1500,654,846,79,1421,742,1313,59,6%
2016-09,הצפון,962,טובא-זנגרייה,311,143,168,5,306,226,299,8,10%
2016-09,הצפון,498,טורעאן,417,171,246,12,405,344,404,11,7%
2016-09,הצפון,8900,טמרה,1377,597,780,25,1352,1189,1360,12,10%
2016-09,הצפון,1295,יאנוח-ג'ת,119,40,79,5,114,80,117,5,4%
2016-09,הצפון,46,יבנאל,127,64,63,6,121,77,100,3,6%
2016-09,הצפון,499,יפיע,527,205,322,21,506,411,521,3,7%
2016-09,הצפון,240,יקנעם עילית,432,174,258,88,344,105,425,36,4%
2016-09,הצפון,502,ירכא,478,195,283,0,478,360,470,3,8%
2016-09,הצפון,504,כאבול,494,226,268,10,484,421,489,4,10%
2016-09,הצפון,505,כאוכב אבו אל-היג'א,207,80,127,2,205,174,202,0,12%
2016-09,הצפון,1296,כסרא-סמיע,190,73,117,5,185,122,180,4,5%
2016-09,הצפון,978,כעביה-טבאש-חג'אג'רה,153,64,89,3,150,111,149,1,7%
2016-09,הצפון,1263,כפר ורדים,66,32,34,29,37,5,66,3,2%
2016-09,הצפון,507,כפר יאסיף,410,168,242,4,406,290,398,6,8%
2016-09,הצפון,508,כפר כמא,47,14,33,5,42,21,47,0,3%
2016-09,הצפון,509,כפר כנא,845,372,473,23,822,687,810,18,9%
2016-09,הצפון,510,כפר מנדא,720,333,387,13,707,578,709,4,10%
2016-09,הצפון,47,כפר תבור,35,13,22,13,22,1,34,0,2%
2016-09,הצפון,1139,כרמיאל,1481,581,900,255,1226,692,1379,40,5%
2016-09,הצפון,481,מגאר,1259,501,758,18,1241,1037,1217,11,13%
2016-09,הצפון,516,מג'ד אל-כרום,468,198,270,9,459,334,448,8,7%
2016-09,הצפון,874,מגדל העמק,893,361,532,84,809,319,830,66,6%
2016-09,הצפון,4201,מג'דל שמס,412,156,256,12,400,328,390,2,8%
2016-09,הצפון,517,מזרעה,151,57,94,0,151,113,144,3,7%
2016-09,הצפון,4203,מסעדה,195,62,133,4,191,157,181,3,11%
2016-09,הצפון,518,מעיליא,60,25,35,5,55,24,58,0,4%
2016-09,הצפון,1063,מעלות-תרשיחא,791,395,396,82,709,393,758,39,6%
2016-09,הצפון,520,משהד,217,90,127,3,214,165,212,4,7%
2016-09,הצפון,9100,נהרייה,1801,798,1003,180,1621,954,1711,91,6%
2016-09,הצפון,522,נחף,338,154,184,12,326,280,330,7,7%
2016-09,הצפון,7300,נצרת,2873,1183,1690,118,2755,2179,2837,16,8%
2016-09,הצפון,1061,נצרת עילית,1539,680,859,158,1381,725,1376,111,6%
2016-09,הצפון,525,סאג'ור,105,36,69,5,100,70,104,0,6%
2016-09,הצפון,7500,סח'נין,2018,857,1161,38,1980,1709,1979,14,14%
2016-09,הצפון,4501,ע'ג'ר,87,33,54,2,85,61,86,0,8%
2016-09,הצפון,530,עיילבון,152,61,91,6,146,104,149,1,6%
2016-09,הצפון,511,עילוט,276,104,172,2,274,230,273,0,10%
2016-09,הצפון,532,עין מאהל,379,183,196,8,371,305,367,1,7%
2016-09,הצפון,7600,עכו,2828,1255,1573,139,2689,2057,2742,58,10%
2016-09,הצפון,7700,עפולה,1632,632,1000,198,1434,624,1546,107,6%
2016-09,הצפון,531,עראבה,1475,630,845,26,1449,1305,1444,10,14%
2016-09,הצפון,535,פסוטה,89,38,51,7,82,45,84,1,5%
2016-09,הצפון,536,פקיעין (בוקייעה),129,69,60,6,123,78,121,5,4%
2016-09,הצפון,8000,צפת,1141,565,576,101,1040,741,1077,23,8%
2016-09,הצפון,4100,קצרין,197,71,126,32,165,89,195,3,5%
2016-09,הצפון,2800,קריית שמונה,758,335,423,71,687,279,731,44,6%
2016-09,הצפון,543,ראמה,247,100,147,18,229,170,238,0,6%
2016-09,הצפון,26,ראש פינה,40,12,28,9,31,16,40,0,3%
2016-09,הצפון,542,ריינה,505,212,293,9,496,381,490,12,7%
2016-09,הצפון,122,רמת ישי,101,40,61,38,63,14,99,1,2%
2016-09,הצפון,913,שבלי - אום אל-גנם,194,71,123,7,187,129,192,1,8%
2016-09,הצפון,812,שלומי,217,86,131,12,205,104,203,5,6%
2016-09,הצפון,538,שעב,501,192,309,6,495,451,493,4,16%
2016-09,הצפון,8800,שפרעם,1497,605,892,45,1452,1214,1467,31,9%
2016-09,חיפה,2710,אום אל-פחם,2871,1140,1731,35,2836,2399,2824,32,14%
2016-09,חיפה,1020,אור עקיבא,472,190,282,53,419,128,452,18,5%
2016-09,חיפה,6000,באקה אל-גרביה,543,240,303,13,530,349,540,21,5%
2016-09,חיפה,9800,בנימינה-גבעת עדה*,191,81,110,59,132,43,191,4,3%
2016-09,חיפה,1326,"בסמ""ה",363,158,205,10,353,277,355,6,9%
2016-09,חיפה,541,ג'סר א-זרקא,324,181,143,4,320,196,324,13,6%
2016-09,חיפה,628,ג'ת,193,87,106,4,189,113,192,6,4%
2016-09,חיפה,494,דאלית אל-כרמל,448,172,276,15,433,244,417,8,5%
2016-09,חיפה,9300,זכרון יעקב,268,127,141,100,168,38,266,1,2%
2016-09,חיפה,6500,חדרה,2281,903,1378,244,2037,797,2133,36,4%
2016-09,חיפה,4000,חיפה,5585,2637,2948,1120,4465,2761,5275,149,4%
2016-09,חיפה,1247,חריש,74,32,42,12,62,22,70,0,5%
2016-09,חיפה,2100,טירת כרמל,652,307,345,34,618,317,639,21,6%
2016-09,חיפה,654,כפר קרע,378,178,200,14,364,234,373,13,5%
2016-09,חיפה,1327,מעלה עירון,710,262,448,5,705,570,700,4,12%
2016-09,חיפה,2500,נשר,445,204,241,99,346,157,430,10,3%
2016-09,חיפה,534,עספיא,271,116,155,17,254,149,249,5,5%
2016-09,חיפה,637,ערערה,526,235,291,13,513,337,519,10,6%
2016-09,חיפה,537,פוריידיס,289,147,142,5,284,180,286,4,5%
2016-09,חיפה,7800,פרדס חנה-כרכור,790,329,461,174,616,192,775,33,4%
2016-09,חיפה,6800,קריית אתא,1499,694,805,117,1382,747,1458,45,5%
2016-09,חיפה,9500,קריית ביאליק,997,392,605,120,877,441,970,31,5%
2016-09,חיפה,2300,קריית טבעון,185,82,103,76,109,36,181,0,2%
2016-09,חיפה,9600,קריית ים,1298,588,710,114,1184,730,1259,33,6%
2016-09,חיפה,8200,קריית מוצקין,913,371,542,156,757,403,881,18,4%
2016-09,חיפה,922,רכסים,162,65,97,14,148,68,145,1,4%
2016-09,ירושלים,472,אבו גוש,229,109,120,7,222,177,224,2,7%
2016-09,ירושלים,2610,בית שמש,1408,504,904,122,1286,437,1363,44,4%
2016-09,ירושלים,3000,ירושלים,12001,5153,6848,1362,10639,7131,11672,152,4%
2016-09,ירושלים,1015,מבשרת ציון,336,164,172,74,262,118,332,5,3%
2016-09,ירושלים,1137,קריית יערים,44,17,27,12,32,10,44,0,3%
2016-09,תל אביב,2400,אור יהודה,670,310,360,62,608,159,641,25,3%
2016-09,תל אביב,565,אזור,170,81,89,27,143,25,169,9,3%
2016-09,תל אביב,6100,בני ברק,2014,877,1137,90,1924,748,1895,21,3%
2016-09,תל אביב,6200,בת ים,2631,1188,1443,366,2265,924,2491,84,4%
2016-09,תל אביב,6300,גבעתיים,707,289,418,328,379,76,704,2,2%
2016-09,תל אביב,6400,הרצלייה,1038,452,586,381,657,29,1027,26,2%
2016-09,תל אביב,6600,חולון,2911,1257,1654,459,2452,638,2845,59,3%
2016-09,תל אביב,2620,קריית אונו,386,146,240,178,208,33,384,0,2%
2016-09,תל אביב,8600,רמת גן,1924,835,1089,642,1282,326,1884,22,2%
2016-09,תל אביב,2650,רמת השרון,372,144,228,149,223,10,369,2,2%
2016-09,תל אביב,5000,תל אביב -יפו,6927,3311,3616,2483,4444,1690,6781,91,3%
2016-10,אזור יהודה והשומרון,3760,אורנית,75,41,34,27,48,3,75,0,2%
2016-10,אזור יהודה והשומרון,3750,אלפי מנשה,85,30,55,28,57,1,85,2,2%
2016-10,אזור יהודה והשומרון,3560,אלקנה,29,15,14,20,9,0,29,0,2%
2016-10,אזור יהודה והשומרון,3650,אפרת,102,50,52,52,50,6,100,0,2%
2016-10,אזור יהודה והשומרון,3570,אריאל,270,126,144,77,193,33,268,6,3%
2016-10,אזור יהודה והשומרון,3574,בית אל,46,18,28,22,24,13,46,0,2%
2016-10,אזור יהודה והשומרון,3652,בית אריה,37,16,21,5,32,1,37,0,1%
2016-10,אזור יהודה והשומרון,3780,ביתר עילית,452,214,238,10,442,182,448,3,4%
2016-10,אזור יהודה והשומרון,3730,גבעת זאב,165,76,89,33,132,37,163,0,2%
2016-10,אזור יהודה והשומרון,3769,הר אדר,27,15,12,12,15,3,27,0,1%
2016-10,אזור יהודה והשומרון,3797,מודיעין עילית,408,105,303,20,388,23,408,2,3%
2016-10,אזור יהודה והשומרון,3616,מעלה אדומים,543,223,320,91,452,172,537,10,3%
2016-10,אזור יהודה והשומרון,3660,עמנואל,44,23,21,1,43,28,44,0,4%
2016-10,אזור יהודה והשומרון,3557,קדומים,36,22,14,10,26,4,35,0,2%
2016-10,אזור יהודה והשומרון,3611,קריית ארבע,82,42,40,14,68,41,81,2,3%
2016-10,אזור יהודה והשומרון,3640,קרני שומרון,69,34,35,17,52,5,69,0,2%
2016-10,הדרום,31,אופקים,865,359,506,54,811,478,839,23,7%
2016-10,הדרום,2600,אילת,913,465,448,56,857,351,850,24,3%
2016-10,הדרום,70,אשדוד,4920,1990,2930,626,4294,2274,4704,79,4%
2016-10,הדרום,7100,אשקלון,3404,1385,2019,412,2992,1634,2982,30,4%
2016-10,הדרום,9000,באר שבע,5148,2267,2881,666,4482,2875,4891,64,5%
2016-10,הדרום,2200,דימונה,1604,709,895,88,1516,1100,1530,12,9%
2016-10,הדרום,1303,חורה,514,201,313,0,514,466,501,1,13%
2016-10,הדרום,831,ירוחם,382,181,201,20,362,213,363,6,8%
2016-10,הדרום,1059,כסיפה,947,349,598,3,944,846,937,3,20%
2016-10,הדרום,1271,להבים,53,20,33,26,27,3,53,0,2%
2016-10,הדרום,1060,לקיה,615,275,340,0,615,539,602,4,16%
2016-10,הדרום,1268,מיתר,78,29,49,34,44,4,77,0,2%
2016-10,הדרום,99,מצפה רמון,230,88,142,19,211,154,221,3,9%
2016-10,הדרום,246,נתיבות,858,360,498,45,813,399,814,22,6%
2016-10,הדרום,666,עומר,44,15,29,15,29,1,44,0,1%
2016-10,הדרום,2560,ערד,628,292,336,71,557,333,595,22,5%
2016-10,הדרום,1192,ערערה-בנגב,1032,428,604,4,1028,936,1011,14,24%
2016-10,הדרום,2630,קריית גת,1498,608,890,86,1412,731,1439,16,5%
2016-10,הדרום,1034,קריית מלאכי,675,297,378,18,657,317,649,25,6%
2016-10,הדרום,1161,רהט,2355,937,1418,15,2340,1935,2322,33,13%
2016-10,הדרום,1286,שגב-שלום,339,117,222,1,338,288,330,4,13%
2016-10,הדרום,1031,שדרות,889,384,505,63,826,511,817,14,7%
2016-10,הדרום,1054,תל שבע,704,299,405,1,703,651,686,6,15%
2016-10,המרכז,182,אבן יהודה,151,74,77,56,95,17,151,1,2%
2016-10,המרכז,41,אליכין,58,32,26,10,48,18,57,0,3%
2016-10,המרכז,1309,אלעד,348,135,213,22,326,33,340,1,3%
2016-10,המרכז,2530,באר יעקב,226,84,142,70,156,41,223,1,2%
2016-10,המרכז,466,בית דגן,107,56,51,14,93,32,106,0,3%
2016-10,המרכז,1066,"בני עי""ש",129,55,74,21,108,42,125,3,3%
2016-10,המרכז,681,גבעת שמואל,211,108,103,68,143,43,205,1,2%
2016-10,המרכז,2550,גדרה,282,108,174,57,225,67,278,4,2%
2016-10,המרכז,627,ג'לג'וליה,77,29,48,0,77,50,76,0,2%
2016-10,המרכז,166,גן יבנה,266,104,162,49,217,52,264,2,2%
2016-10,המרכז,229,גני תקווה,176,78,98,77,99,23,176,0,2%
2016-10,המרכז,9700,הוד השרון,574,242,332,239,335,36,573,4,2%
2016-10,המרכז,1290,זמר,122,43,79,3,119,79,121,3,4%
2016-10,המרכז,2730,טייבה,1118,501,617,28,1090,839,959,19,6%
2016-10,המרכז,2720,טירה,177,83,94,5,172,69,171,9,2%
2016-10,המרכז,2660,יבנה,667,290,377,132,535,196,658,3,3%
2016-10,המרכז,9400,יהוד,328,144,184,79,249,47,321,0,2%
2016-10,המרכז,1224,כוכב יאיר,76,41,35,43,33,0,76,0,1%
2016-10,המרכז,633,כפר ברא,19,8,11,2,17,13,17,0,1%
2016-10,המרכז,168,כפר יונה,275,126,149,49,226,40,274,1,3%
2016-10,המרכז,6900,כפר סבא,1007,448,559,397,610,91,988,15,2%
2016-10,המרכז,634,כפר קאסם,205,96,109,12,193,111,200,5,2%
2016-10,המרכז,7000,לוד,1577,728,849,114,1463,872,1534,14,4%
2016-10,המרכז,1200,מודיעין-מכבים-רעות*,759,346,413,317,442,44,754,6,2%
2016-10,המרכז,28,מזכרת בתיה,137,60,77,59,78,23,134,0,2%
2016-10,המרכז,7200,נס ציונה,569,252,317,152,417,146,561,2,2%
2016-10,המרכז,7400,נתניה,3600,1657,1943,467,3133,1183,3524,46,3%
2016-10,המרכז,587,סביון*,14,3,11,7,7,0,14,0,1%
2016-10,המרכז,171,פרדסייה,79,33,46,20,59,6,79,0,2%
2016-10,המרכז,7900,פתח תקווה,3310,1476,1834,790,2520,825,3253,15,3%
2016-10,המרכז,195,קדימה-צורן,250,105,145,81,169,37,249,0,2%
2016-10,המרכז,638,קלנסווה,396,200,196,8,388,293,364,6,4%
2016-10,המרכז,469,קריית עקרון,228,104,124,29,199,93,223,1,4%
2016-10,המרכז,2640,ראש העין,604,292,312,98,506,124,596,12,3%
2016-10,המרכז,8300,ראשון לציון,3684,1566,2118,769,2915,1037,3652,27,3%
2016-10,המרכז,8400,רחובות,2036,908,1128,503,1533,653,1985,23,3%
2016-10,המרכז,8500,רמלה,1372,653,719,111,1261,585,1315,22,4%
2016-10,המרכז,8700,רעננה,602,285,317,267,335,44,594,2,2%
2016-10,המרכז,1304,שוהם,157,58,99,60,97,8,156,0,1%
2016-10,המרכז,154,תל מונד,119,51,68,35,84,14,119,0,2%
2016-10,הצפון,473,אבו סנאן,564,234,330,3,561,459,553,1,10%
2016-10,הצפון,478,אכסאל,464,210,254,8,456,393,458,2,8%
2016-10,הצפון,529,אעבלין,422,172,250,6,416,350,419,7,8%
2016-10,הצפון,482,בועיינה-נוג'ידאת,252,118,134,5,247,199,249,0,7%
2016-10,הצפון,4001,בוקעאתא,369,144,225,3,366,297,354,1,13%
2016-10,הצפון,998,ביר אל-מכסור,321,133,188,3,318,255,320,2,9%
2016-10,הצפון,480,בית ג'ן,349,93,256,9,340,241,338,1,6%
2016-10,הצפון,9200,בית שאן,703,299,404,24,679,329,682,33,7%
2016-10,הצפון,944,בסמת טבעון,145,67,78,2,143,112,139,3,4%
2016-10,הצפון,483,בענה,303,131,172,7,296,252,296,0,9%
2016-10,הצפון,1292,ג'דיידה-מכר,1064,455,609,3,1061,887,1048,4,12%
2016-10,הצפון,485,ג'ולס,197,59,138,1,196,123,196,3,7%
2016-10,הצפון,487,ג'ש (גוש חלב),57,19,38,6,51,28,57,1,4%
2016-10,הצפון,489,דבורייה,296,117,179,16,280,214,292,0,7%
2016-10,הצפון,490,דייר אל-אסד,311,141,170,12,299,260,299,1,6%
2016-10,הצפון,492,דייר חנא,589,247,342,6,583,473,579,3,12%
2016-10,הצפון,975,זרזיר,216,93,123,5,211,144,210,4,7%
2016-10,הצפון,496,חורפיש,101,40,61,7,94,57,97,2,4%
2016-10,הצפון,2034,חצור הגלילית,231,86,145,20,211,116,222,1,5%
2016-10,הצפון,6700,טבריה,1323,587,736,62,1261,692,1150,35,5%
2016-10,הצפון,962,טובא-זנגרייה,287,138,149,5,282,216,276,1,9%
2016-10,הצפון,498,טורעאן,381,158,223,11,370,324,373,3,7%
2016-10,הצפון,8900,טמרה,1293,566,727,19,1274,1122,1276,6,10%
2016-10,הצפון,1295,יאנוח-ג'ת,113,31,82,6,107,78,109,1,4%
2016-10,הצפון,46,יבנאל,87,45,42,4,83,60,64,0,4%
2016-10,הצפון,499,יפיע,512,201,311,16,496,394,506,0,7%
2016-10,הצפון,240,יקנעם עילית,376,145,231,74,302,100,372,13,3%
2016-10,הצפון,502,ירכא,453,187,266,0,453,349,448,2,8%
2016-10,הצפון,504,כאבול,463,207,256,6,457,399,457,0,10%
2016-10,הצפון,505,כאוכב אבו אל-היג'א,201,82,119,1,200,169,197,1,12%
2016-10,הצפון,1296,כסרא-סמיע,164,67,97,3,161,107,155,1,5%
2016-10,הצפון,978,כעביה-טבאש-חג'אג'רה,143,57,86,3,140,106,140,1,6%
2016-10,הצפון,1263,כפר ורדים,59,28,31,27,32,6,59,0,2%
2016-10,הצפון,507,כפר יאסיף,406,168,238,4,402,288,399,0,8%
2016-10,הצפון,508,כפר כמא,50,21,29,3,47,24,50,1,3%
2016-10,הצפון,509,כפר כנא,783,351,432,20,763,651,758,6,9%
2016-10,הצפון,510,כפר מנדא,667,317,350,9,658,547,654,2,9%
2016-10,הצפון,47,כפר תבור,35,14,21,16,19,1,34,0,2%
2016-10,הצפון,1139,כרמיאל,1356,540,816,255,1101,656,1270,21,5%
2016-10,הצפון,481,מגאר,1210,494,716,16,1194,1011,1171,8,13%
2016-10,הצפון,516,מג'ד אל-כרום,455,189,266,7,448,324,437,0,7%
2016-10,הצפון,874,מגדל העמק,682,295,387,70,612,287,638,18,5%
2016-10,הצפון,4201,מג'דל שמס,392,150,242,11,381,308,378,2,8%
2016-10,הצפון,517,מזרעה,145,55,90,1,144,110,139,3,7%
2016-10,הצפון,4203,מסעדה,184,61,123,4,180,144,174,2,11%
2016-10,הצפון,518,מעיליא,52,23,29,3,49,20,51,0,3%
2016-10,הצפון,1063,מעלות-תרשיחא,689,336,353,82,607,368,660,17,6%
2016-10,הצפון,520,משהד,209,88,121,4,205,164,200,1,6%
2016-10,הצפון,9100,נהרייה,1586,727,859,152,1434,874,1515,38,5%
2016-10,הצפון,522,נחף,343,152,191,11,332,283,331,1,7%
2016-10,הצפון,7300,נצרת,2654,1116,1538,120,2534,2059,2626,6,8%
2016-10,הצפון,1061,נצרת עילית,1307,569,738,143,1164,674,1160,42,5%
2016-10,הצפון,525,סאג'ור,102,33,69,5,97,75,98,1,6%
2016-10,הצפון,7500,סח'נין,1919,817,1102,30,1889,1632,1885,10,14%
2016-10,הצפון,4501,ע'ג'ר,83,29,54,0,83,62,81,1,8%
2016-10,הצפון,530,עיילבון,159,69,90,12,147,106,156,0,6%
2016-10,הצפון,511,עילוט,270,103,167,3,267,217,265,5,10%
2016-10,הצפון,532,עין מאהל,359,169,190,9,350,289,348,1,7%
2016-10,הצפון,7600,עכו,2616,1186,1430,118,2498,1941,2540,16,10%
2016-10,הצפון,7700,עפולה,1334,541,793,168,1166,571,1262,39,5%
2016-10,הצפון,531,עראבה,1392,591,801,17,1375,1241,1368,7,14%
2016-10,הצפון,535,פסוטה,79,34,45,7,72,45,75,0,5%
2016-10,הצפון,536,פקיעין (בוקייעה),127,63,64,1,126,79,120,1,4%
2016-10,הצפון,8000,צפת,1014,511,503,94,920,690,947,17,7%
2016-10,הצפון,4100,קצרין,170,66,104,27,143,81,168,0,4%
2016-10,הצפון,2800,קריית שמונה,644,284,360,63,581,264,621,10,5%
2016-10,הצפון,543,ראמה,253,110,143,18,235,174,242,1,6%
2016-10,הצפון,26,ראש פינה,44,13,31,9,35,16,43,0,3%
2016-10,הצפון,542,ריינה,480,212,268,9,471,372,463,6,7%
2016-10,הצפון,122,רמת ישי,87,36,51,31,56,13,86,1,2%
2016-10,הצפון,913,שבלי - אום אל-גנם,188,71,117,6,182,127,186,1,7%
2016-10,הצפון,812,שלומי,196,78,118,15,181,98,187,2,5%
2016-10,הצפון,538,שעב,478,186,292,4,474,427,472,1,16%
2016-10,הצפון,8800,שפרעם,1389,563,826,36,1353,1128,1368,15,8%
2016-10,חיפה,2710,אום אל-פחם,2736,1106,1630,29,2707,2332,2691,11,13%
2016-10,חיפה,1020,אור עקיבא,406,175,231,39,367,114,389,9,4%
2016-10,חיפה,6000,באקה אל-גרביה,514,229,285,10,504,351,511,9,4%
2016-10,חיפה,9800,בנימינה-גבעת עדה*,154,62,92,50,104,40,154,1,2%
2016-10,חיפה,1326,"בסמ""ה",345,154,191,7,338,270,338,2,9%
2016-10,חיפה,541,ג'סר א-זרקא,278,148,130,2,276,179,277,4,5%
2016-10,חיפה,628,ג'ת,177,85,92,5,172,101,177,2,3%
2016-10,חיפה,494,דאלית אל-כרמל,415,160,255,15,400,238,390,2,5%
2016-10,חיפה,9300,זכרון יעקב,253,116,137,95,158,37,249,2,2%
2016-10,חיפה,6500,חדרה,1973,805,1168,227,1746,737,1847,23,4%
2016-10,חיפה,4000,חיפה,5066,2436,2630,1030,4036,2566,4788,64,3%
2016-10,חיפה,1247,חריש,68,26,42,14,54,14,64,0,4%
2016-10,חיפה,2100,טירת כרמל,572,288,284,30,542,293,561,9,5%
2016-10,חיפה,654,כפר קרע,359,162,197,10,349,225,354,4,4%
2016-10,חיפה,1327,מעלה עירון,671,257,414,7,664,551,660,2,12%
2016-10,חיפה,2500,נשר,385,175,210,85,300,129,374,1,3%
2016-10,חיפה,534,עספיא,277,121,156,17,260,147,250,1,5%
2016-10,חיפה,637,ערערה,484,209,275,9,475,324,477,9,6%
2016-10,חיפה,537,פוריידיס,267,136,131,6,261,162,265,3,5%
2016-10,חיפה,7800,פרדס חנה-כרכור,685,294,391,152,533,162,671,18,3%
2016-10,חיפה,6800,קריית אתא,1308,604,704,112,1196,686,1281,13,4%
2016-10,חיפה,9500,קריית ביאליק,884,355,529,113,771,395,859,10,4%
2016-10,חיפה,2300,קריית טבעון,162,75,87,70,92,29,161,0,2%
2016-10,חיפה,9600,קריית ים,1191,533,658,110,1081,687,1150,17,5%
2016-10,חיפה,8200,קריית מוצקין,810,326,484,152,658,362,780,14,3%
2016-10,חיפה,922,רכסים,133,57,76,11,122,61,124,1,4%
2016-10,ירושלים,472,אבו גוש,221,112,109,9,212,169,218,3,7%
2016-10,ירושלים,2610,בית שמש,1116,429,687,111,1005,385,1088,12,3%
2016-10,ירושלים,3000,ירושלים,10855,4781,6074,1225,9630,6799,10586,56,4%
2016-10,ירושלים,1015,מבשרת ציון,288,143,145,60,228,109,281,2,2%
2016-10,ירושלים,1137,קריית יערים,40,19,21,8,32,14,40,0,3%
2016-10,תל אביב,2400,אור יהודה,560,264,296,58,502,152,541,5,3%
2016-10,תל אביב,565,אזור,146,72,74,27,119,25,145,2,2%
2016-10,תל אביב,6100,בני ברק,1679,787,892,87,1592,709,1568,10,3%
2016-10,תל אביב,6200,בת ים,2389,1102,1287,318,2071,873,2270,24,3%
2016-10,תל אביב,6300,גבעתיים,655,291,364,307,348,73,651,0,2%
2016-10,תל אביב,6400,הרצלייה,933,403,530,359,574,22,930,4,2%
2016-10,תל אביב,6600,חולון,2622,1177,1445,419,2203,585,2579,33,3%
2016-10,תל אביב,2620,קריית אונו,360,138,222,157,203,35,357,1,2%
2016-10,תל אביב,8600,רמת גן,1749,789,960,609,1140,285,1718,10,2%
2016-10,תל אביב,2650,רמת השרון,318,126,192,133,185,9,317,1,1%
2016-10,תל אביב,5000,תל אביב -יפו,6372,3087,3285,2303,4069,1561,6265,39,3%
2016-11,אזור יהודה והשומרון,3760,אורנית,96,51,45,30,66,5,96,1,2%
2016-11,אזור יהודה והשומרון,3750,אלפי מנשה,106,40,66,31,75,0,105,2,2%
2016-11,אזור יהודה והשומרון,3560,אלקנה,33,17,16,22,11,1,33,0,2%
2016-11,אזור יהודה והשומרון,3650,אפרת,122,68,54,56,66,6,122,3,3%
2016-11,אזור יהודה והשומרון,3570,אריאל,313,145,168,80,233,32,310,14,3%
2016-11,אזור יהודה והשומרון,3574,בית אל,55,22,33,28,27,13,55,0,2%
2016-11,אזור יהודה והשומרון,3652,בית אריה,45,23,22,6,39,0,45,1,2%
2016-11,אזור יהודה והשומרון,3780,ביתר עילית,496,238,258,7,489,186,493,3,4%
2016-11,אזור יהודה והשומרון,3730,גבעת זאב,197,83,114,47,150,36,195,2,3%
2016-11,אזור יהודה והשומרון,3769,הר אדר,28,15,13,12,16,3,28,1,1%
2016-11,אזור יהודה והשומרון,3797,מודיעין עילית,431,124,307,23,408,32,426,5,3%
2016-11,אזור יהודה והשומרון,3616,מעלה אדומים,617,255,362,101,516,171,606,11,3%
2016-11,אזור יהודה והשומרון,3660,עמנואל,47,26,21,3,44,29,47,2,4%
2016-11,אזור יהודה והשומרון,3557,קדומים,36,20,16,10,26,3,35,0,2%
2016-11,אזור יהודה והשומרון,3611,קריית ארבע,91,49,42,14,77,46,90,3,3%
2016-11,אזור יהודה והשומרון,3640,קרני שומרון,78,36,42,17,61,6,76,2,2%
2016-11,הדרום,31,אופקים,893,381,512,49,844,483,858,44,7%
2016-11,הדרום,2600,אילת,1020,516,504,61,959,380,955,57,3%
2016-11,הדרום,70,אשדוד,5312,2145,3167,658,4654,2365,5073,146,5%
2016-11,הדרום,7100,אשקלון,3612,1508,2104,417,3195,1728,3168,71,5%
2016-11,הדרום,9000,באר שבע,5645,2547,3098,757,4888,3004,5348,134,5%
2016-11,הדרום,2200,דימונה,1759,779,980,97,1662,1144,1672,58,9%
2016-11,הדרום,1303,חורה,565,226,339,1,564,502,553,11,15%
2016-11,הדרום,831,ירוחם,405,194,211,20,385,222,383,30,8%
2016-11,הדרום,1059,כסיפה,992,380,612,2,990,873,983,15,21%
2016-11,הדרום,1271,להבים,57,18,39,29,28,4,57,0,2%
2016-11,הדרום,1060,לקיה,686,302,384,5,681,587,669,13,17%
2016-11,הדרום,1268,מיתר,87,33,54,39,48,4,87,0,2%
2016-11,הדרום,99,מצפה רמון,242,96,146,15,227,159,231,8,9%
2016-11,הדרום,246,נתיבות,890,391,499,47,843,416,841,51,6%
2016-11,הדרום,666,עומר,60,23,37,21,39,4,58,0,1%
2016-11,הדרום,2560,ערד,678,321,357,64,614,352,642,45,5%
2016-11,הדרום,1192,ערערה-בנגב,1068,454,614,5,1063,944,1051,13,25%
2016-11,הדרום,2630,קריית גת,1643,663,980,95,1548,760,1564,53,6%
2016-11,הדרום,1034,קריית מלאכי,774,342,432,23,751,340,742,66,7%
2016-11,הדרום,1161,רהט,2533,1052,1481,13,2520,1969,2493,69,14%
2016-11,הדרום,1286,שגב-שלום,362,133,229,2,360,302,350,5,14%
2016-11,הדרום,1031,שדרות,934,417,517,65,869,513,859,34,7%
2016-11,הדרום,1054,תל שבע,780,337,443,1,779,699,754,9,17%
2016-11,המרכז,182,אבן יהודה,159,83,76,50,109,18,158,2,2%
2016-11,המרכז,41,אליכין,64,35,29,11,53,18,62,1,3%
2016-11,המרכז,1309,אלעד,358,138,220,26,332,41,345,6,3%
2016-11,המרכז,2530,באר יעקב,248,97,151,72,176,42,247,9,3%
2016-11,המרכז,466,בית דגן,115,62,53,14,101,30,113,1,3%
2016-11,המרכז,1066,"בני עי""ש",133,62,71,19,114,42,129,7,3%
2016-11,המרכז,681,גבעת שמואל,243,121,122,76,167,43,237,2,2%
2016-11,המרכז,2550,גדרה,317,124,193,68,249,77,304,14,3%
2016-11,המרכז,627,ג'לג'וליה,96,37,59,2,94,58,88,2,2%
2016-11,המרכז,166,גן יבנה,305,123,182,49,256,58,301,5,3%
2016-11,המרכז,229,גני תקווה,188,79,109,80,108,22,188,4,2%
2016-11,המרכז,9700,הוד השרון,625,277,348,262,363,36,621,4,2%
2016-11,המרכז,1290,זמר,144,53,91,3,141,92,141,6,5%
2016-11,המרכז,2730,טייבה,1177,540,637,29,1148,856,1009,31,6%
2016-11,המרכז,2720,טירה,196,97,99,11,185,66,189,18,2%
2016-11,המרכז,2660,יבנה,731,329,402,139,592,199,722,20,3%
2016-11,המרכז,9400,יהוד,361,161,200,91,270,48,356,7,2%
2016-11,המרכז,1224,כוכב יאיר,87,46,41,52,35,1,86,2,2%
2016-11,המרכז,633,כפר ברא,18,8,10,2,16,11,18,0,1%
2016-11,המרכז,168,כפר יונה,302,136,166,49,253,43,299,0,3%
2016-11,המרכז,6900,כפר סבא,1114,500,614,423,691,93,1092,33,2%
2016-11,המרכז,634,כפר קאסם,223,100,123,13,210,122,216,4,2%
2016-11,המרכז,7000,לוד,1745,798,947,118,1627,916,1705,40,5%
2016-11,המרכז,1200,מודיעין-מכבים-רעות*,846,391,455,330,516,55,833,4,2%
2016-11,המרכז,28,מזכרת בתיה,155,60,95,61,94,22,150,4,2%
2016-11,המרכז,7200,נס ציונה,603,276,327,157,446,154,590,10,3%
2016-11,המרכז,7400,נתניה,3904,1829,2075,478,3426,1276,3812,66,4%
2016-11,המרכז,587,סביון*,16,5,11,6,10,1,16,0,1%
2016-11,המרכז,171,פרדסייה,75,30,45,22,53,6,75,0,2%
2016-11,המרכז,7900,פתח תקווה,3633,1603,2030,852,2781,858,3557,40,3%
2016-11,המרכז,195,קדימה-צורן,271,118,153,85,186,40,269,3,3%
2016-11,המרכז,638,קלנסווה,411,207,204,9,402,295,374,11,4%
2016-11,המרכז,469,קריית עקרון,235,109,126,31,204,92,230,5,4%
2016-11,המרכז,2640,ראש העין,703,354,349,121,582,135,690,19,3%
2016-11,המרכז,8300,ראשון לציון,4050,1736,2314,824,3226,1094,4004,80,3%
2016-11,המרכז,8400,רחובות,2226,1003,1223,546,1680,679,2159,51,3%
2016-11,המרכז,8500,רמלה,1527,732,795,123,1404,634,1452,72,4%
2016-11,המרכז,8700,רעננה,652,299,353,290,362,45,645,8,2%
2016-11,המרכז,1304,שוהם,184,64,120,72,112,7,183,1,2%
2016-11,המרכז,154,תל מונד,142,71,71,40,102,18,142,1,2%
2016-11,הצפון,473,אבו סנאן,585,245,340,2,583,465,572,8,10%
2016-11,הצפון,478,אכסאל,474,206,268,7,467,403,469,5,8%
2016-11,הצפון,529,אעבלין,456,186,270,7,449,360,448,9,8%
2016-11,הצפון,482,בועיינה-נוג'ידאת,279,135,144,7,272,218,272,7,7%
2016-11,הצפון,4001,בוקעאתא,390,152,238,4,386,303,376,4,14%
2016-11,הצפון,998,ביר אל-מכסור,344,144,200,5,339,269,340,2,9%
2016-11,הצפון,480,בית ג'ן,366,99,267,7,359,252,355,3,7%
2016-11,הצפון,9200,בית שאן,757,340,417,29,728,348,736,55,7%
2016-11,הצפון,944,בסמת טבעון,159,77,82,2,157,120,154,1,5%
2016-11,הצפון,483,בענה,330,140,190,9,321,272,314,4,10%
2016-11,הצפון,1292,ג'דיידה-מכר,1102,480,622,2,1100,905,1082,23,12%
2016-11,הצפון,485,ג'ולס,206,60,146,2,204,121,206,3,7%
2016-11,הצפון,487,ג'ש (גוש חלב),56,24,32,6,50,24,56,1,3%
2016-11,הצפון,489,דבורייה,303,122,181,17,286,217,298,4,7%
2016-11,הצפון,490,דייר אל-אסד,329,150,179,10,319,270,319,4,6%
2016-11,הצפון,492,דייר חנא,605,249,356,5,600,476,594,5,12%
2016-11,הצפון,975,זרזיר,233,98,135,4,229,147,228,6,8%
2016-11,הצפון,496,חורפיש,110,41,69,7,103,61,104,3,4%
2016-11,הצפון,2034,חצור הגלילית,275,106,169,21,254,127,259,3,6%
2016-11,הצפון,6700,טבריה,1472,701,771,72,1400,719,1283,63,6%
2016-11,הצפון,962,טובא-זנגרייה,305,136,169,7,298,229,294,2,10%
2016-11,הצפון,498,טורעאן,401,167,234,11,390,336,389,6,7%
2016-11,הצפון,8900,טמרה,1350,600,750,16,1334,1165,1331,9,10%
2016-11,הצפון,1295,יאנוח-ג'ת,131,42,89,5,126,87,123,0,4%
2016-11,הצפון,46,יבנאל,96,47,49,5,91,59,71,2,5%
2016-11,הצפון,499,יפיע,542,216,326,16,526,420,536,2,7%
2016-11,הצפון,240,יקנעם עילית,405,167,238,69,336,100,398,24,3%
2016-11,הצפון,502,ירכא,439,175,264,0,439,333,434,8,8%
2016-11,הצפון,504,כאבול,471,218,253,5,466,403,459,5,10%
2016-11,הצפון,505,כאוכב אבו אל-היג'א,204,85,119,2,202,171,199,3,12%
2016-11,הצפון,1296,כסרא-סמיע,190,73,117,3,187,123,175,8,5%
2016-11,הצפון,978,כעביה-טבאש-חג'אג'רה,146,60,86,2,144,105,142,5,6%
2016-11,הצפון,1263,כפר ורדים,63,30,33,26,37,6,63,1,2%
2016-11,הצפון,507,כפר יאסיף,420,169,251,9,411,291,410,7,8%
2016-11,הצפון,508,כפר כמא,57,24,33,4,53,24,57,1,4%
2016-11,הצפון,509,כפר כנא,814,363,451,26,788,674,783,17,9%
2016-11,הצפון,510,כפר מנדא,691,328,363,9,682,550,679,6,10%
2016-11,הצפון,47,כפר תבור,38,14,24,17,21,1,38,0,2%
2016-11,הצפון,1139,כרמיאל,1451,575,876,269,1182,682,1356,38,5%
2016-11,הצפון,481,מגאר,1280,540,740,16,1264,1050,1242,20,14%
2016-11,הצפון,516,מג'ד אל-כרום,488,208,280,9,479,343,472,6,7%
2016-11,הצפון,874,מגדל העמק,821,365,456,80,741,292,758,75,6%
2016-11,הצפון,4201,מג'דל שמס,414,164,250,9,405,306,403,8,9%
2016-11,הצפון,517,מזרעה,155,66,89,1,154,113,146,6,8%
2016-11,הצפון,4203,מסעדה,193,67,126,2,191,149,182,3,11%
2016-11,הצפון,518,מעיליא,59,29,30,4,55,19,59,1,4%
2016-11,הצפון,1063,מעלות-תרשיחא,768,379,389,90,678,394,738,35,6%
2016-11,הצפון,520,משהד,225,97,128,5,220,177,213,5,7%
2016-11,הצפון,9100,נהרייה,1798,842,956,168,1630,947,1709,68,6%
2016-11,הצפון,522,נחף,356,155,201,11,345,292,344,5,7%
2016-11,הצפון,7300,נצרת,2775,1189,1586,140,2635,2101,2743,16,8%
2016-11,הצפון,1061,נצרת עילית,1464,640,824,145,1319,707,1300,104,6%
2016-11,הצפון,525,סאג'ור,104,38,66,5,99,71,104,1,6%
2016-11,הצפון,7500,סח'נין,1992,875,1117,32,1960,1664,1957,31,14%
2016-11,הצפון,4501,ע'ג'ר,95,30,65,0,95,63,92,1,9%
2016-11,הצפון,530,עיילבון,173,80,93,10,163,107,169,3,6%
2016-11,הצפון,511,עילוט,280,112,168,6,274,224,277,2,10%
2016-11,הצפון,532,עין מאהל,389,189,200,10,379,316,373,4,7%
2016-11,הצפון,7600,עכו,2775,1262,1513,130,2645,2024,2688,49,10%
2016-11,הצפון,7700,עפולה,1530,622,908,180,1350,602,1432,73,6%
2016-11,הצפון,531,עראבה,1436,607,829,20,1416,1266,1409,20,14%
2016-11,הצפון,535,פסוטה,83,38,45,7,76,47,80,2,5%
2016-11,הצפון,536,פקיעין (בוקייעה),131,70,61,4,127,77,125,4,5%
2016-11,הצפון,8000,צפת,1115,585,530,98,1017,717,1054,30,8%
2016-11,הצפון,4100,קצרין,185,72,113,28,157,90,178,2,5%
2016-11,הצפון,2800,קריית שמונה,722,342,380,58,664,268,696,35,5%
2016-11,הצפון,543,ראמה,266,107,159,22,244,183,257,1,7%
2016-11,הצפון,26,ראש פינה,44,13,31,9,35,17,44,2,3%
2016-11,הצפון,542,ריינה,503,222,281,13,490,380,486,6,7%
2016-11,הצפון,122,רמת ישי,92,36,56,36,56,12,90,2,2%
2016-11,הצפון,913,שבלי - אום אל-גנם,189,74,115,4,185,125,188,3,7%
2016-11,הצפון,812,שלומי,202,82,120,17,185,99,193,6,5%
2016-11,הצפון,538,שעב,480,189,291,3,477,425,475,5,16%
2016-11,הצפון,8800,שפרעם,1508,597,911,43,1465,1208,1468,33,9%
2016-11,חיפה,2710,אום אל-פחם,2833,1153,1680,30,2803,2363,2786,31,14%
2016-11,חיפה,1020,אור עקיבא,459,194,265,47,412,123,446,17,5%
2016-11,חיפה,6000,באקה אל-גרביה,570,262,308,13,557,359,566,19,5%
2016-11,חיפה,9800,בנימינה-גבעת עדה*,176,75,101,55,121,41,176,2,3%
2016-11,חיפה,1326,"בסמ""ה",353,160,193,6,347,275,347,3,9%
2016-11,חיפה,541,ג'סר א-זרקא,293,151,142,2,291,185,293,16,5%
2016-11,חיפה,628,ג'ת,189,91,98,6,183,108,186,6,4%
2016-11,חיפה,494,דאלית אל-כרמל,443,180,263,14,429,248,411,8,5%
2016-11,חיפה,9300,זכרון יעקב,262,112,150,88,174,41,258,3,2%
2016-11,חיפה,6500,חדרה,2131,878,1253,242,1889,766,1992,45,4%
2016-11,חיפה,4000,חיפה,5519,2651,2868,1141,4378,2729,5192,158,4%
2016-11,חיפה,1247,חריש,66,24,42,16,50,14,62,0,4%
2016-11,חיפה,2100,טירת כרמל,653,328,325,29,624,323,637,21,6%
2016-11,חיפה,654,כפר קרע,389,176,213,9,380,240,383,3,5%
2016-11,חיפה,1327,מעלה עירון,694,257,437,6,688,565,686,10,12%
2016-11,חיפה,2500,נשר,399,187,212,78,321,137,391,8,3%
2016-11,חיפה,534,עספיא,286,122,164,16,270,152,258,7,5%
2016-11,חיפה,637,ערערה,517,233,284,11,506,335,509,10,6%
2016-11,חיפה,537,פוריידיס,284,146,138,4,280,153,281,2,5%
2016-11,חיפה,7800,פרדס חנה-כרכור,734,312,422,164,570,170,716,22,4%
2016-11,חיפה,6800,קריית אתא,1463,670,793,129,1334,719,1419,44,5%
2016-11,חיפה,9500,קריית ביאליק,950,389,561,124,826,409,917,25,4%
2016-11,חיפה,2300,קריית טבעון,181,83,98,79,102,27,180,0,2%
2016-11,חיפה,9600,קריית ים,1263,579,684,110,1153,709,1216,39,6%
2016-11,חיפה,8200,קריית מוצקין,875,368,507,162,713,370,846,17,4%
2016-11,חיפה,922,רכסים,147,65,82,11,136,71,132,3,4%
2016-11,ירושלים,472,אבו גוש,230,119,111,8,222,179,226,1,7%
2016-11,ירושלים,2610,בית שמש,1207,481,726,106,1101,418,1160,25,4%
2016-11,ירושלים,3000,ירושלים,11654,5195,6459,1342,10312,7077,11352,156,4%
2016-11,ירושלים,1015,מבשרת ציון,318,161,157,68,250,116,308,6,2%
2016-11,ירושלים,1137,קריית יערים,46,20,26,10,36,15,46,0,3%
2016-11,תל אביב,2400,אור יהודה,669,313,356,62,607,167,636,37,3%
2016-11,תל אביב,565,אזור,163,84,79,31,132,25,162,4,3%
2016-11,תל אביב,6100,בני ברק,1752,822,930,88,1664,712,1640,28,3%
2016-11,תל אביב,6200,בת ים,2637,1230,1407,333,2304,923,2492,69,4%
2016-11,תל אביב,6300,גבעתיים,729,325,404,338,391,76,723,7,2%
2016-11,תל אביב,6400,הרצלייה,1072,475,597,401,671,33,1062,19,2%
2016-11,תל אביב,6600,חולון,2925,1328,1597,477,2448,641,2858,52,3%
2016-11,תל אביב,2620,קריית אונו,399,165,234,180,219,35,395,6,2%
2016-11,תל אביב,8600,רמת גן,1994,908,1086,679,1315,313,1957,22,3%
2016-11,תל אביב,2650,רמת השרון,375,143,232,158,217,9,373,4,2%
2016-11,תל אביב,5000,תל אביב -יפו,7254,3553,3701,2636,4618,1655,7127,78,3%
2016-12,אזור יהודה והשומרון,3760,אורנית,91,54,37,29,62,2,91,2,2%
2016-12,אזור יהודה והשומרון,3750,אלפי מנשה,102,36,66,38,64,1,102,0,2%
2016-12,אזור יהודה והשומרון,3560,אלקנה,34,20,14,20,14,0,34,0,2%
2016-12,אזור יהודה והשומרון,3650,אפרת,124,66,58,50,74,6,124,0,3%
2016-12,אזור יהודה והשומרון,3570,אריאל,314,157,157,73,241,28,312,14,3%
2016-12,אזור יהודה והשומרון,3574,בית אל,49,18,31,20,29,12,49,0,2%
2016-12,אזור יהודה והשומרון,3652,בית אריה,52,28,24,11,41,2,50,1,2%
2016-12,אזור יהודה והשומרון,3780,ביתר עילית,491,228,263,8,483,171,489,1,4%
2016-12,אזור יהודה והשומרון,3730,גבעת זאב,188,86,102,45,143,35,186,1,2%
2016-12,אזור יהודה והשומרון,3769,הר אדר,22,12,10,10,12,3,22,0,1%
2016-12,אזור יהודה והשומרון,3797,מודיעין עילית,405,124,281,22,383,30,402,7,3%
2016-12,אזור יהודה והשומרון,3616,מעלה אדומים,572,234,338,95,477,175,565,17,3%
2016-12,אזור יהודה והשומרון,3660,עמנואל,49,27,22,2,47,29,49,2,4%
2016-12,אזור יהודה והשומרון,3557,קדומים,28,18,10,7,21,3,27,1,1%
2016-12,אזור יהודה והשומרון,3611,קריית ארבע,76,44,32,13,63,36,74,2,2%
2016-12,אזור יהודה והשומרון,3640,קרני שומרון,77,37,40,20,57,6,75,2,2%
2016-12,הדרום,31,אופקים,788,347,441,37,751,466,770,40,6%
2016-12,הדרום,2600,אילת,1034,523,511,63,971,371,969,49,3%
2016-12,הדרום,70,אשדוד,5048,2086,2962,621,4427,2328,4828,134,5%
2016-12,הדרום,7100,אשקלון,3421,1461,1960,395,3026,1669,3001,55,4%
2016-12,הדרום,9000,באר שבע,5321,2428,2893,704,4617,2924,5026,90,5%
2016-12,הדרום,2200,דימונה,1676,759,917,95,1581,1114,1595,46,9%
2016-12,הדרום,1303,חורה,550,225,325,1,549,475,531,1,14%
2016-12,הדרום,831,ירוחם,377,187,190,21,356,214,358,24,8%
2016-12,הדרום,1059,כסיפה,969,378,591,2,967,863,954,3,21%
2016-12,הדרום,1271,להבים,57,17,40,29,28,3,57,1,2%
2016-12,הדרום,1060,לקיה,682,310,372,4,678,597,651,4,17%
2016-12,הדרום,1268,מיתר,81,31,50,36,45,4,80,0,2%
2016-12,הדרום,99,מצפה רמון,237,91,146,10,227,160,226,5,9%
2016-12,הדרום,246,נתיבות,850,388,462,44,806,393,803,49,6%
2016-12,הדרום,666,עומר,55,20,35,23,32,3,54,0,1%
2016-12,הדרום,2560,ערד,630,288,342,66,564,344,598,35,5%
2016-12,הדרום,1192,ערערה-בנגב,1091,468,623,5,1086,964,1068,0,25%
2016-12,הדרום,2630,קריית גת,1573,669,904,86,1487,736,1490,47,5%
2016-12,הדרום,1034,קריית מלאכי,699,315,384,21,678,313,670,53,6%
2016-12,הדרום,1161,רהט,2415,1021,1394,15,2400,1916,2382,57,13%
2016-12,הדרום,1286,שגב-שלום,349,128,221,2,347,301,340,3,14%
2016-12,הדרום,1031,שדרות,928,432,496,63,865,512,851,23,7%
2016-12,הדרום,1054,תל שבע,756,323,433,2,754,687,731,7,16%
2016-12,המרכז,182,אבן יהודה,140,65,75,44,96,14,140,0,2%
2016-12,המרכז,41,אליכין,57,33,24,10,47,17,55,0,3%
2016-12,המרכז,1309,אלעד,324,138,186,22,302,34,313,4,3%
2016-12,המרכז,2530,באר יעקב,230,95,135,64,166,38,229,5,3%
2016-12,המרכז,466,בית דגן,111,62,49,13,98,27,109,0,3%
2016-12,המרכז,1066,"בני עי""ש",132,63,69,14,118,48,125,4,3%
2016-12,המרכז,681,גבעת שמואל,241,127,114,73,168,43,235,3,2%
2016-12,המרכז,2550,גדרה,315,137,178,54,261,73,303,3,3%
2016-12,המרכז,627,ג'לג'וליה,87,37,50,2,85,53,85,2,2%
2016-12,המרכז,166,גן יבנה,287,119,168,46,241,60,284,4,3%
2016-12,המרכז,229,גני תקווה,193,88,105,77,116,24,193,5,2%
2016-12,המרכז,9700,הוד השרון,578,255,323,258,320,40,565,11,2%
2016-12,המרכז,1290,זמר,129,46,83,3,126,85,127,6,4%
2016-12,המרכז,2730,טייבה,1114,506,608,30,1084,816,972,27,6%
2016-12,המרכז,2720,טירה,185,94,91,12,173,64,184,16,2%
2016-12,המרכז,2660,יבנה,684,310,374,132,552,189,667,21,3%
2016-12,המרכז,9400,יהוד,337,155,182,85,252,48,330,3,2%
2016-12,המרכז,1224,כוכב יאיר,94,49,45,52,42,1,94,1,2%
2016-12,המרכז,633,כפר ברא,21,12,9,2,19,10,21,0,2%
2016-12,המרכז,168,כפר יונה,297,133,164,58,239,40,294,2,3%
2016-12,המרכז,6900,כפר סבא,1073,463,610,411,662,85,1055,25,2%
2016-12,המרכז,634,כפר קאסם,229,99,130,13,216,129,220,3,3%
2016-12,המרכז,7000,לוד,1650,777,873,112,1538,886,1616,44,5%
2016-12,המרכז,1200,מודיעין-מכבים-רעות*,778,355,423,320,458,57,769,20,2%
2016-12,המרכז,28,מזכרת בתיה,153,59,94,48,105,23,145,4,2%
2016-12,המרכז,7200,נס ציונה,597,276,321,152,445,157,586,6,3%
2016-12,המרכז,7400,נתניה,3758,1777,1981,473,3285,1277,3658,84,4%
2016-12,המרכז,587,סביון*,15,3,12,6,9,1,15,1,1%
2016-12,המרכז,171,פרדסייה,67,32,35,21,46,5,67,2,2%
2016-12,המרכז,7900,פתח תקווה,3542,1591,1951,823,2719,850,3455,49,3%
2016-12,המרכז,195,קדימה-צורן,247,109,138,68,179,39,242,1,2%
2016-12,המרכז,638,קלנסווה,398,202,196,11,387,287,360,16,4%
2016-12,המרכז,469,קריית עקרון,240,112,128,27,213,95,236,7,4%
2016-12,המרכז,2640,ראש העין,707,355,352,106,601,133,694,11,3%
2016-12,המרכז,8300,ראשון לציון,3900,1716,2184,784,3116,1031,3851,65,3%
2016-12,המרכז,8400,רחובות,2146,962,1184,516,1630,678,2075,76,3%
2016-12,המרכז,8500,רמלה,1399,676,723,110,1289,587,1336,48,4%
2016-12,המרכז,8700,רעננה,653,304,349,277,376,40,644,10,2%
2016-12,המרכז,1304,שוהם,170,59,111,71,99,7,169,0,2%
2016-12,המרכז,154,תל מונד,142,77,65,41,101,17,140,2,2%
2016-12,הצפון,473,אבו סנאן,574,240,334,3,571,457,564,9,10%
2016-12,הצפון,478,אכסאל,456,201,255,8,448,381,453,1,8%
2016-12,הצפון,529,אעבלין,443,179,264,9,434,354,434,12,8%
2016-12,הצפון,482,בועיינה-נוג'ידאת,283,138,145,9,274,222,279,1,8%
2016-12,הצפון,4001,בוקעאתא,397,156,241,5,392,308,383,3,14%
2016-12,הצפון,998,ביר אל-מכסור,336,138,198,5,331,261,333,2,9%
2016-12,הצפון,480,בית ג'ן,385,110,275,9,376,261,370,2,7%
2016-12,הצפון,9200,בית שאן,706,327,379,29,677,319,681,42,7%
2016-12,הצפון,944,בסמת טבעון,164,77,87,3,161,122,156,1,5%
2016-12,הצפון,483,בענה,318,133,185,7,311,263,308,8,9%
2016-12,הצפון,1292,ג'דיידה-מכר,1096,483,613,3,1093,897,1075,11,12%
2016-12,הצפון,485,ג'ולס,194,58,136,2,192,124,194,3,7%
2016-12,הצפון,487,ג'ש (גוש חלב),56,24,32,8,48,25,56,1,3%
2016-12,הצפון,489,דבורייה,283,116,167,14,269,207,281,2,7%
2016-12,הצפון,490,דייר אל-אסד,330,148,182,11,319,272,321,4,6%
2016-12,הצפון,492,דייר חנא,603,246,357,4,599,465,593,6,12%
2016-12,הצפון,975,זרזיר,220,94,126,3,217,137,212,12,7%
2016-12,הצפון,496,חורפיש,100,40,60,7,93,60,93,2,4%
2016-12,הצפון,2034,חצור הגלילית,262,105,157,16,246,118,249,10,5%
2016-12,הצפון,6700,טבריה,1421,675,746,68,1353,691,1226,66,6%
2016-12,הצפון,962,טובא-זנגרייה,317,151,166,5,312,224,307,3,10%
2016-12,הצפון,498,טורעאן,403,179,224,8,395,337,393,3,7%
2016-12,הצפון,8900,טמרה,1326,591,735,19,1307,1139,1300,16,10%
2016-12,הצפון,1295,יאנוח-ג'ת,145,50,95,4,141,90,140,0,5%
2016-12,הצפון,46,יבנאל,95,51,44,5,90,62,72,2,5%
2016-12,הצפון,499,יפיע,533,220,313,16,517,406,529,6,7%
2016-12,הצפון,240,יקנעם עילית,397,165,232,66,331,105,388,26,3%
2016-12,הצפון,502,ירכא,444,172,272,1,443,338,437,6,8%
2016-12,הצפון,504,כאבול,453,213,240,7,446,386,446,3,10%
2016-12,הצפון,505,כאוכב אבו אל-היג'א,205,87,118,2,203,172,201,2,12%
2016-12,הצפון,1296,כסרא-סמיע,189,66,123,5,184,121,177,1,5%
2016-12,הצפון,978,כעביה-טבאש-חג'אג'רה,138,55,83,2,136,101,135,2,6%
2016-12,הצפון,1263,כפר ורדים,68,33,35,26,42,6,67,0,2%
2016-12,הצפון,507,כפר יאסיף,398,165,233,8,390,274,391,4,8%
2016-12,הצפון,508,כפר כמא,56,21,35,5,51,23,56,1,3%
2016-12,הצפון,509,כפר כנא,797,367,430,30,767,654,772,9,9%
2016-12,הצפון,510,כפר מנדא,670,321,349,8,662,522,664,0,9%
2016-12,הצפון,47,כפר תבור,41,14,27,20,21,2,39,0,2%
2016-12,הצפון,1139,כרמיאל,1394,574,820,254,1140,662,1299,38,5%
2016-12,הצפון,481,מגאר,1235,534,701,18,1217,1005,1200,17,13%
2016-12,הצפון,516,מג'ד אל-כרום,469,206,263,8,461,340,451,14,7%
2016-12,הצפון,874,מגדל העמק,742,316,426,74,668,289,685,56,5%
2016-12,הצפון,4201,מג'דל שמס,420,160,260,9,411,320,402,3,9%
2016-12,הצפון,517,מזרעה,151,64,87,1,150,112,146,6,8%
2016-12,הצפון,4203,מסעדה,195,69,126,2,193,158,184,5,11%
2016-12,הצפון,518,מעיליא,53,28,25,4,49,19,53,0,3%
2016-12,הצפון,1063,מעלות-תרשיחא,736,359,377,87,649,391,697,45,6%
2016-12,הצפון,520,משהד,218,94,124,6,212,167,207,7,7%
2016-12,הצפון,9100,נהרייה,1693,800,893,146,1547,935,1600,69,5%
2016-12,הצפון,522,נחף,364,161,203,14,350,297,353,5,7%
2016-12,הצפון,7300,נצרת,2682,1142,1540,124,2558,2045,2651,17,8%
2016-12,הצפון,1061,נצרת עילית,1362,601,761,137,1225,683,1210,75,5%
2016-12,הצפון,525,סאג'ור,110,40,70,5,105,79,107,1,6%
2016-12,הצפון,7500,סח'נין,1956,867,1089,34,1922,1630,1921,23,14%
2016-12,הצפון,4501,ע'ג'ר,90,30,60,1,89,61,89,1,9%
2016-12,הצפון,530,עיילבון,172,79,93,11,161,102,169,0,6%
2016-12,הצפון,511,עילוט,270,108,162,5,265,219,270,1,10%
2016-12,הצפון,532,עין מאהל,383,189,194,12,371,309,368,2,7%
2016-12,הצפון,7600,עכו,2699,1252,1447,130,2569,1992,2609,53,10%
2016-12,הצפון,7700,עפולה,1410,586,824,173,1237,591,1333,66,5%
2016-12,הצפון,531,עראבה,1417,580,837,20,1397,1240,1391,19,14%
2016-12,הצפון,535,פסוטה,82,40,42,7,75,46,80,1,5%
2016-12,הצפון,536,פקיעין (בוקייעה),134,70,64,6,128,83,126,1,5%
2016-12,הצפון,8000,צפת,1041,546,495,98,943,680,979,22,8%
2016-12,הצפון,4100,קצרין,206,90,116,29,177,93,203,2,5%
2016-12,הצפון,2800,קריית שמונה,683,329,354,62,621,279,658,22,5%
2016-12,הצפון,543,ראמה,252,101,151,19,233,174,245,2,6%
2016-12,הצפון,26,ראש פינה,45,17,28,9,36,17,44,0,3%
2016-12,הצפון,542,ריינה,487,216,271,9,478,367,474,9,7%
2016-12,הצפון,122,רמת ישי,82,33,49,29,53,10,81,3,2%
2016-12,הצפון,913,שבלי - אום אל-גנם,183,73,110,3,180,124,181,6,7%
2016-12,הצפון,812,שלומי,200,78,122,18,182,92,190,8,5%
2016-12,הצפון,538,שעב,459,187,272,2,457,400,454,4,15%
2016-12,הצפון,8800,שפרעם,1470,575,895,44,1426,1174,1433,29,8%
2016-12,חיפה,2710,אום אל-פחם,2776,1161,1615,29,2747,2289,2723,25,14%
2016-12,חיפה,1020,אור עקיבא,447,193,254,44,403,123,435,17,4%
2016-12,חיפה,6000,באקה אל-גרביה,551,254,297,11,540,347,545,24,5%
2016-12,חיפה,9800,בנימינה-גבעת עדה*,188,87,101,61,127,41,188,5,3%
2016-12,חיפה,1326,"בסמ""ה",348,158,190,5,343,267,343,0,9%
2016-12,חיפה,541,ג'סר א-זרקא,275,142,133,2,273,166,274,11,5%
2016-12,חיפה,628,ג'ת,186,93,93,5,181,114,183,6,4%
2016-12,חיפה,494,דאלית אל-כרמל,439,176,263,15,424,248,402,8,5%
2016-12,חיפה,9300,זכרון יעקב,242,108,134,82,160,36,239,3,2%
2016-12,חיפה,6500,חדרה,2014,872,1142,228,1786,711,1890,49,4%
2016-12,חיפה,4000,חיפה,5353,2615,2738,1135,4218,2678,5017,108,4%
2016-12,חיפה,1247,חריש,72,34,38,12,60,14,64,0,4%
2016-12,חיפה,2100,טירת כרמל,637,322,315,29,608,319,625,20,6%
2016-12,חיפה,654,כפר קרע,403,185,218,9,394,247,397,5,5%
2016-12,חיפה,1327,מעלה עירון,675,265,410,3,672,549,658,10,12%
2016-12,חיפה,2500,נשר,355,159,196,74,281,135,338,16,3%
2016-12,חיפה,534,עספיא,292,126,166,16,276,153,266,4,5%
2016-12,חיפה,637,ערערה,499,223,276,10,489,329,487,16,6%
2016-12,חיפה,537,פוריידיס,275,149,126,4,271,145,271,3,5%
2016-12,חיפה,7800,פרדס חנה-כרכור,670,280,390,166,504,163,659,19,3%
2016-12,חיפה,6800,קריית אתא,1398,641,757,122,1276,692,1363,27,5%
2016-12,חיפה,9500,קריית ביאליק,913,382,531,114,799,390,885,12,4%
2016-12,חיפה,2300,קריית טבעון,169,74,95,76,93,24,168,0,2%
2016-12,חיפה,9600,קריית ים,1199,544,655,103,1096,681,1151,33,5%
2016-12,חיפה,8200,קריית מוצקין,856,368,488,142,714,358,830,18,4%
2016-12,חיפה,922,רכסים,144,68,76,12,132,69,131,2,4%
2016-12,ירושלים,472,אבו גוש,238,123,115,9,229,178,235,1,8%
2016-12,ירושלים,2610,בית שמש,1163,499,664,108,1055,418,1113,31,4%
2016-12,ירושלים,3000,ירושלים,11275,5080,6195,1303,9972,6978,10951,125,4%
2016-12,ירושלים,1015,מבשרת ציון,307,158,149,67,240,113,297,5,2%
2016-12,ירושלים,1137,קריית יערים,44,23,21,10,34,13,44,0,3%
2016-12,תל אביב,2400,אור יהודה,627,311,316,62,565,150,600,25,3%
2016-12,תל אביב,565,אזור,142,75,67,26,116,23,142,1,2%
2016-12,תל אביב,6100,בני ברק,1634,790,844,85,1549,695,1535,31,3%
2016-12,תל אביב,6200,בת ים,2476,1176,1300,316,2160,882,2331,76,3%
2016-12,תל אביב,6300,גבעתיים,684,318,366,317,367,73,679,3,2%
2016-12,תל אביב,6400,הרצלייה,991,453,538,367,624,29,984,17,2%
2016-12,תל אביב,6600,חולון,2777,1270,1507,467,2310,609,2715,67,3%
2016-12,תל אביב,2620,קריית אונו,392,156,236,179,213,33,388,1,2%
2016-12,תל אביב,8600,רמת גן,1917,889,1028,677,1240,313,1882,17,2%
2016-12,תל אביב,2650,רמת השרון,340,130,210,163,177,5,339,3,2%
2016-12,תל אביב,5000,תל אביב -יפו,7007,3456,3551,2555,4452,1619,6876,85,3%
2017-01,אזור יהודה והשומרון,3760,אורנית,98,52,46,36,62,1,98,0,2%
2017-01,אזור יהודה והשומרון,3750,אלפי מנשה,105,38,67,38,67,2,104,2,2%
2017-01,אזור יהודה והשומרון,3560,אלקנה,35,19,16,19,16,0,35,0,2%
2017-01,אזור יהודה והשומרון,3650,אפרת,126,70,56,54,72,6,126,2,3%
2017-01,אזור יהודה והשומרון,3570,אריאל,320,162,158,71,249,23,314,24,3%
2017-01,אזור יהודה והשומרון,3574,בית אל,49,21,28,21,28,15,49,0,2%
2017-01,אזור יהודה והשומרון,3652,בית אריה,59,34,25,15,44,0,58,1,2%
2017-01,אזור יהודה והשומרון,3780,ביתר עילית,480,222,258,8,472,170,478,6,4%
2017-01,אזור יהודה והשומרון,3730,גבעת זאב,189,82,107,39,150,40,186,4,2%
2017-01,אזור יהודה והשומרון,3769,הר אדר,25,12,13,12,13,4,25,0,1%
2017-01,אזור יהודה והשומרון,3797,מודיעין עילית,404,126,278,23,381,30,400,5,3%
2017-01,אזור יהודה והשומרון,3616,מעלה אדומים,603,266,337,98,505,171,590,20,3%
2017-01,אזור יהודה והשומרון,3660,עמנואל,48,29,19,2,46,28,48,2,4%
2017-01,אזור יהודה והשומרון,3557,קדומים,27,18,9,8,19,3,25,4,1%
2017-01,אזור יהודה והשומרון,3611,קריית ארבע,82,48,34,16,66,39,78,3,2%
2017-01,אזור יהודה והשומרון,3640,קרני שומרון,84,43,41,24,60,4,84,6,2%
2017-01,הדרום,31,אופקים,842,375,467,51,791,470,815,49,7%
2017-01,הדרום,2600,אילת,1206,601,605,62,1144,377,1131,52,3%
2017-01,הדרום,70,אשדוד,5228,2181,3047,656,4572,2352,4958,145,5%
2017-01,הדרום,7100,אשקלון,3578,1549,2029,430,3148,1691,3153,66,5%
2017-01,הדרום,9000,באר שבע,5531,2551,2980,716,4815,2939,5188,134,5%
2017-01,הדרום,2200,דימונה,1716,787,929,97,1619,1118,1613,76,9%
2017-01,הדרום,1303,חורה,549,231,318,3,546,473,533,3,14%
2017-01,הדרום,831,ירוחם,400,193,207,25,375,230,366,29,8%
2017-01,הדרום,1059,כסיפה,966,386,580,2,964,854,954,4,21%
2017-01,הדרום,1271,להבים,53,15,38,28,25,3,53,0,2%
2017-01,הדרום,1060,לקיה,660,296,364,4,656,579,632,4,16%
2017-01,הדרום,1268,מיתר,86,34,52,38,48,5,83,1,2%
2017-01,הדרום,99,מצפה רמון,254,100,154,16,238,157,243,12,10%
2017-01,הדרום,246,נתיבות,868,396,472,51,817,414,811,46,6%
2017-01,הדרום,666,עומר,63,24,39,30,33,3,62,0,2%
2017-01,הדרום,2560,ערד,701,315,386,72,629,343,666,33,5%
2017-01,הדרום,1192,ערערה-בנגב,1089,472,617,6,1083,963,1065,34,25%
2017-01,הדרום,2630,קריית גת,1608,654,954,93,1515,719,1529,62,5%
2017-01,הדרום,1034,קריית מלאכי,717,329,388,22,695,314,685,55,6%
2017-01,הדרום,1161,רהט,2477,1039,1438,10,2467,1918,2437,75,13%
2017-01,הדרום,1286,שגב-שלום,355,137,218,2,353,299,340,2,14%
2017-01,הדרום,1031,שדרות,900,410,490,67,833,491,827,25,7%
2017-01,הדרום,1054,תל שבע,766,338,428,2,764,682,732,11,16%
2017-01,המרכז,182,אבן יהודה,155,72,83,46,109,14,155,2,2%
2017-01,המרכז,41,אליכין,54,30,24,9,45,15,51,4,3%
2017-01,המרכז,1309,אלעד,321,135,186,23,298,30,311,1,3%
2017-01,המרכז,2530,באר יעקב,245,99,146,75,170,42,242,5,3%
2017-01,המרכז,466,בית דגן,105,57,48,11,94,29,102,1,3%
2017-01,המרכז,1066,"בני עי""ש",139,72,67,13,126,41,136,7,3%
2017-01,המרכז,681,גבעת שמואל,250,134,116,77,173,38,245,2,2%
2017-01,המרכז,2550,גדרה,319,134,185,50,269,72,308,11,3%
2017-01,המרכז,627,ג'לג'וליה,78,35,43,4,74,43,76,1,2%
2017-01,המרכז,166,גן יבנה,307,118,189,54,253,60,302,6,3%
2017-01,המרכז,229,גני תקווה,210,99,111,86,124,27,207,1,2%
2017-01,המרכז,9700,הוד השרון,610,263,347,270,340,41,600,10,2%
2017-01,המרכז,1290,זמר,127,47,80,3,124,81,125,6,4%
2017-01,המרכז,2730,טייבה,1123,510,613,32,1091,801,968,40,6%
2017-01,המרכז,2720,טירה,186,94,92,15,171,58,180,10,2%
2017-01,המרכז,2660,יבנה,712,339,373,136,576,180,700,29,3%
2017-01,המרכז,9400,יהוד,366,164,202,90,276,44,357,13,2%
2017-01,המרכז,1224,כוכב יאיר,88,45,43,56,32,0,87,1,2%
2017-01,המרכז,633,כפר ברא,13,8,5,0,13,7,13,2,1%
2017-01,המרכז,168,כפר יונה,319,143,176,64,255,42,316,4,3%
2017-01,המרכז,6900,כפר סבא,1148,515,633,439,709,93,1127,23,2%
2017-01,המרכז,634,כפר קאסם,240,99,141,11,229,126,230,3,3%
2017-01,המרכז,7000,לוד,1734,822,912,135,1599,907,1689,46,5%
2017-01,המרכז,1200,מודיעין-מכבים-רעות*,846,380,466,342,504,52,834,23,2%
2017-01,המרכז,28,מזכרת בתיה,170,77,93,51,119,23,164,5,2%
2017-01,המרכז,7200,נס ציונה,634,295,339,154,480,162,624,14,3%
2017-01,המרכז,7400,נתניה,3918,1864,2054,498,3420,1268,3827,115,4%
2017-01,המרכז,587,סביון*,16,6,10,8,8,1,16,0,1%
2017-01,המרכז,171,פרדסייה,71,35,36,25,46,5,71,1,2%
2017-01,המרכז,7900,פתח תקווה,3750,1713,2037,876,2874,853,3650,60,3%
2017-01,המרכז,195,קדימה-צורן,265,117,148,70,195,43,262,3,2%
2017-01,המרכז,638,קלנסווה,372,198,174,10,362,261,338,8,4%
2017-01,המרכז,469,קריית עקרון,220,96,124,27,193,93,213,9,4%
2017-01,המרכז,2640,ראש העין,774,377,397,118,656,128,763,16,3%
2017-01,המרכז,8300,ראשון לציון,4059,1754,2305,813,3246,1029,4017,82,3%
2017-01,המרכז,8400,רחובות,2215,986,1229,539,1676,694,2138,72,3%
2017-01,המרכז,8500,רמלה,1483,712,771,129,1354,601,1415,76,4%
2017-01,המרכז,8700,רעננה,678,320,358,285,393,38,672,10,2%
2017-01,המרכז,1304,שוהם,177,64,113,72,105,10,176,1,2%
2017-01,המרכז,154,תל מונד,143,74,69,48,95,17,143,0,2%
2017-01,הצפון,473,אבו סנאן,575,241,334,4,571,445,562,8,10%
2017-01,הצפון,478,אכסאל,449,191,258,7,442,384,446,9,8%
2017-01,הצפון,529,אעבלין,443,184,259,10,433,348,432,8,8%
2017-01,הצפון,482,בועיינה-נוג'ידאת,278,134,144,8,270,219,270,4,7%
2017-01,הצפון,4001,בוקעאתא,414,161,253,4,410,305,399,0,15%
2017-01,הצפון,998,ביר אל-מכסור,341,143,198,6,335,258,336,6,9%
2017-01,הצפון,480,בית ג'ן,390,118,272,9,381,263,370,1,7%
2017-01,הצפון,9200,בית שאן,716,336,380,24,692,323,687,43,7%
2017-01,הצפון,944,בסמת טבעון,178,84,94,3,175,129,165,5,5%
2017-01,הצפון,483,בענה,340,142,198,7,333,282,324,7,10%
2017-01,הצפון,1292,ג'דיידה-מכר,1112,499,613,2,1110,900,1093,15,12%
2017-01,הצפון,485,ג'ולס,197,58,139,2,195,127,196,0,7%
2017-01,הצפון,487,ג'ש (גוש חלב),60,25,35,7,53,25,60,1,4%
2017-01,הצפון,489,דבורייה,293,121,172,15,278,211,289,2,7%
2017-01,הצפון,490,דייר אל-אסד,337,147,190,12,325,278,321,9,6%
2017-01,הצפון,492,דייר חנא,612,259,353,4,608,467,598,7,12%
2017-01,הצפון,975,זרזיר,221,96,125,3,218,143,218,6,7%
2017-01,הצפון,496,חורפיש,114,43,71,12,102,58,107,5,4%
2017-01,הצפון,2034,חצור הגלילית,248,99,149,17,231,119,230,4,5%
2017-01,הצפון,6700,טבריה,1518,725,793,83,1435,730,1327,72,6%
2017-01,הצפון,962,טובא-זנגרייה,329,162,167,5,324,226,317,4,11%
2017-01,הצפון,498,טורעאן,409,180,229,8,401,338,401,12,7%
2017-01,הצפון,8900,טמרה,1328,607,721,21,1307,1119,1296,12,10%
2017-01,הצפון,1295,יאנוח-ג'ת,147,54,93,5,142,85,142,3,5%
2017-01,הצפון,46,יבנאל,116,59,57,9,107,72,94,4,6%
2017-01,הצפון,499,יפיע,540,234,306,14,526,408,531,10,7%
2017-01,הצפון,240,יקנעם עילית,445,185,260,79,366,113,431,28,4%
2017-01,הצפון,502,ירכא,420,161,259,1,419,320,415,5,7%
2017-01,הצפון,504,כאבול,467,226,241,6,461,394,456,4,10%
2017-01,הצפון,505,כאוכב אבו אל-היג'א,209,89,120,3,206,176,206,3,12%
2017-01,הצפון,1296,כסרא-סמיע,208,79,129,8,200,129,189,1,6%
2017-01,הצפון,978,כעביה-טבאש-חג'אג'רה,149,61,88,2,147,107,147,1,7%
2017-01,הצפון,1263,כפר ורדים,68,31,37,28,40,5,67,0,2%
2017-01,הצפון,507,כפר יאסיף,401,163,238,9,392,272,395,7,8%
2017-01,הצפון,508,כפר כמא,57,25,32,5,52,25,56,0,3%
2017-01,הצפון,509,כפר כנא,812,377,435,30,782,650,788,28,9%
2017-01,הצפון,510,כפר מנדא,683,331,352,6,677,530,677,4,10%
2017-01,הצפון,47,כפר תבור,34,10,24,15,19,1,33,1,2%
2017-01,הצפון,1139,כרמיאל,1409,574,835,278,1131,665,1299,42,5%
2017-01,הצפון,481,מגאר,1246,541,705,22,1224,1005,1210,23,13%
2017-01,הצפון,516,מג'ד אל-כרום,485,206,279,8,477,351,459,12,7%
2017-01,הצפון,874,מגדל העמק,771,328,443,88,683,292,709,77,5%
2017-01,הצפון,4201,מג'דל שמס,426,166,260,10,416,311,409,6,9%
2017-01,הצפון,517,מזרעה,157,69,88,0,157,114,152,4,8%
2017-01,הצפון,4203,מסעדה,202,73,129,3,199,157,188,4,11%
2017-01,הצפון,518,מעיליא,61,33,28,7,54,19,61,1,4%
2017-01,הצפון,1063,מעלות-תרשיחא,791,392,399,87,704,388,748,39,6%
2017-01,הצפון,520,משהד,205,91,114,3,202,167,197,4,6%
2017-01,הצפון,9100,נהרייה,1763,853,910,163,1600,952,1660,74,5%
2017-01,הצפון,522,נחף,385,176,209,16,369,307,366,10,7%
2017-01,הצפון,7300,נצרת,2739,1187,1552,129,2610,2052,2699,37,8%
2017-01,הצפון,1061,נצרת עילית,1434,628,806,140,1294,678,1259,113,5%
2017-01,הצפון,525,סאג'ור,104,36,68,7,97,75,102,1,6%
2017-01,הצפון,7500,סח'נין,1920,870,1050,37,1883,1578,1883,15,14%
2017-01,הצפון,4501,ע'ג'ר,87,28,59,0,87,57,86,0,8%
2017-01,הצפון,530,עיילבון,179,84,95,11,168,101,175,4,6%
2017-01,הצפון,511,עילוט,274,110,164,8,266,220,271,4,10%
2017-01,הצפון,532,עין מאהל,395,203,192,13,382,301,380,4,7%
2017-01,הצפון,7600,עכו,2776,1291,1485,145,2631,2013,2666,48,10%
2017-01,הצפון,7700,עפולה,1485,617,868,180,1305,583,1392,69,6%
2017-01,הצפון,531,עראבה,1423,604,819,21,1402,1232,1400,9,14%
2017-01,הצפון,535,פסוטה,87,42,45,7,80,50,83,2,5%
2017-01,הצפון,536,פקיעין (בוקייעה),133,74,59,7,126,82,127,5,5%
2017-01,הצפון,8000,צפת,1053,542,511,104,949,674,979,26,8%
2017-01,הצפון,4100,קצרין,201,92,109,26,175,87,198,6,5%
2017-01,הצפון,2800,קריית שמונה,731,356,375,68,663,282,698,34,5%
2017-01,הצפון,543,ראמה,257,102,155,21,236,179,247,4,6%
2017-01,הצפון,26,ראש פינה,42,18,24,6,36,15,41,0,3%
2017-01,הצפון,542,ריינה,481,224,257,9,472,368,468,4,7%
2017-01,הצפון,122,רמת ישי,92,41,51,44,48,10,91,0,2%
2017-01,הצפון,913,שבלי - אום אל-גנם,206,87,119,6,200,130,201,8,8%
2017-01,הצפון,812,שלומי,201,75,126,20,181,104,193,9,5%
2017-01,הצפון,538,שעב,462,191,271,5,457,396,457,3,15%
2017-01,הצפון,8800,שפרעם,1425,573,852,37,1388,1145,1390,28,8%
2017-01,חיפה,2710,אום אל-פחם,2790,1186,1604,27,2763,2301,2725,40,14%
2017-01,חיפה,1020,אור עקיבא,454,196,258,47,407,124,436,23,4%
2017-01,חיפה,6000,באקה אל-גרביה,529,243,286,7,522,333,524,33,5%
2017-01,חיפה,9800,בנימינה-גבעת עדה*,190,88,102,64,126,39,190,4,3%
2017-01,חיפה,1326,"בסמ""ה",357,161,196,7,350,276,352,5,9%
2017-01,חיפה,541,ג'סר א-זרקא,267,148,119,3,264,154,266,13,5%
2017-01,חיפה,628,ג'ת,189,96,93,6,183,112,186,10,4%
2017-01,חיפה,494,דאלית אל-כרמל,454,180,274,14,440,265,407,8,5%
2017-01,חיפה,9300,זכרון יעקב,262,116,146,94,168,35,257,1,2%
2017-01,חיפה,6500,חדרה,2108,939,1169,254,1854,712,1979,54,4%
2017-01,חיפה,4000,חיפה,5563,2693,2870,1198,4365,2709,5193,146,4%
2017-01,חיפה,1247,חריש,82,36,46,16,66,16,72,2,5%
2017-01,חיפה,2100,טירת כרמל,633,316,317,27,606,322,615,16,6%
2017-01,חיפה,654,כפר קרע,415,194,221,12,403,248,408,16,5%
2017-01,חיפה,1327,מעלה עירון,662,258,404,4,658,545,647,8,12%
2017-01,חיפה,2500,נשר,366,180,186,74,292,134,356,4,3%
2017-01,חיפה,534,עספיא,297,130,167,16,281,152,272,5,5%
2017-01,חיפה,637,ערערה,494,223,271,8,486,327,482,16,6%
2017-01,חיפה,537,פוריידיס,283,156,127,5,278,134,280,4,5%
2017-01,חיפה,7800,פרדס חנה-כרכור,721,309,412,180,541,164,709,22,4%
2017-01,חיפה,6800,קריית אתא,1435,659,776,118,1317,685,1403,42,5%
2017-01,חיפה,9500,קריית ביאליק,955,418,537,117,838,413,926,19,4%
2017-01,חיפה,2300,קריית טבעון,187,79,108,84,103,29,185,2,2%
2017-01,חיפה,9600,קריית ים,1258,577,681,117,1141,702,1212,31,6%
2017-01,חיפה,8200,קריית מוצקין,894,375,519,150,744,355,864,18,4%
2017-01,חיפה,922,רכסים,145,69,76,10,135,74,129,2,4%
2017-01,ירושלים,472,אבו גוש,245,133,112,7,238,174,242,7,8%
2017-01,ירושלים,2610,בית שמש,1213,524,689,111,1102,424,1163,50,4%
2017-01,ירושלים,3000,ירושלים,11434,5154,6280,1355,10079,6978,11097,156,4%
2017-01,ירושלים,1015,מבשרת ציון,320,157,163,70,250,109,311,7,2%
2017-01,ירושלים,1137,קריית יערים,45,23,22,9,36,15,45,2,3%
2017-01,תל אביב,2400,אור יהודה,624,316,308,63,561,153,598,41,3%
2017-01,תל אביב,565,אזור,173,87,86,29,144,33,168,4,3%
2017-01,תל אביב,6100,בני ברק,1654,815,839,89,1565,698,1530,26,3%
2017-01,תל אביב,6200,בת ים,2637,1277,1360,358,2279,891,2493,109,4%
2017-01,תל אביב,6300,גבעתיים,725,331,394,347,378,79,721,10,2%
2017-01,תל אביב,6400,הרצלייה,1052,479,573,376,676,30,1043,15,2%
2017-01,תל אביב,6600,חולון,2889,1309,1580,485,2404,628,2813,68,3%
2017-01,תל אביב,2620,קריית אונו,405,162,243,182,223,34,401,4,2%
2017-01,תל אביב,8600,רמת גן,1977,933,1044,698,1279,316,1942,27,2%
2017-01,תל אביב,2650,רמת השרון,375,158,217,175,200,12,373,7,2%
2017-01,תל אביב,5000,תל אביב -יפו,7266,3604,3662,2658,4608,1635,7130,110,3%
2017-02,אזור יהודה והשומרון,3760,אורנית,81,41,40,33,48,2,81,4,2%
2017-02,אזור יהודה והשומרון,3750,אלפי מנשה,92,33,59,35,57,4,90,2,2%
2017-02,אזור יהודה והשומרון,3560,אלקנה,32,16,16,15,17,0,32,0,2%
2017-02,אזור יהודה והשומרון,3650,אפרת,124,70,54,60,64,6,124,2,3%
2017-02,אזור יהודה והשומרון,3570,אריאל,303,141,162,67,236,22,300,14,3%
2017-02,אזור יהודה והשומרון,3574,בית אל,52,26,26,19,33,16,52,0,2%
2017-02,אזור יהודה והשומרון,3652,בית אריה,54,30,24,14,40,0,54,1,2%
2017-02,אזור יהודה והשומרון,3780,ביתר עילית,455,210,245,11,444,161,450,1,4%
2017-02,אזור יהודה והשומרון,3730,גבעת זאב,176,77,99,41,135,38,172,4,2%
2017-02,אזור יהודה והשומרון,3769,הר אדר,26,11,15,13,13,2,26,0,1%
2017-02,אזור יהודה והשומרון,3797,מודיעין עילית,387,124,263,24,363,30,383,5,3%
2017-02,אזור יהודה והשומרון,3616,מעלה אדומים,563,250,313,91,472,158,551,14,3%
2017-02,אזור יהודה והשומרון,3660,עמנואל,44,27,17,2,42,23,44,5,4%
2017-02,אזור יהודה והשומרון,3557,קדומים,26,17,9,7,19,5,24,0,1%
2017-02,אזור יהודה והשומרון,3611,קריית ארבע,88,51,37,18,70,40,83,4,3%
2017-02,אזור יהודה והשומרון,3640,קרני שומרון,70,42,28,21,49,5,69,1,2%
2017-02,הדרום,31,אופקים,798,350,448,50,748,452,775,41,6%
2017-02,הדרום,2600,אילת,1194,597,597,58,1136,378,1122,56,3%
2017-02,הדרום,70,אשדוד,5059,2099,2960,648,4411,2293,4801,118,4%
2017-02,הדרום,7100,אשקלון,3480,1502,1978,414,3066,1659,3063,58,5%
2017-02,הדרום,9000,באר שבע,5256,2413,2843,662,4594,2838,4967,121,5%
2017-02,הדרום,2200,דימונה,1641,743,898,93,1548,1118,1545,37,9%
2017-02,הדרום,1303,חורה,543,229,314,4,539,456,526,4,14%
2017-02,הדרום,831,ירוחם,379,185,194,25,354,220,352,27,8%
2017-02,הדרום,1059,כסיפה,984,393,591,4,980,862,972,7,21%
2017-02,הדרום,1271,להבים,52,14,38,29,23,3,52,0,1%
2017-02,הדרום,1060,לקיה,644,286,358,8,636,559,628,3,16%
2017-02,הדרום,1268,מיתר,84,34,50,34,50,5,82,0,2%
2017-02,הדרום,99,מצפה רמון,231,91,140,14,217,154,220,11,9%
2017-02,הדרום,246,נתיבות,877,396,481,52,825,406,820,61,6%
2017-02,הדרום,666,עומר,57,20,37,29,28,3,56,1,1%
2017-02,הדרום,2560,ערד,673,295,378,60,613,333,642,29,5%
2017-02,הדרום,1192,ערערה-בנגב,1090,475,615,6,1084,971,1064,17,25%
2017-02,הדרום,2630,קריית גת,1535,624,911,88,1447,705,1461,67,5%
2017-02,הדרום,1034,קריית מלאכי,691,302,389,25,666,288,660,49,6%
2017-02,הדרום,1161,רהט,2399,1003,1396,10,2389,1860,2358,102,13%
2017-02,הדרום,1286,שגב-שלום,331,128,203,2,329,280,320,3,13%
2017-02,הדרום,1031,שדרות,897,413,484,65,832,485,827,32,7%
2017-02,הדרום,1054,תל שבע,732,325,407,2,730,644,701,7,16%
2017-02,המרכז,182,אבן יהודה,163,76,87,54,109,15,162,1,2%
2017-02,המרכז,41,אליכין,57,30,27,12,45,15,54,1,3%
2017-02,המרכז,1309,אלעד,302,126,176,25,277,30,293,2,2%
2017-02,המרכז,2530,באר יעקב,240,93,147,73,167,44,235,4,3%
2017-02,המרכז,466,בית דגן,97,52,45,13,84,29,95,1,3%
2017-02,המרכז,1066,"בני עי""ש",129,70,59,15,114,39,126,6,3%
2017-02,המרכז,681,גבעת שמואל,249,133,116,77,172,37,246,0,2%
2017-02,המרכז,2550,גדרה,292,132,160,48,244,74,284,4,2%
2017-02,המרכז,627,ג'לג'וליה,72,38,34,2,70,38,72,0,2%
2017-02,המרכז,166,גן יבנה,294,119,175,48,246,58,289,2,3%
2017-02,המרכז,229,גני תקווה,208,101,107,81,127,24,206,0,2%
2017-02,המרכז,9700,הוד השרון,639,281,358,301,338,31,632,17,2%
2017-02,המרכז,1290,זמר,117,42,75,2,115,77,115,7,4%
2017-02,המרכז,2730,טייבה,1077,492,585,33,1044,768,938,47,6%
2017-02,המרכז,2720,טירה,174,91,83,12,162,55,168,7,2%
2017-02,המרכז,2660,יבנה,680,322,358,139,541,181,671,25,3%
2017-02,המרכז,9400,יהוד,355,160,195,87,268,40,344,7,2%
2017-02,המרכז,1224,כוכב יאיר,81,43,38,51,30,0,81,0,1%
2017-02,המרכז,633,כפר ברא,11,7,4,1,10,6,11,0,1%
2017-02,המרכז,168,כפר יונה,300,135,165,63,237,41,297,4,3%
2017-02,המרכז,6900,כפר סבא,1073,494,579,415,658,89,1056,20,2%
2017-02,המרכז,634,כפר קאסם,202,82,120,12,190,100,201,1,2%
2017-02,המרכז,7000,לוד,1704,822,882,131,1573,877,1665,48,5%
2017-02,המרכז,1200,מודיעין-מכבים-רעות*,828,383,445,341,487,47,815,22,2%
2017-02,המרכז,28,מזכרת בתיה,155,67,88,50,105,19,152,1,2%
2017-02,המרכז,7200,נס ציונה,623,293,330,149,474,155,612,13,3%
2017-02,המרכז,7400,נתניה,3782,1832,1950,481,3301,1235,3687,91,4%
2017-02,המרכז,587,סביון*,17,6,11,10,7,1,17,0,1%
2017-02,המרכז,171,פרדסייה,74,39,35,29,45,5,74,0,2%
2017-02,המרכז,7900,פתח תקווה,3580,1645,1935,816,2764,827,3480,61,3%
2017-02,המרכז,195,קדימה-צורן,250,104,146,73,177,35,249,2,2%
2017-02,המרכז,638,קלנסווה,370,198,172,8,362,257,331,10,4%
2017-02,המרכז,469,קריית עקרון,212,95,117,27,185,87,210,7,4%
2017-02,המרכז,2640,ראש העין,719,345,374,122,597,119,713,20,3%
2017-02,המרכז,8300,ראשון לציון,3881,1668,2213,784,3097,975,3833,70,3%
2017-02,המרכז,8400,רחובות,2106,906,1200,528,1578,671,2035,49,3%
2017-02,המרכז,8500,רמלה,1425,684,741,126,1299,575,1360,56,4%
2017-02,המרכז,8700,רעננה,652,296,356,285,367,40,638,10,2%
2017-02,המרכז,1304,שוהם,154,57,97,72,82,8,152,0,1%
2017-02,המרכז,154,תל מונד,147,77,70,49,98,14,147,2,2%
2017-02,הצפון,473,אבו סנאן,557,234,323,4,553,436,548,5,10%
2017-02,הצפון,478,אכסאל,451,197,254,10,441,383,448,1,8%
2017-02,הצפון,529,אעבלין,439,187,252,12,427,350,429,4,8%
2017-02,הצפון,482,בועיינה-נוג'ידאת,268,125,143,6,262,216,257,3,7%
2017-02,הצפון,4001,בוקעאתא,403,155,248,4,399,301,390,2,14%
2017-02,הצפון,998,ביר אל-מכסור,329,139,190,6,323,243,325,8,9%
2017-02,הצפון,480,בית ג'ן,389,116,273,7,382,260,371,1,7%
2017-02,הצפון,9200,בית שאן,700,310,390,26,674,310,677,50,7%
2017-02,הצפון,944,בסמת טבעון,162,71,91,3,159,119,154,4,5%
2017-02,הצפון,483,בענה,333,143,190,7,326,281,323,5,10%
2017-02,הצפון,1292,ג'דיידה-מכר,1074,482,592,4,1070,862,1055,15,12%
2017-02,הצפון,485,ג'ולס,192,53,139,3,189,122,192,1,7%
2017-02,הצפון,487,ג'ש (גוש חלב),54,24,30,8,46,23,53,0,3%
2017-02,הצפון,489,דבורייה,289,120,169,18,271,209,286,3,7%
2017-02,הצפון,490,דייר אל-אסד,311,139,172,14,297,257,306,6,6%
2017-02,הצפון,492,דייר חנא,598,259,339,6,592,456,591,4,12%
2017-02,הצפון,975,זרזיר,209,86,123,5,204,142,204,5,7%
2017-02,הצפון,496,חורפיש,95,40,55,6,89,53,93,2,4%
2017-02,הצפון,2034,חצור הגלילית,246,101,145,13,233,117,229,10,5%
2017-02,הצפון,6700,טבריה,1451,683,768,88,1363,701,1272,58,6%
2017-02,הצפון,962,טובא-זנגרייה,323,156,167,4,319,226,312,3,10%
2017-02,הצפון,498,טורעאן,382,176,206,5,377,319,370,4,7%
2017-02,הצפון,8900,טמרה,1303,606,697,18,1285,1102,1276,11,10%
2017-02,הצפון,1295,יאנוח-ג'ת,140,50,90,5,135,81,137,7,5%
2017-02,הצפון,46,יבנאל,105,54,51,6,99,60,86,4,6%
2017-02,הצפון,499,יפיע,547,246,301,21,526,401,542,2,7%
2017-02,הצפון,240,יקנעם עילית,410,173,237,65,345,108,403,29,4%
2017-02,הצפון,502,ירכא,414,159,255,1,413,319,410,3,7%
2017-02,הצפון,504,כאבול,451,217,234,6,445,387,440,2,9%
2017-02,הצפון,505,כאוכב אבו אל-היג'א,205,91,114,2,203,169,203,0,12%
2017-02,הצפון,1296,כסרא-סמיע,208,80,128,7,201,125,194,5,6%
2017-02,הצפון,978,כעביה-טבאש-חג'אג'רה,158,61,97,0,158,112,153,3,7%
2017-02,הצפון,1263,כפר ורדים,63,29,34,29,34,7,62,0,2%
2017-02,הצפון,507,כפר יאסיף,402,165,237,8,394,271,394,4,8%
2017-02,הצפון,508,כפר כמא,54,20,34,4,50,24,53,0,3%
2017-02,הצפון,509,כפר כנא,771,373,398,25,746,633,737,15,9%
2017-02,הצפון,510,כפר מנדא,684,346,338,7,677,520,677,4,10%
2017-02,הצפון,47,כפר תבור,37,12,25,15,22,2,36,0,2%
2017-02,הצפון,1139,כרמיאל,1400,573,827,278,1122,668,1290,48,5%
2017-02,הצפון,481,מגאר,1243,532,711,23,1220,1007,1204,24,13%
2017-02,הצפון,516,מג'ד אל-כרום,472,214,258,10,462,334,453,14,7%
2017-02,הצפון,874,מגדל העמק,715,320,395,73,642,285,669,67,5%
2017-02,הצפון,4201,מג'דל שמס,425,168,257,8,417,311,401,4,9%
2017-02,הצפון,517,מזרעה,152,73,79,2,150,113,149,4,8%
2017-02,הצפון,4203,מסעדה,191,67,124,3,188,153,175,4,11%
2017-02,הצפון,518,מעיליא,61,35,26,7,54,18,61,1,4%
2017-02,הצפון,1063,מעלות-תרשיחא,783,385,398,80,703,382,746,38,6%
2017-02,הצפון,520,משהד,194,91,103,4,190,162,187,4,6%
2017-02,הצפון,9100,נהרייה,1720,837,883,161,1559,931,1617,65,5%
2017-02,הצפון,522,נחף,372,167,205,15,357,295,362,8,7%
2017-02,הצפון,7300,נצרת,2694,1176,1518,126,2568,2007,2660,23,8%
2017-02,הצפון,1061,נצרת עילית,1324,607,717,137,1187,640,1180,60,5%
2017-02,הצפון,525,סאג'ור,94,35,59,6,88,71,93,0,5%
2017-02,הצפון,7500,סח'נין,1887,851,1036,43,1844,1535,1865,13,14%
2017-02,הצפון,4501,ע'ג'ר,91,29,62,1,90,62,90,0,9%
2017-02,הצפון,530,עיילבון,165,77,88,10,155,101,161,2,6%
2017-02,הצפון,511,עילוט,267,109,158,6,261,213,265,1,10%
2017-02,הצפון,532,עין מאהל,386,196,190,11,375,293,374,2,7%
2017-02,הצפון,7600,עכו,2752,1258,1494,144,2608,1999,2646,41,10%
2017-02,הצפון,7700,עפולה,1405,608,797,166,1239,558,1337,78,5%
2017-02,הצפון,531,עראבה,1396,588,808,33,1363,1198,1372,12,14%
2017-02,הצפון,535,פסוטה,80,39,41,7,73,46,76,2,5%
2017-02,הצפון,536,פקיעין (בוקייעה),129,72,57,4,125,81,124,3,5%
2017-02,הצפון,8000,צפת,997,521,476,101,896,662,922,22,7%
2017-02,הצפון,4100,קצרין,176,75,101,23,153,82,172,5,4%
2017-02,הצפון,2800,קריית שמונה,718,362,356,80,638,283,692,36,5%
2017-02,הצפון,543,ראמה,250,95,155,23,227,173,240,3,6%
2017-02,הצפון,26,ראש פינה,42,18,24,6,36,19,39,1,2%
2017-02,הצפון,542,ריינה,464,212,252,9,455,363,447,6,7%
2017-02,הצפון,122,רמת ישי,78,32,46,35,43,9,75,0,2%
2017-02,הצפון,913,שבלי - אום אל-גנם,194,86,108,6,188,123,190,7,7%
2017-02,הצפון,812,שלומי,216,81,135,24,192,110,206,3,6%
2017-02,הצפון,538,שעב,455,195,260,6,449,384,450,1,15%
2017-02,הצפון,8800,שפרעם,1427,580,847,47,1380,1128,1387,33,8%
2017-02,חיפה,2710,אום אל-פחם,2694,1125,1569,28,2666,2220,2648,33,13%
2017-02,חיפה,1020,אור עקיבא,432,185,247,48,384,117,419,21,4%
2017-02,חיפה,6000,באקה אל-גרביה,530,245,285,7,523,328,528,38,5%
2017-02,חיפה,9800,בנימינה-גבעת עדה*,181,82,99,62,119,38,181,5,3%
2017-02,חיפה,1326,"בסמ""ה",355,156,199,5,350,275,351,2,9%
2017-02,חיפה,541,ג'סר א-זרקא,234,130,104,1,233,131,231,12,4%
2017-02,חיפה,628,ג'ת,197,100,97,10,187,113,194,7,4%
2017-02,חיפה,494,דאלית אל-כרמל,454,178,276,21,433,246,420,8,5%
2017-02,חיפה,9300,זכרון יעקב,263,123,140,102,161,32,259,5,2%
2017-02,חיפה,6500,חדרה,2053,940,1113,258,1795,686,1945,59,4%
2017-02,חיפה,4000,חיפה,5400,2622,2778,1162,4238,2607,5063,146,4%
2017-02,חיפה,1247,חריש,84,30,54,18,66,16,76,0,5%
2017-02,חיפה,2100,טירת כרמל,637,310,327,36,601,315,623,22,6%
2017-02,חיפה,654,כפר קרע,398,185,213,14,384,242,392,16,5%
2017-02,חיפה,1327,מעלה עירון,658,261,397,4,654,532,649,10,12%
2017-02,חיפה,2500,נשר,373,173,200,79,294,130,355,13,3%
2017-02,חיפה,534,עספיא,299,133,166,15,284,151,276,5,5%
2017-02,חיפה,637,ערערה,481,218,263,10,471,326,467,20,6%
2017-02,חיפה,537,פוריידיס,259,149,110,6,253,124,257,8,5%
2017-02,חיפה,7800,פרדס חנה-כרכור,707,310,397,180,527,153,696,26,4%
2017-02,חיפה,6800,קריית אתא,1358,625,733,101,1257,665,1319,35,4%
2017-02,חיפה,9500,קריית ביאליק,915,413,502,115,800,398,885,33,4%
2017-02,חיפה,2300,קריית טבעון,179,77,102,82,97,29,174,0,2%
2017-02,חיפה,9600,קריית ים,1234,574,660,108,1126,669,1187,40,6%
2017-02,חיפה,8200,קריית מוצקין,853,357,496,141,712,345,828,24,4%
2017-02,חיפה,922,רכסים,144,72,72,10,134,77,130,4,4%
2017-02,ירושלים,472,אבו גוש,232,126,106,8,224,171,229,1,8%
2017-02,ירושלים,2610,בית שמש,1134,475,659,97,1037,426,1081,41,3%
2017-02,ירושלים,3000,ירושלים,11052,5026,6026,1314,9738,6832,10738,156,4%
2017-02,ירושלים,1015,מבשרת ציון,319,158,161,68,251,111,311,4,2%
2017-02,ירושלים,1137,קריית יערים,42,22,20,8,34,15,42,0,3%
2017-02,תל אביב,2400,אור יהודה,582,289,293,61,521,134,563,30,3%
2017-02,תל אביב,565,אזור,168,91,77,32,136,26,166,0,3%
2017-02,תל אביב,6100,בני ברק,1546,793,753,79,1467,657,1429,20,3%
2017-02,תל אביב,6200,בת ים,2543,1237,1306,358,2185,850,2404,80,3%
2017-02,תל אביב,6300,גבעתיים,690,313,377,329,361,68,688,8,2%
2017-02,תל אביב,6400,הרצלייה,1013,461,552,371,642,31,1007,7,2%
2017-02,תל אביב,6600,חולון,2764,1233,1531,463,2301,619,2692,66,3%
2017-02,תל אביב,2620,קריית אונו,380,159,221,175,205,32,375,4,2%
2017-02,תל אביב,8600,רמת גן,1899,889,1010,662,1237,309,1858,32,2%
2017-02,תל אביב,2650,רמת השרון,369,148,221,175,194,11,367,5,2%
2017-02,תל אביב,5000,תל אביב -יפו,6943,3506,3437,2570,4373,1540,6811,106,3%
2017-03,אזור יהודה והשומרון,3760,אורנית,80,37,43,31,49,4,80,0,2%
2017-03,אזור יהודה והשומרון,3750,אלפי מנשה,89,31,58,30,59,1,88,2,2%
2017-03,אזור יהודה והשומרון,3560,אלקנה,29,13,16,16,13,0,29,0,2%
2017-03,אזור יהודה והשומרון,3650,אפרת,110,62,48,56,54,4,110,1,3%
2017-03,אזור יהודה והשומרון,3570,אריאל,277,126,151,65,212,22,272,18,3%
2017-03,אזור יהודה והשומרון,3574,בית אל,56,25,31,20,36,15,56,0,2%
2017-03,אזור יהודה והשומרון,3652,בית אריה,53,28,25,13,40,1,53,1,2%
2017-03,אזור יהודה והשומרון,3780,ביתר עילית,459,208,251,13,446,154,451,2,4%
2017-03,אזור יהודה והשומרון,3730,גבעת זאב,176,81,95,43,133,33,174,1,2%
2017-03,אזור יהודה והשומרון,3769,הר אדר,28,10,18,15,13,2,28,0,1%
2017-03,אזור יהודה והשומרון,3797,מודיעין עילית,382,118,264,23,359,28,377,7,3%
2017-03,אזור יהודה והשומרון,3616,מעלה אדומים,559,245,314,85,474,165,552,17,3%
2017-03,אזור יהודה והשומרון,3660,עמנואל,40,22,18,2,38,23,40,0,4%
2017-03,אזור יהודה והשומרון,3557,קדומים,30,17,13,12,18,3,29,0,2%
2017-03,אזור יהודה והשומרון,3611,קריית ארבע,89,51,38,21,68,41,87,4,3%
2017-03,אזור יהודה והשומרון,3640,קרני שומרון,68,40,28,18,50,5,68,1,2%
2017-03,הדרום,31,אופקים,789,366,423,49,740,451,761,35,6%
2017-03,הדרום,2600,אילת,1075,538,537,65,1010,352,1010,56,3%
2017-03,הדרום,70,אשדוד,5019,2096,2923,632,4387,2270,4752,126,4%
2017-03,הדרום,7100,אשקלון,3431,1473,1958,380,3051,1644,3020,68,4%
2017-03,הדרום,9000,באר שבע,5271,2449,2822,682,4589,2845,4977,121,5%
2017-03,הדרום,2200,דימונה,1610,750,860,95,1515,1107,1516,40,8%
2017-03,הדרום,1303,חורה,541,230,311,7,534,458,521,7,14%
2017-03,הדרום,831,ירוחם,367,179,188,19,348,216,341,19,8%
2017-03,הדרום,1059,כסיפה,984,394,590,4,980,868,970,2,21%
2017-03,הדרום,1271,להבים,51,16,35,28,23,4,51,1,1%
2017-03,הדרום,1060,לקיה,633,280,353,9,624,547,612,4,16%
2017-03,הדרום,1268,מיתר,74,28,46,29,45,4,72,1,2%
2017-03,הדרום,99,מצפה רמון,236,90,146,18,218,151,224,17,9%
2017-03,הדרום,246,נתיבות,849,377,472,49,800,396,797,56,6%
2017-03,הדרום,666,עומר,61,21,40,29,32,3,60,0,1%
2017-03,הדרום,2560,ערד,680,321,359,63,617,330,648,28,5%
2017-03,הדרום,1192,ערערה-בנגב,1071,457,614,4,1067,960,1051,2,25%
2017-03,הדרום,2630,קריית גת,1501,622,879,79,1422,688,1428,47,5%
2017-03,הדרום,1034,קריית מלאכי,692,316,376,25,667,280,669,37,6%
2017-03,הדרום,1161,רהט,2236,905,1331,14,2222,1822,2212,90,12%
2017-03,הדרום,1286,שגב-שלום,339,135,204,4,335,284,325,2,13%
2017-03,הדרום,1031,שדרות,884,408,476,57,827,484,811,27,6%
2017-03,הדרום,1054,תל שבע,728,321,407,1,727,635,702,7,16%
2017-03,המרכז,182,אבן יהודה,168,81,87,53,115,19,166,0,2%
2017-03,המרכז,41,אליכין,56,33,23,7,49,17,52,1,3%
2017-03,המרכז,1309,אלעד,294,115,179,23,271,31,287,2,2%
2017-03,המרכז,2530,באר יעקב,235,96,139,71,164,41,232,7,3%
2017-03,המרכז,466,בית דגן,102,56,46,11,91,29,100,1,3%
2017-03,המרכז,1066,"בני עי""ש",125,63,62,18,107,41,122,2,3%
2017-03,המרכז,681,גבעת שמואל,257,136,121,81,176,36,250,1,2%
2017-03,המרכז,2550,גדרה,294,124,170,47,247,76,283,3,2%
2017-03,המרכז,627,ג'לג'וליה,72,35,37,2,70,40,69,1,2%
2017-03,המרכז,166,גן יבנה,321,134,187,47,274,63,311,7,3%
2017-03,המרכז,229,גני תקווה,212,101,111,82,130,26,210,0,3%
2017-03,המרכז,9700,הוד השרון,625,270,355,296,329,27,618,7,2%
2017-03,המרכז,1290,זמר,118,45,73,3,115,75,116,10,4%
2017-03,המרכז,2730,טייבה,1060,501,559,38,1022,755,906,27,5%
2017-03,המרכז,2720,טירה,184,90,94,13,171,57,178,16,2%
2017-03,המרכז,2660,יבנה,684,329,355,137,547,170,673,20,3%
2017-03,המרכז,9400,יהוד,345,152,193,85,260,37,338,4,2%
2017-03,המרכז,1224,כוכב יאיר,79,42,37,48,31,1,79,1,1%
2017-03,המרכז,633,כפר ברא,10,5,5,2,8,7,9,0,1%
2017-03,המרכז,168,כפר יונה,288,133,155,62,226,48,287,9,3%
2017-03,המרכז,6900,כפר סבא,1046,489,557,428,618,85,1029,16,2%
2017-03,המרכז,634,כפר קאסם,223,92,131,11,212,109,216,3,2%
2017-03,המרכז,7000,לוד,1683,826,857,137,1546,875,1646,54,5%
2017-03,המרכז,1200,מודיעין-מכבים-רעות*,811,366,445,342,469,47,799,22,2%
2017-03,המרכז,28,מזכרת בתיה,150,55,95,50,100,18,148,0,2%
2017-03,המרכז,7200,נס ציונה,621,302,319,157,464,155,611,13,3%
2017-03,המרכז,7400,נתניה,3752,1848,1904,475,3277,1214,3671,86,4%
2017-03,המרכז,587,סביון*,14,4,10,8,6,1,14,0,1%
2017-03,המרכז,171,פרדסייה,76,38,38,28,48,8,75,0,2%
2017-03,המרכז,7900,פתח תקווה,3510,1621,1889,777,2733,821,3416,41,3%
2017-03,המרכז,195,קדימה-צורן,255,114,141,77,178,38,253,1,2%
2017-03,המרכז,638,קלנסווה,358,190,168,9,349,249,320,14,4%
2017-03,המרכז,469,קריית עקרון,218,101,117,27,191,93,209,6,4%
2017-03,המרכז,2640,ראש העין,719,336,383,132,587,121,711,14,3%
2017-03,המרכז,8300,ראשון לציון,3865,1687,2178,767,3098,935,3824,65,3%
2017-03,המרכז,8400,רחובות,2090,923,1167,525,1565,674,2008,44,3%
2017-03,המרכז,8500,רמלה,1438,691,747,125,1313,570,1381,55,4%
2017-03,המרכז,8700,רעננה,656,296,360,283,373,41,646,8,2%
2017-03,המרכז,1304,שוהם,163,65,98,77,86,7,162,1,1%
2017-03,המרכז,154,תל מונד,144,71,73,52,92,15,144,0,2%
2017-03,הצפון,473,אבו סנאן,547,227,320,4,543,429,539,11,10%
2017-03,הצפון,478,אכסאל,435,190,245,12,423,375,429,4,8%
2017-03,הצפון,529,אעבלין,423,176,247,12,411,342,417,10,8%
2017-03,הצפון,482,בועיינה-נוג'ידאת,291,131,160,6,285,216,285,3,8%
2017-03,הצפון,4001,בוקעאתא,408,152,256,6,402,303,393,9,14%
2017-03,הצפון,998,ביר אל-מכסור,322,144,178,6,316,236,317,2,9%
2017-03,הצפון,480,בית ג'ן,394,112,282,7,387,248,376,6,7%
2017-03,הצפון,9200,בית שאן,669,297,372,28,641,309,646,51,7%
2017-03,הצפון,944,בסמת טבעון,169,77,92,2,167,118,160,4,5%
2017-03,הצפון,483,בענה,337,145,192,6,331,284,325,5,10%
2017-03,הצפון,1292,ג'דיידה-מכר,1065,474,591,3,1062,846,1043,11,12%
2017-03,הצפון,485,ג'ולס,178,49,129,2,176,118,178,3,6%
2017-03,הצפון,487,ג'ש (גוש חלב),50,24,26,4,46,22,50,1,3%
2017-03,הצפון,489,דבורייה,299,124,175,16,283,214,294,4,7%
2017-03,הצפון,490,דייר אל-אסד,316,143,173,15,301,259,309,9,6%
2017-03,הצפון,492,דייר חנא,596,258,338,12,584,449,588,6,12%
2017-03,הצפון,975,זרזיר,212,88,124,4,208,139,208,6,7%
2017-03,הצפון,496,חורפיש,88,39,49,6,82,52,86,1,3%
2017-03,הצפון,2034,חצור הגלילית,240,96,144,15,225,118,223,6,5%
2017-03,הצפון,6700,טבריה,1376,656,720,75,1301,693,1181,64,6%
2017-03,הצפון,962,טובא-זנגרייה,312,153,159,3,309,214,302,6,10%
2017-03,הצפון,498,טורעאן,369,159,210,5,364,305,359,10,7%
2017-03,הצפון,8900,טמרה,1270,589,681,18,1252,1070,1241,11,9%
2017-03,הצפון,1295,יאנוח-ג'ת,146,49,97,7,139,82,142,3,5%
2017-03,הצפון,46,יבנאל,102,52,50,7,95,60,80,2,5%
2017-03,הצפון,499,יפיע,544,248,296,24,520,394,540,4,7%
2017-03,הצפון,240,יקנעם עילית,406,171,235,64,342,103,396,32,3%
2017-03,הצפון,502,ירכא,397,151,246,2,395,306,395,3,7%
2017-03,הצפון,504,כאבול,450,220,230,5,445,377,438,2,9%
2017-03,הצפון,505,כאוכב אבו אל-היג'א,205,90,115,2,203,166,204,4,12%
2017-03,הצפון,1296,כסרא-סמיע,214,74,140,5,209,125,200,3,6%
2017-03,הצפון,978,כעביה-טבאש-חג'אג'רה,156,60,96,1,155,105,151,2,7%
2017-03,הצפון,1263,כפר ורדים,56,27,29,25,31,6,54,0,2%
2017-03,הצפון,507,כפר יאסיף,384,163,221,9,375,254,379,6,7%
2017-03,הצפון,508,כפר כמא,50,19,31,5,45,23,49,1,3%
2017-03,הצפון,509,כפר כנא,764,374,390,23,741,621,730,12,9%
2017-03,הצפון,510,כפר מנדא,676,344,332,9,667,510,669,3,9%
2017-03,הצפון,47,כפר תבור,47,16,31,20,27,2,44,1,2%
2017-03,הצפון,1139,כרמיאל,1366,577,789,269,1097,671,1259,39,5%
2017-03,הצפון,481,מגאר,1221,517,704,24,1197,979,1181,20,13%
2017-03,הצפון,516,מג'ד אל-כרום,476,217,259,11,465,338,454,14,7%
2017-03,הצפון,874,מגדל העמק,706,310,396,75,631,281,648,58,5%
2017-03,הצפון,4201,מג'דל שמס,433,176,257,11,422,319,412,2,9%
2017-03,הצפון,517,מזרעה,157,72,85,2,155,115,150,4,8%
2017-03,הצפון,4203,מסעדה,190,73,117,3,187,145,178,0,11%
2017-03,הצפון,518,מעיליא,63,33,30,9,54,21,60,4,4%
2017-03,הצפון,1063,מעלות-תרשיחא,737,370,367,83,654,370,704,36,6%
2017-03,הצפון,520,משהד,193,91,102,3,190,148,186,5,6%
2017-03,הצפון,9100,נהרייה,1694,815,879,157,1537,924,1594,71,5%
2017-03,הצפון,522,נחף,371,178,193,17,354,287,357,3,7%
2017-03,הצפון,7300,נצרת,2653,1164,1489,120,2533,1981,2629,21,8%
2017-03,הצפון,1061,נצרת עילית,1348,599,749,146,1202,664,1183,85,5%
2017-03,הצפון,525,סאג'ור,107,39,68,6,101,72,105,2,6%
2017-03,הצפון,7500,סח'נין,1837,830,1007,42,1795,1490,1816,23,13%
2017-03,הצפון,4501,ע'ג'ר,90,28,62,1,89,62,89,1,9%
2017-03,הצפון,530,עיילבון,154,70,84,10,144,93,150,3,6%
2017-03,הצפון,511,עילוט,254,102,152,3,251,202,253,4,9%
2017-03,הצפון,532,עין מאהל,386,200,186,14,372,288,376,3,7%
2017-03,הצפון,7600,עכו,2752,1268,1484,154,2598,1977,2662,33,10%
2017-03,הצפון,7700,עפולה,1401,584,817,174,1227,557,1334,63,5%
2017-03,הצפון,531,עראבה,1362,576,786,35,1327,1160,1341,9,14%
2017-03,הצפון,535,פסוטה,86,44,42,11,75,44,83,3,5%
2017-03,הצפון,536,פקיעין (בוקייעה),126,73,53,4,122,79,119,5,4%
2017-03,הצפון,8000,צפת,943,496,447,104,839,637,868,15,7%
2017-03,הצפון,4100,קצרין,185,76,109,25,160,87,181,6,5%
2017-03,הצפון,2800,קריית שמונה,679,347,332,74,605,289,653,37,5%
2017-03,הצפון,543,ראמה,246,92,154,18,228,169,238,4,6%
2017-03,הצפון,26,ראש פינה,38,17,21,4,34,18,37,1,2%
2017-03,הצפון,542,ריינה,450,211,239,9,441,344,439,10,7%
2017-03,הצפון,122,רמת ישי,84,37,47,30,54,12,80,1,2%
2017-03,הצפון,913,שבלי - אום אל-גנם,190,82,108,4,186,119,185,6,7%
2017-03,הצפון,812,שלומי,213,78,135,23,190,106,205,4,6%
2017-03,הצפון,538,שעב,454,201,253,6,448,377,448,1,15%
2017-03,הצפון,8800,שפרעם,1381,570,811,55,1326,1093,1343,33,8%
2017-03,חיפה,2710,אום אל-פחם,2643,1121,1522,25,2618,2167,2593,40,13%
2017-03,חיפה,1020,אור עקיבא,417,181,236,41,376,113,399,18,4%
2017-03,חיפה,6000,באקה אל-גרביה,521,254,267,8,513,329,519,21,5%
2017-03,חיפה,9800,בנימינה-גבעת עדה*,174,77,97,67,107,34,173,1,2%
2017-03,חיפה,1326,"בסמ""ה",340,154,186,5,335,262,334,8,9%
2017-03,חיפה,541,ג'סר א-זרקא,220,132,88,1,219,118,220,14,4%
2017-03,חיפה,628,ג'ת,187,98,89,9,178,113,185,5,4%
2017-03,חיפה,494,דאלית אל-כרמל,450,174,276,24,426,238,416,4,5%
2017-03,חיפה,9300,זכרון יעקב,262,125,137,102,160,36,258,1,2%
2017-03,חיפה,6500,חדרה,2023,910,1113,247,1776,679,1909,40,4%
2017-03,חיפה,4000,חיפה,5306,2558,2748,1148,4158,2555,4982,147,4%
2017-03,חיפה,1247,חריש,96,26,70,20,76,18,86,0,6%
2017-03,חיפה,2100,טירת כרמל,629,313,316,36,593,325,612,24,6%
2017-03,חיפה,654,כפר קרע,395,180,215,16,379,241,388,16,5%
2017-03,חיפה,1327,מעלה עירון,650,250,400,3,647,520,638,9,11%
2017-03,חיפה,2500,נשר,390,194,196,74,316,144,370,5,3%
2017-03,חיפה,534,עספיא,293,126,167,17,276,145,274,10,5%
2017-03,חיפה,637,ערערה,480,218,262,10,470,324,465,17,6%
2017-03,חיפה,537,פוריידיס,244,143,101,3,241,124,243,5,5%
2017-03,חיפה,7800,פרדס חנה-כרכור,712,318,394,177,535,137,705,32,4%
2017-03,חיפה,6800,קריית אתא,1342,625,717,96,1246,656,1306,20,4%
2017-03,חיפה,9500,קריית ביאליק,915,408,507,116,799,389,888,30,4%
2017-03,חיפה,2300,קריית טבעון,161,64,97,76,85,29,159,2,2%
2017-03,חיפה,9600,קריית ים,1215,547,668,114,1101,668,1164,29,6%
2017-03,חיפה,8200,קריית מוצקין,838,344,494,127,711,347,806,31,4%
2017-03,חיפה,922,רכסים,137,64,73,10,127,77,120,3,4%
2017-03,ירושלים,472,אבו גוש,225,115,110,7,218,166,221,2,7%
2017-03,ירושלים,2610,בית שמש,1043,443,600,92,951,415,987,28,3%
2017-03,ירושלים,3000,ירושלים,11092,5016,6076,1276,9816,6794,10783,159,4%
2017-03,ירושלים,1015,מבשרת ציון,295,142,153,66,229,112,287,2,2%
2017-03,ירושלים,1137,קריית יערים,39,21,18,6,33,13,39,0,3%
2017-03,תל אביב,2400,אור יהודה,561,270,291,62,499,129,539,27,3%
2017-03,תל אביב,565,אזור,164,90,74,23,141,27,162,1,3%
2017-03,תל אביב,6100,בני ברק,1497,760,737,77,1420,628,1376,22,3%
2017-03,תל אביב,6200,בת ים,2491,1227,1264,379,2112,825,2364,78,3%
2017-03,תל אביב,6300,גבעתיים,661,303,358,324,337,60,657,5,2%
2017-03,תל אביב,6400,הרצלייה,1032,470,562,392,640,31,1021,11,2%
2017-03,תל אביב,6600,חולון,2744,1225,1519,474,2270,609,2669,55,3%
2017-03,תל אביב,2620,קריית אונו,381,157,224,176,205,35,375,3,2%
2017-03,תל אביב,8600,רמת גן,1898,899,999,682,1216,284,1861,22,2%
2017-03,תל אביב,2650,רמת השרון,383,154,229,175,208,12,377,1,2%
2017-03,תל אביב,5000,תל אביב -יפו,6964,3510,3454,2575,4389,1512,6822,103,3%
2017-04,אזור יהודה והשומרון,3760,אורנית,79,33,46,31,48,2,79,1,2%
2017-04,אזור יהודה והשומרון,3750,אלפי מנשה,83,28,55,26,57,1,83,0,2%
2017-04,אזור יהודה והשומרון,3560,אלקנה,30,15,15,18,12,0,30,1,2%
2017-04,אזור יהודה והשומרון,3650,אפרת,124,76,48,64,60,0,120,1,3%
2017-04,אזור יהודה והשומרון,3570,אריאל,261,122,139,65,196,21,259,10,2%
2017-04,אזור יהודה והשומרון,3574,בית אל,52,24,28,21,31,12,51,1,2%
2017-04,אזור יהודה והשומרון,3652,בית אריה,53,29,24,12,41,0,52,0,2%
2017-04,אזור יהודה והשומרון,3780,ביתר עילית,421,196,225,12,409,146,418,2,3%
2017-04,אזור יהודה והשומרון,3730,גבעת זאב,162,76,86,36,126,29,162,3,2%
2017-04,אזור יהודה והשומרון,3769,הר אדר,24,8,16,14,10,3,24,0,1%
2017-04,אזור יהודה והשומרון,3797,מודיעין עילית,373,113,260,23,350,26,371,1,3%
2017-04,אזור יהודה והשומרון,3616,מעלה אדומים,528,232,296,72,456,148,518,11,3%
2017-04,אזור יהודה והשומרון,3660,עמנואל,40,24,16,2,38,23,40,0,4%
2017-04,אזור יהודה והשומרון,3557,קדומים,27,13,14,10,17,4,26,0,1%
2017-04,אזור יהודה והשומרון,3611,קריית ארבע,94,52,42,23,71,41,90,2,3%
2017-04,אזור יהודה והשומרון,3640,קרני שומרון,64,33,31,21,43,5,64,0,2%
2017-04,הדרום,31,אופקים,774,345,429,48,726,438,741,20,6%
2017-04,הדרום,2600,אילת,892,465,427,63,829,328,834,30,3%
2017-04,הדרום,70,אשדוד,4751,2009,2742,598,4153,2165,4509,70,4%
2017-04,הדרום,7100,אשקלון,3301,1418,1883,377,2924,1550,2933,39,4%
2017-04,הדרום,9000,באר שבע,5016,2329,2687,688,4328,2715,4765,58,5%
2017-04,הדרום,2200,דימונה,1578,745,833,89,1489,1072,1493,35,8%
2017-04,הדרום,1303,חורה,514,212,302,6,508,438,501,3,13%
2017-04,הדרום,831,ירוחם,345,161,184,18,327,207,322,7,7%
2017-04,הדרום,1059,כסיפה,955,372,583,3,952,862,945,1,21%
2017-04,הדרום,1271,להבים,46,13,33,21,25,5,46,0,1%
2017-04,הדרום,1060,לקיה,614,272,342,8,606,533,595,4,15%
2017-04,הדרום,1268,מיתר,67,24,43,31,36,3,66,0,2%
2017-04,הדרום,99,מצפה רמון,230,89,141,15,215,147,219,8,9%
2017-04,הדרום,246,נתיבות,829,371,458,44,785,398,774,29,6%
2017-04,הדרום,666,עומר,60,20,40,27,33,3,59,0,1%
2017-04,הדרום,2560,ערד,630,289,341,61,569,328,597,19,5%
2017-04,הדרום,1192,ערערה-בנגב,1068,450,618,4,1064,962,1053,2,25%
2017-04,הדרום,2630,קריית גת,1459,609,850,80,1379,677,1405,31,5%
2017-04,הדרום,1034,קריית מלאכי,643,278,365,23,620,281,618,26,6%
2017-04,הדרום,1161,רהט,2135,845,1290,9,2126,1743,2107,53,12%
2017-04,הדרום,1286,שגב-שלום,319,126,193,4,315,265,306,4,13%
2017-04,הדרום,1031,שדרות,880,404,476,61,819,470,817,7,7%
2017-04,הדרום,1054,תל שבע,690,302,388,1,689,614,655,4,15%
2017-04,המרכז,182,אבן יהודה,156,70,86,52,104,21,155,0,2%
2017-04,המרכז,41,אליכין,54,28,26,6,48,16,51,1,3%
2017-04,המרכז,1309,אלעד,290,118,172,16,274,29,284,0,2%
2017-04,המרכז,2530,באר יעקב,212,83,129,69,143,36,208,2,2%
2017-04,המרכז,466,בית דגן,89,47,42,11,78,27,87,1,2%
2017-04,המרכז,1066,"בני עי""ש",121,59,62,19,102,38,119,2,3%
2017-04,המרכז,681,גבעת שמואל,241,129,112,81,160,33,237,0,2%
2017-04,המרכז,2550,גדרה,282,119,163,46,236,71,275,2,2%
2017-04,המרכז,627,ג'לג'וליה,69,32,37,2,67,37,65,1,2%
2017-04,המרכז,166,גן יבנה,296,126,170,42,254,61,290,2,3%
2017-04,המרכז,229,גני תקווה,211,110,101,83,128,26,208,0,3%
2017-04,המרכז,9700,הוד השרון,618,262,356,302,316,27,612,5,2%
2017-04,המרכז,1290,זמר,112,39,73,1,111,75,111,2,4%
2017-04,המרכז,2730,טייבה,984,461,523,29,955,713,836,26,5%
2017-04,המרכז,2720,טירה,155,81,74,11,144,54,154,4,1%
2017-04,המרכז,2660,יבנה,644,301,343,129,515,162,630,17,3%
2017-04,המרכז,9400,יהוד,330,144,186,86,244,32,320,4,2%
2017-04,המרכז,1224,כוכב יאיר,70,34,36,41,29,0,70,0,1%
2017-04,המרכז,633,כפר ברא,10,6,4,2,8,5,10,0,1%
2017-04,המרכז,168,כפר יונה,265,122,143,57,208,45,263,3,2%
2017-04,המרכז,6900,כפר סבא,981,443,538,418,563,78,969,14,2%
2017-04,המרכז,634,כפר קאסם,206,81,125,11,195,103,196,2,2%
2017-04,המרכז,7000,לוד,1549,768,781,130,1419,819,1510,25,4%
2017-04,המרכז,1200,מודיעין-מכבים-רעות*,764,330,434,340,424,41,757,10,2%
2017-04,המרכז,28,מזכרת בתיה,151,61,90,47,104,16,150,2,2%
2017-04,המרכז,7200,נס ציונה,623,304,319,171,452,149,612,4,3%
2017-04,המרכז,7400,נתניה,3579,1756,1823,458,3121,1143,3504,60,3%
2017-04,המרכז,587,סביון*,15,4,11,8,7,0,15,0,1%
2017-04,המרכז,171,פרדסייה,74,38,36,26,48,7,74,1,2%
2017-04,המרכז,7900,פתח תקווה,3334,1521,1813,739,2595,780,3260,26,3%
2017-04,המרכז,195,קדימה-צורן,233,101,132,70,163,34,231,1,2%
2017-04,המרכז,638,קלנסווה,337,178,159,12,325,237,305,4,4%
2017-04,המרכז,469,קריית עקרון,212,94,118,27,185,87,204,7,4%
2017-04,המרכז,2640,ראש העין,698,335,363,127,571,118,692,6,3%
2017-04,המרכז,8300,ראשון לציון,3773,1659,2114,792,2981,909,3736,27,3%
2017-04,המרכז,8400,רחובות,2004,893,1111,520,1484,648,1940,35,3%
2017-04,המרכז,8500,רמלה,1328,644,684,124,1204,523,1281,37,4%
2017-04,המרכז,8700,רעננה,641,297,344,278,363,41,628,2,2%
2017-04,המרכז,1304,שוהם,167,69,98,74,93,9,167,0,2%
2017-04,המרכז,154,תל מונד,144,78,66,49,95,18,144,1,2%
2017-04,הצפון,473,אבו סנאן,524,217,307,3,521,423,515,7,9%
2017-04,הצפון,478,אכסאל,422,182,240,12,410,364,418,4,8%
2017-04,הצפון,529,אעבלין,411,173,238,9,402,337,407,12,7%
2017-04,הצפון,482,בועיינה-נוג'ידאת,269,127,142,8,261,198,265,5,7%
2017-04,הצפון,4001,בוקעאתא,398,152,246,7,391,303,380,4,14%
2017-04,הצפון,998,ביר אל-מכסור,288,125,163,2,286,219,283,1,8%
2017-04,הצפון,480,בית ג'ן,366,93,273,3,363,243,348,1,7%
2017-04,הצפון,9200,בית שאן,635,266,369,26,609,305,613,37,6%
2017-04,הצפון,944,בסמת טבעון,150,67,83,1,149,104,143,1,5%
2017-04,הצפון,483,בענה,321,143,178,5,316,269,314,7,10%
2017-04,הצפון,1292,ג'דיידה-מכר,1020,473,547,4,1016,817,1004,8,11%
2017-04,הצפון,485,ג'ולס,162,45,117,3,159,109,162,0,6%
2017-04,הצפון,487,ג'ש (גוש חלב),47,23,24,4,43,20,47,0,3%
2017-04,הצפון,489,דבורייה,279,117,162,15,264,199,276,3,7%
2017-04,הצפון,490,דייר אל-אסד,312,136,176,16,296,260,303,8,6%
2017-04,הצפון,492,דייר חנא,572,246,326,14,558,426,566,6,12%
2017-04,הצפון,975,זרזיר,180,73,107,4,176,123,179,3,6%
2017-04,הצפון,496,חורפיש,79,36,43,5,74,46,76,0,3%
2017-04,הצפון,2034,חצור הגלילית,206,84,122,14,192,108,193,1,4%
2017-04,הצפון,6700,טבריה,1250,614,636,66,1184,669,1087,40,5%
2017-04,הצפון,962,טובא-זנגרייה,300,133,167,4,296,208,291,3,10%
2017-04,הצפון,498,טורעאן,353,158,195,5,348,291,344,7,6%
2017-04,הצפון,8900,טמרה,1241,581,660,18,1223,1054,1210,9,9%
2017-04,הצפון,1295,יאנוח-ג'ת,134,48,86,6,128,79,130,1,5%
2017-04,הצפון,46,יבנאל,109,57,52,7,102,68,86,3,6%
2017-04,הצפון,499,יפיע,524,235,289,26,498,383,520,3,7%
2017-04,הצפון,240,יקנעם עילית,365,157,208,66,299,97,361,16,3%
2017-04,הצפון,502,ירכא,383,145,238,3,380,294,380,2,7%
2017-04,הצפון,504,כאבול,430,212,218,4,426,362,423,1,9%
2017-04,הצפון,505,כאוכב אבו אל-היג'א,204,91,113,2,202,155,203,1,12%
2017-04,הצפון,1296,כסרא-סמיע,195,66,129,7,188,118,185,7,5%
2017-04,הצפון,978,כעביה-טבאש-חג'אג'רה,150,63,87,0,150,106,148,1,7%
2017-04,הצפון,1263,כפר ורדים,56,23,33,28,28,4,54,0,2%
2017-04,הצפון,507,כפר יאסיף,343,146,197,7,336,239,335,3,7%
2017-04,הצפון,508,כפר כמא,41,16,25,2,39,19,41,0,3%
2017-04,הצפון,509,כפר כנא,729,358,371,20,709,598,701,7,8%
2017-04,הצפון,510,כפר מנדא,653,336,317,9,644,491,647,5,9%
2017-04,הצפון,47,כפר תבור,41,16,25,18,23,2,39,0,2%
2017-04,הצפון,1139,כרמיאל,1325,565,760,263,1062,655,1227,34,5%
2017-04,הצפון,481,מגאר,1159,483,676,19,1140,932,1126,5,12%
2017-04,הצפון,516,מג'ד אל-כרום,433,201,232,9,424,325,415,7,7%
2017-04,הצפון,874,מגדל העמק,679,310,369,64,615,287,626,37,5%
2017-04,הצפון,4201,מג'דל שמס,410,167,243,9,401,299,394,1,8%
2017-04,הצפון,517,מזרעה,147,63,84,1,146,112,140,2,7%
2017-04,הצפון,4203,מסעדה,180,68,112,3,177,138,173,2,11%
2017-04,הצפון,518,מעיליא,58,33,25,9,49,21,54,1,3%
2017-04,הצפון,1063,מעלות-תרשיחא,686,348,338,83,603,356,655,19,6%
2017-04,הצפון,520,משהד,182,82,100,5,177,145,172,3,6%
2017-04,הצפון,9100,נהרייה,1588,778,810,159,1429,889,1493,38,5%
2017-04,הצפון,522,נחף,371,170,201,16,355,279,354,7,7%
2017-04,הצפון,7300,נצרת,2556,1128,1428,107,2449,1924,2526,18,7%
2017-04,הצפון,1061,נצרת עילית,1239,555,684,132,1107,622,1102,57,5%
2017-04,הצפון,525,סאג'ור,95,34,61,7,88,63,94,0,5%
2017-04,הצפון,7500,סח'נין,1748,784,964,40,1708,1435,1731,29,13%
2017-04,הצפון,4501,ע'ג'ר,86,23,63,1,85,59,85,0,8%
2017-04,הצפון,530,עיילבון,152,68,84,11,141,94,148,0,6%
2017-04,הצפון,511,עילוט,255,106,149,3,252,204,253,2,9%
2017-04,הצפון,532,עין מאהל,363,186,177,11,352,274,352,2,7%
2017-04,הצפון,7600,עכו,2634,1195,1439,148,2486,1912,2549,20,10%
2017-04,הצפון,7700,עפולה,1280,534,746,162,1118,518,1224,35,5%
2017-04,הצפון,531,עראבה,1262,538,724,33,1229,1083,1243,11,13%
2017-04,הצפון,535,פסוטה,77,34,43,9,68,42,74,1,4%
2017-04,הצפון,536,פקיעין (בוקייעה),113,63,50,6,107,73,107,1,4%
2017-04,הצפון,8000,צפת,910,478,432,98,812,618,849,8,7%
2017-04,הצפון,4100,קצרין,182,80,102,22,160,89,178,3,5%
2017-04,הצפון,2800,קריית שמונה,642,328,314,70,572,286,619,21,5%
2017-04,הצפון,543,ראמה,232,89,143,16,216,163,224,0,6%
2017-04,הצפון,26,ראש פינה,41,18,23,9,32,18,40,1,3%
2017-04,הצפון,542,ריינה,426,197,229,7,419,326,413,2,6%
2017-04,הצפון,122,רמת ישי,79,30,49,37,42,12,75,1,2%
2017-04,הצפון,913,שבלי - אום אל-גנם,170,67,103,7,163,116,167,0,7%
2017-04,הצפון,812,שלומי,205,79,126,22,183,102,198,4,6%
2017-04,הצפון,538,שעב,432,191,241,2,430,357,428,2,14%
2017-04,הצפון,8800,שפרעם,1328,564,764,50,1278,1050,1295,18,8%
2017-04,חיפה,2710,אום אל-פחם,2553,1070,1483,21,2532,2099,2514,26,13%
2017-04,חיפה,1020,אור עקיבא,377,162,215,40,337,105,364,17,4%
2017-04,חיפה,6000,באקה אל-גרביה,487,239,248,8,479,319,485,10,4%
2017-04,חיפה,9800,בנימינה-גבעת עדה*,166,74,92,61,105,35,163,2,2%
2017-04,חיפה,1326,"בסמ""ה",328,150,178,5,323,260,321,5,8%
2017-04,חיפה,541,ג'סר א-זרקא,204,120,84,1,203,112,202,9,4%
2017-04,חיפה,628,ג'ת,191,106,85,11,180,112,188,3,4%
2017-04,חיפה,494,דאלית אל-כרמל,415,169,246,20,395,227,384,5,5%
2017-04,חיפה,9300,זכרון יעקב,236,111,125,94,142,31,231,6,2%
2017-04,חיפה,6500,חדרה,1899,866,1033,234,1665,641,1788,21,4%
2017-04,חיפה,4000,חיפה,5026,2438,2588,1092,3934,2426,4725,104,3%
2017-04,חיפה,1247,חריש,98,32,66,18,80,16,88,1,6%
2017-04,חיפה,2100,טירת כרמל,597,294,303,36,561,305,584,13,6%
2017-04,חיפה,654,כפר קרע,379,168,211,16,363,233,373,10,5%
2017-04,חיפה,1327,מעלה עירון,621,245,376,5,616,500,610,7,11%
2017-04,חיפה,2500,נשר,372,180,192,73,299,132,357,7,3%
2017-04,חיפה,534,עספיא,274,117,157,15,259,144,257,4,5%
2017-04,חיפה,637,ערערה,468,207,261,9,459,320,457,2,6%
2017-04,חיפה,537,פוריידיס,192,114,78,5,187,105,191,8,4%
2017-04,חיפה,7800,פרדס חנה-כרכור,669,308,361,167,502,125,661,13,3%
2017-04,חיפה,6800,קריית אתא,1253,584,669,96,1157,606,1223,18,4%
2017-04,חיפה,9500,קריית ביאליק,836,364,472,110,726,351,815,19,4%
2017-04,חיפה,2300,קריית טבעון,151,61,90,75,76,27,150,0,2%
2017-04,חיפה,9600,קריית ים,1176,552,624,114,1062,639,1128,19,5%
2017-04,חיפה,8200,קריית מוצקין,785,322,463,122,663,337,758,13,3%
2017-04,חיפה,922,רכסים,118,59,59,8,110,61,107,0,3%
2017-04,ירושלים,472,אבו גוש,211,106,105,8,203,167,209,0,7%
2017-04,ירושלים,2610,בית שמש,969,420,549,87,882,376,933,15,3%
2017-04,ירושלים,3000,ירושלים,10500,4696,5804,1218,9282,6577,10229,89,3%
2017-04,ירושלים,1015,מבשרת ציון,280,135,145,61,219,106,273,2,2%
2017-04,ירושלים,1137,קריית יערים,37,19,18,7,30,12,37,0,3%
2017-04,תל אביב,2400,אור יהודה,538,260,278,57,481,128,520,17,3%
2017-04,תל אביב,565,אזור,154,84,70,23,131,25,152,2,2%
2017-04,תל אביב,6100,בני ברק,1467,729,738,83,1384,614,1347,9,2%
2017-04,תל אביב,6200,בת ים,2307,1131,1176,359,1948,792,2190,40,3%
2017-04,תל אביב,6300,גבעתיים,659,313,346,334,325,60,655,4,2%
2017-04,תל אביב,6400,הרצלייה,980,438,542,383,597,31,973,3,2%
2017-04,תל אביב,6600,חולון,2626,1177,1449,455,2171,572,2564,40,3%
2017-04,תל אביב,2620,קריית אונו,388,176,212,182,206,30,384,1,2%
2017-04,תל אביב,8600,רמת גן,1885,903,982,685,1200,273,1856,15,2%
2017-04,תל אביב,2650,רמת השרון,373,156,217,180,193,5,373,2,2%
2017-04,תל אביב,5000,תל אביב -יפו,6659,3396,3263,2538,4121,1452,6537,56,3%
2017-05,אזור יהודה והשומרון,3760,אורנית,87,42,45,33,54,3,87,0,2%
2017-05,אזור יהודה והשומרון,3750,אלפי מנשה,88,35,53,27,61,0,88,2,2%
2017-05,אזור יהודה והשומרון,3560,אלקנה,31,14,17,19,12,0,31,1,2%
2017-05,אזור יהודה והשומרון,3650,אפרת,108,60,48,62,46,2,106,1,3%
2017-05,אזור יהודה והשומרון,3570,אריאל,275,128,147,67,208,21,274,13,3%
2017-05,אזור יהודה והשומרון,3574,בית אל,45,18,27,17,28,10,45,1,2%
2017-05,אזור יהודה והשומרון,3652,בית אריה,57,29,28,15,42,1,57,1,2%
2017-05,אזור יהודה והשומרון,3780,ביתר עילית,441,205,236,11,430,164,439,4,4%
2017-05,אזור יהודה והשומרון,3730,גבעת זאב,162,79,83,38,124,27,161,3,2%
2017-05,אזור יהודה והשומרון,3769,הר אדר,35,15,20,19,16,3,35,0,2%
2017-05,אזור יהודה והשומרון,3797,מודיעין עילית,354,110,244,23,331,27,351,9,3%
2017-05,אזור יהודה והשומרון,3616,מעלה אדומים,571,249,322,86,485,150,562,17,3%
2017-05,אזור יהודה והשומרון,3660,עמנואל,47,27,20,2,45,23,46,0,4%
2017-05,אזור יהודה והשומרון,3557,קדומים,26,14,12,8,18,3,26,1,1%
2017-05,אזור יהודה והשומרון,3611,קריית ארבע,92,53,39,18,74,46,86,4,3%
2017-05,אזור יהודה והשומרון,3640,קרני שומרון,60,30,30,20,40,4,60,1,2%
2017-05,הדרום,31,אופקים,835,380,455,52,783,424,798,52,6%
2017-05,הדרום,2600,אילת,953,499,454,65,888,352,875,50,3%
2017-05,הדרום,70,אשדוד,4897,2053,2844,630,4267,2146,4662,124,4%
2017-05,הדרום,7100,אשקלון,3476,1449,2027,381,3095,1577,3083,78,5%
2017-05,הדרום,9000,באר שבע,5198,2394,2804,700,4498,2721,4927,120,5%
2017-05,הדרום,2200,דימונה,1626,760,866,84,1542,1080,1535,41,9%
2017-05,הדרום,1303,חורה,531,228,303,7,524,442,512,4,14%
2017-05,הדרום,831,ירוחם,359,176,183,21,338,215,334,25,7%
2017-05,הדרום,1059,כסיפה,972,368,604,2,970,877,963,11,21%
2017-05,הדרום,1271,להבים,49,15,34,22,27,3,49,0,1%
2017-05,הדרום,1060,לקיה,599,265,334,8,591,520,578,6,15%
2017-05,הדרום,1268,מיתר,58,21,37,23,35,3,57,1,1%
2017-05,הדרום,99,מצפה רמון,226,84,142,16,210,146,214,15,9%
2017-05,הדרום,246,נתיבות,884,386,498,50,834,403,815,61,6%
2017-05,הדרום,666,עומר,60,24,36,22,38,2,60,0,1%
2017-05,הדרום,2560,ערד,608,271,337,55,553,320,579,33,5%
2017-05,הדרום,1192,ערערה-בנגב,1063,440,623,5,1058,959,1046,25,25%
2017-05,הדרום,2630,קריית גת,1515,646,869,100,1415,666,1455,52,5%
2017-05,הדרום,1034,קריית מלאכי,683,307,376,19,664,281,654,41,6%
2017-05,הדרום,1161,רהט,2180,857,1323,8,2172,1714,2157,66,12%
2017-05,הדרום,1286,שגב-שלום,327,123,204,3,324,265,314,3,13%
2017-05,הדרום,1031,שדרות,888,402,486,61,827,467,825,20,7%
2017-05,הדרום,1054,תל שבע,687,297,390,0,687,614,646,6,15%
2017-05,המרכז,182,אבן יהודה,158,72,86,50,108,22,156,3,2%
2017-05,המרכז,41,אליכין,58,28,30,9,49,16,55,0,3%
2017-05,המרכז,1309,אלעד,288,120,168,17,271,32,280,1,2%
2017-05,המרכז,2530,באר יעקב,229,87,142,70,159,39,223,7,2%
2017-05,המרכז,466,בית דגן,86,47,39,10,76,25,84,1,2%
2017-05,המרכז,1066,"בני עי""ש",117,55,62,16,101,40,116,1,3%
2017-05,המרכז,681,גבעת שמואל,247,132,115,89,158,37,241,2,2%
2017-05,המרכז,2550,גדרה,287,137,150,48,239,73,277,7,2%
2017-05,המרכז,627,ג'לג'וליה,75,38,37,2,73,42,71,1,2%
2017-05,המרכז,166,גן יבנה,294,120,174,43,251,62,289,4,3%
2017-05,המרכז,229,גני תקווה,206,114,92,79,127,22,206,1,2%
2017-05,המרכז,9700,הוד השרון,634,276,358,314,320,28,628,8,2%
2017-05,המרכז,1290,זמר,111,39,72,2,109,76,110,3,4%
2017-05,המרכז,2730,טייבה,951,437,514,27,924,691,813,32,5%
2017-05,המרכז,2720,טירה,155,81,74,13,142,51,150,8,1%
2017-05,המרכז,2660,יבנה,670,308,362,142,528,158,662,32,3%
2017-05,המרכז,9400,יהוד,338,151,187,84,254,32,329,5,2%
2017-05,המרכז,1224,כוכב יאיר,66,26,40,43,23,0,66,0,1%
2017-05,המרכז,633,כפר ברא,17,11,6,2,15,8,15,0,1%
2017-05,המרכז,168,כפר יונה,273,120,153,52,221,45,271,3,3%
2017-05,המרכז,6900,כפר סבא,1024,462,562,441,583,76,1009,23,2%
2017-05,המרכז,634,כפר קאסם,212,79,133,12,200,105,205,2,2%
2017-05,המרכז,7000,לוד,1572,781,791,126,1446,815,1535,41,4%
2017-05,המרכז,1200,מודיעין-מכבים-רעות*,820,361,459,362,458,39,811,28,2%
2017-05,המרכז,28,מזכרת בתיה,143,60,83,40,103,15,142,2,2%
2017-05,המרכז,7200,נס ציונה,644,315,329,177,467,152,630,6,3%
2017-05,המרכז,7400,נתניה,3689,1785,1904,467,3222,1139,3613,111,3%
2017-05,המרכז,587,סביון*,16,4,12,9,7,0,16,0,1%
2017-05,המרכז,171,פרדסייה,77,38,39,27,50,9,75,0,2%
2017-05,המרכז,7900,פתח תקווה,3472,1574,1898,747,2725,776,3387,51,3%
2017-05,המרכז,195,קדימה-צורן,235,98,137,74,161,30,234,3,2%
2017-05,המרכז,638,קלנסווה,338,181,157,13,325,228,307,9,4%
2017-05,המרכז,469,קריית עקרון,199,100,99,22,177,94,194,5,3%
2017-05,המרכז,2640,ראש העין,746,364,382,136,610,117,738,10,3%
2017-05,המרכז,8300,ראשון לציון,3918,1726,2192,817,3101,902,3871,60,3%
2017-05,המרכז,8400,רחובות,2005,899,1106,537,1468,635,1938,38,3%
2017-05,המרכז,8500,רמלה,1347,655,692,123,1224,530,1299,51,4%
2017-05,המרכז,8700,רעננה,668,310,358,301,367,38,656,19,2%
2017-05,המרכז,1304,שוהם,175,68,107,91,84,11,175,1,2%
2017-05,המרכז,154,תל מונד,132,71,61,45,87,15,132,1,2%
2017-05,הצפון,473,אבו סנאן,528,215,313,4,524,418,521,9,9%
2017-05,הצפון,478,אכסאל,406,174,232,11,395,354,404,5,7%
2017-05,הצפון,529,אעבלין,418,178,240,10,408,329,411,7,8%
2017-05,הצפון,482,בועיינה-נוג'ידאת,252,122,130,7,245,195,249,3,7%
2017-05,הצפון,4001,בוקעאתא,386,144,242,4,382,293,369,3,14%
2017-05,הצפון,998,ביר אל-מכסור,283,123,160,1,282,215,280,3,8%
2017-05,הצפון,480,בית ג'ן,361,94,267,6,355,238,343,1,7%
2017-05,הצפון,9200,בית שאן,655,279,376,24,631,285,631,56,6%
2017-05,הצפון,944,בסמת טבעון,153,67,86,2,151,105,142,2,5%
2017-05,הצפון,483,בענה,318,140,178,5,313,263,309,10,10%
2017-05,הצפון,1292,ג'דיידה-מכר,1024,468,556,6,1018,813,1008,9,12%
2017-05,הצפון,485,ג'ולס,174,48,126,3,171,117,173,2,6%
2017-05,הצפון,487,ג'ש (גוש חלב),55,27,28,4,51,23,55,4,3%
2017-05,הצפון,489,דבורייה,273,112,161,11,262,192,271,3,7%
2017-05,הצפון,490,דייר אל-אסד,307,131,176,13,294,252,297,10,6%
2017-05,הצפון,492,דייר חנא,571,248,323,16,555,425,564,9,12%
2017-05,הצפון,975,זרזיר,195,79,116,2,193,127,190,4,6%
2017-05,הצפון,496,חורפיש,92,41,51,3,89,57,88,1,3%
2017-05,הצפון,2034,חצור הגלילית,217,89,128,15,202,114,205,7,4%
2017-05,הצפון,6700,טבריה,1283,613,670,67,1216,661,1098,73,5%
2017-05,הצפון,962,טובא-זנגרייה,320,134,186,3,317,203,311,4,10%
2017-05,הצפון,498,טורעאן,360,156,204,6,354,298,353,9,6%
2017-05,הצפון,8900,טמרה,1228,583,645,17,1211,1035,1202,14,9%
2017-05,הצפון,1295,יאנוח-ג'ת,129,42,87,6,123,79,125,4,5%
2017-05,הצפון,46,יבנאל,111,55,56,7,104,70,85,3,6%
2017-05,הצפון,499,יפיע,508,226,282,23,485,377,502,4,7%
2017-05,הצפון,240,יקנעם עילית,387,177,210,79,308,88,381,28,3%
2017-05,הצפון,502,ירכא,379,139,240,2,377,292,377,3,7%
2017-05,הצפון,504,כאבול,426,217,209,4,422,355,415,2,9%
2017-05,הצפון,505,כאוכב אבו אל-היג'א,199,88,111,2,197,154,198,6,12%
2017-05,הצפון,1296,כסרא-סמיע,182,57,125,6,176,111,170,4,5%
2017-05,הצפון,978,כעביה-טבאש-חג'אג'רה,157,63,94,0,157,114,154,2,7%
2017-05,הצפון,1263,כפר ורדים,52,20,32,22,30,5,49,0,2%
2017-05,הצפון,507,כפר יאסיף,344,147,197,7,337,240,339,7,7%
2017-05,הצפון,508,כפר כמא,37,15,22,2,35,15,37,1,2%
2017-05,הצפון,509,כפר כנא,741,344,397,18,723,602,712,9,8%
2017-05,הצפון,510,כפר מנדא,630,332,298,9,621,468,623,1,9%
2017-05,הצפון,47,כפר תבור,43,15,28,16,27,3,42,0,2%
2017-05,הצפון,1139,כרמיאל,1344,569,775,271,1073,671,1237,43,5%
2017-05,הצפון,481,מגאר,1179,478,701,16,1163,946,1143,10,13%
2017-05,הצפון,516,מג'ד אל-כרום,435,204,231,8,427,321,421,11,7%
2017-05,הצפון,874,מגדל העמק,698,316,382,73,625,282,641,65,5%
2017-05,הצפון,4201,מג'דל שמס,407,159,248,10,397,299,389,5,8%
2017-05,הצפון,517,מזרעה,148,63,85,1,147,111,141,3,7%
2017-05,הצפון,4203,מסעדה,182,71,111,4,178,139,173,2,11%
2017-05,הצפון,518,מעיליא,49,26,23,8,41,19,48,3,3%
2017-05,הצפון,1063,מעלות-תרשיחא,732,372,360,76,656,359,693,42,6%
2017-05,הצפון,520,משהד,180,80,100,6,174,144,172,0,6%
2017-05,הצפון,9100,נהרייה,1620,796,824,161,1459,887,1526,73,5%
2017-05,הצפון,522,נחף,363,169,194,12,351,270,349,5,7%
2017-05,הצפון,7300,נצרת,2535,1132,1403,105,2430,1886,2509,30,7%
2017-05,הצפון,1061,נצרת עילית,1278,568,710,131,1147,597,1132,87,5%
2017-05,הצפון,525,סאג'ור,100,31,69,10,90,59,96,1,5%
2017-05,הצפון,7500,סח'נין,1698,766,932,43,1655,1403,1680,22,12%
2017-05,הצפון,4501,ע'ג'ר,87,24,63,2,85,58,86,0,8%
2017-05,הצפון,530,עיילבון,150,69,81,11,139,96,146,1,5%
2017-05,הצפון,511,עילוט,258,111,147,3,255,206,256,3,9%
2017-05,הצפון,532,עין מאהל,351,180,171,11,340,264,343,3,7%
2017-05,הצפון,7600,עכו,2617,1184,1433,138,2479,1912,2526,44,10%
2017-05,הצפון,7700,עפולה,1370,588,782,172,1198,533,1303,74,5%
2017-05,הצפון,531,עראבה,1241,534,707,33,1208,1066,1222,23,13%
2017-05,הצפון,535,פסוטה,80,38,42,9,71,45,78,2,5%
2017-05,הצפון,536,פקיעין (בוקייעה),115,60,55,8,107,72,108,1,4%
2017-05,הצפון,8000,צפת,922,492,430,105,817,628,852,26,7%
2017-05,הצפון,4100,קצרין,172,81,91,21,151,85,168,3,4%
2017-05,הצפון,2800,קריית שמונה,611,312,299,67,544,269,588,29,5%
2017-05,הצפון,543,ראמה,233,90,143,19,214,157,223,5,6%
2017-05,הצפון,26,ראש פינה,47,20,27,10,37,19,46,0,3%
2017-05,הצפון,542,ריינה,434,197,237,8,426,338,422,6,6%
2017-05,הצפון,122,רמת ישי,81,32,49,36,45,15,77,2,2%
2017-05,הצפון,913,שבלי - אום אל-גנם,167,71,96,7,160,105,164,4,7%
2017-05,הצפון,812,שלומי,216,79,137,18,198,107,209,9,6%
2017-05,הצפון,538,שעב,417,191,226,2,415,340,410,4,14%
2017-05,הצפון,8800,שפרעם,1302,545,757,46,1256,1022,1276,22,8%
2017-05,חיפה,2710,אום אל-פחם,2567,1072,1495,24,2543,2108,2523,40,13%
2017-05,חיפה,1020,אור עקיבא,404,167,237,43,361,103,390,18,4%
2017-05,חיפה,6000,באקה אל-גרביה,506,251,255,9,497,326,502,24,4%
2017-05,חיפה,9800,בנימינה-גבעת עדה*,171,81,90,67,104,33,169,5,2%
2017-05,חיפה,1326,"בסמ""ה",329,151,178,6,323,255,324,4,8%
2017-05,חיפה,541,ג'סר א-זרקא,223,127,96,2,221,112,220,9,4%
2017-05,חיפה,628,ג'ת,181,95,86,9,172,113,179,7,3%
2017-05,חיפה,494,דאלית אל-כרמל,426,159,267,23,403,229,397,11,5%
2017-05,חיפה,9300,זכרון יעקב,234,112,122,96,138,29,230,6,2%
2017-05,חיפה,6500,חדרה,1969,869,1100,237,1732,660,1860,29,4%
2017-05,חיפה,4000,חיפה,5121,2451,2670,1102,4019,2416,4836,136,3%
2017-05,חיפה,1247,חריש,92,30,62,20,72,12,84,0,6%
2017-05,חיפה,2100,טירת כרמל,615,305,310,39,576,310,596,17,6%
2017-05,חיפה,654,כפר קרע,392,180,212,23,369,231,387,19,5%
2017-05,חיפה,1327,מעלה עירון,640,254,386,4,636,504,627,12,11%
2017-05,חיפה,2500,נשר,369,186,183,77,292,123,359,7,3%
2017-05,חיפה,534,עספיא,284,131,153,16,268,148,266,6,5%
2017-05,חיפה,637,ערערה,478,210,268,10,468,320,468,16,6%
2017-05,חיפה,537,פוריידיס,199,112,87,4,195,103,195,7,4%
2017-05,חיפה,7800,פרדס חנה-כרכור,689,320,369,171,518,128,669,23,3%
2017-05,חיפה,6800,קריית אתא,1266,592,674,106,1160,605,1228,36,4%
2017-05,חיפה,9500,קריית ביאליק,846,377,469,111,735,356,820,36,4%
2017-05,חיפה,2300,קריית טבעון,140,61,79,67,73,26,140,3,2%
2017-05,חיפה,9600,קריית ים,1203,558,645,118,1085,651,1152,37,5%
2017-05,חיפה,8200,קריית מוצקין,821,360,461,129,692,337,792,15,4%
2017-05,חיפה,922,רכסים,116,55,61,6,110,58,104,0,3%
2017-05,ירושלים,472,אבו גוש,203,98,105,6,197,162,201,3,7%
2017-05,ירושלים,2610,בית שמש,1028,430,598,97,931,385,985,36,3%
2017-05,ירושלים,3000,ירושלים,10731,4847,5884,1310,9421,6545,10460,157,4%
2017-05,ירושלים,1015,מבשרת ציון,300,142,158,76,224,107,291,6,2%
2017-05,ירושלים,1137,קריית יערים,42,23,19,7,35,13,42,1,3%
2017-05,תל אביב,2400,אור יהודה,568,274,294,61,507,133,546,38,3%
2017-05,תל אביב,565,אזור,164,90,74,28,136,25,163,4,3%
2017-05,תל אביב,6100,בני ברק,1533,748,785,96,1437,614,1403,18,3%
2017-05,תל אביב,6200,בת ים,2358,1143,1215,360,1998,825,2223,81,3%
2017-05,תל אביב,6300,גבעתיים,723,346,377,374,349,65,719,4,2%
2017-05,תל אביב,6400,הרצלייה,985,430,555,405,580,30,978,7,2%
2017-05,תל אביב,6600,חולון,2719,1186,1533,484,2235,586,2672,62,3%
2017-05,תל אביב,2620,קריית אונו,370,164,206,179,191,25,368,3,2%
2017-05,תל אביב,8600,רמת גן,1937,917,1020,731,1206,274,1898,16,2%
2017-05,תל אביב,2650,רמת השרון,383,161,222,193,190,9,381,2,2%
2017-05,תל אביב,5000,תל אביב -יפו,6874,3466,3408,2760,4114,1402,6763,68,3%
2017-06,אזור יהודה והשומרון,3760,אורנית,82,38,44,31,51,3,82,0,2%
2017-06,אזור יהודה והשומרון,3750,אלפי מנשה,85,37,48,30,55,1,85,1,2%
2017-06,אזור יהודה והשומרון,3560,אלקנה,35,16,19,21,14,0,35,0,2%
2017-06,אזור יהודה והשומרון,3650,אפרת,120,62,58,66,54,4,116,3,3%
2017-06,אזור יהודה והשומרון,3570,אריאל,275,120,155,61,214,24,273,6,3%
2017-06,אזור יהודה והשומרון,3574,בית אל,42,19,23,14,28,10,42,1,2%
2017-06,אזור יהודה והשומרון,3652,בית אריה,60,28,32,18,42,3,60,1,2%
2017-06,אזור יהודה והשומרון,3780,ביתר עילית,427,197,230,11,416,153,425,4,4%
2017-06,אזור יהודה והשומרון,3730,גבעת זאב,170,93,77,34,136,32,168,4,2%
2017-06,אזור יהודה והשומרון,3769,הר אדר,38,18,20,18,20,3,38,0,2%
2017-06,אזור יהודה והשומרון,3797,מודיעין עילית,392,105,287,20,372,37,390,8,3%
2017-06,אזור יהודה והשומרון,3616,מעלה אדומים,574,264,310,90,484,147,567,13,3%
2017-06,אזור יהודה והשומרון,3660,עמנואל,47,26,21,1,46,23,46,2,4%
2017-06,אזור יהודה והשומרון,3557,קדומים,29,17,12,10,19,4,28,0,2%
2017-06,אזור יהודה והשומרון,3611,קריית ארבע,90,53,37,17,73,40,87,7,3%
2017-06,אזור יהודה והשומרון,3640,קרני שומרון,69,32,37,25,44,3,69,1,2%
2017-06,הדרום,31,אופקים,849,397,452,54,795,423,806,39,7%
2017-06,הדרום,2600,אילת,924,485,439,58,866,325,857,56,3%
2017-06,הדרום,70,אשדוד,5018,2051,2967,649,4369,2163,4750,141,4%
2017-06,הדרום,7100,אשקלון,3477,1440,2037,387,3090,1553,3071,78,5%
2017-06,הדרום,9000,באר שבע,5203,2381,2822,701,4502,2735,4898,91,5%
2017-06,הדרום,2200,דימונה,1674,784,890,89,1585,1072,1563,60,9%
2017-06,הדרום,1303,חורה,517,213,304,5,512,445,502,7,13%
2017-06,הדרום,831,ירוחם,367,182,185,19,348,216,343,33,8%
2017-06,הדרום,1059,כסיפה,954,360,594,2,952,856,945,11,21%
2017-06,הדרום,1271,להבים,49,18,31,23,26,4,49,0,1%
2017-06,הדרום,1060,לקיה,601,271,330,5,596,529,575,9,15%
2017-06,הדרום,1268,מיתר,64,25,39,23,41,6,63,0,1%
2017-06,הדרום,99,מצפה רמון,221,79,142,19,202,133,207,18,9%
2017-06,הדרום,246,נתיבות,980,443,537,52,928,415,912,53,7%
2017-06,הדרום,666,עומר,60,21,39,24,36,2,60,1,1%
2017-06,הדרום,2560,ערד,607,277,330,52,555,313,576,26,5%
2017-06,הדרום,1192,ערערה-בנגב,1075,448,627,4,1071,973,1050,3,25%
2017-06,הדרום,2630,קריית גת,1529,658,871,96,1433,657,1456,49,5%
2017-06,הדרום,1034,קריית מלאכי,672,280,392,15,657,296,635,35,6%
2017-06,הדרום,1161,רהט,2154,851,1303,8,2146,1686,2116,73,12%
2017-06,הדרום,1286,שגב-שלום,329,129,200,3,326,275,314,1,13%
2017-06,הדרום,1031,שדרות,925,423,502,70,855,480,841,24,7%
2017-06,הדרום,1054,תל שבע,669,288,381,0,669,599,632,2,14%
2017-06,המרכז,182,אבן יהודה,155,71,84,53,102,20,155,0,2%
2017-06,המרכז,41,אליכין,59,28,31,8,51,17,56,1,3%
2017-06,המרכז,1309,אלעד,296,128,168,19,277,35,286,3,2%
2017-06,המרכז,2530,באר יעקב,210,76,134,66,144,35,206,5,2%
2017-06,המרכז,466,בית דגן,93,46,47,10,83,24,91,0,3%
2017-06,המרכז,1066,"בני עי""ש",118,56,62,22,96,37,116,4,3%
2017-06,המרכז,681,גבעת שמואל,242,135,107,84,158,38,238,3,2%
2017-06,המרכז,2550,גדרה,281,141,140,52,229,71,274,10,2%
2017-06,המרכז,627,ג'לג'וליה,65,30,35,2,63,32,64,1,2%
2017-06,המרכז,166,גן יבנה,297,123,174,44,253,66,285,7,3%
2017-06,המרכז,229,גני תקווה,211,120,91,73,138,24,208,2,3%
2017-06,המרכז,9700,הוד השרון,682,294,388,328,354,27,674,14,2%
2017-06,המרכז,1290,זמר,115,42,73,3,112,78,112,6,4%
2017-06,המרכז,2730,טייבה,922,423,499,20,902,688,782,27,5%
2017-06,המרכז,2720,טירה,153,73,80,10,143,50,148,6,1%
2017-06,המרכז,2660,יבנה,668,316,352,144,524,157,646,28,3%
2017-06,המרכז,9400,יהוד,356,161,195,97,259,36,341,8,2%
2017-06,המרכז,1224,כוכב יאיר,68,27,41,43,25,0,68,1,1%
2017-06,המרכז,633,כפר ברא,15,9,6,2,13,5,14,0,1%
2017-06,המרכז,168,כפר יונה,284,126,158,55,229,47,283,3,3%
2017-06,המרכז,6900,כפר סבא,1044,493,551,440,604,81,1027,24,2%
2017-06,המרכז,634,כפר קאסם,230,81,149,14,216,100,222,2,3%
2017-06,המרכז,7000,לוד,1585,789,796,133,1452,807,1546,33,4%
2017-06,המרכז,1200,מודיעין-מכבים-רעות*,822,376,446,359,463,33,812,15,2%
2017-06,המרכז,28,מזכרת בתיה,150,59,91,46,104,17,147,2,2%
2017-06,המרכז,7200,נס ציונה,664,331,333,183,481,150,652,18,3%
2017-06,המרכז,7400,נתניה,3756,1820,1936,492,3264,1152,3682,115,4%
2017-06,המרכז,587,סביון*,17,1,16,9,8,0,17,0,1%
2017-06,המרכז,171,פרדסייה,70,33,37,25,45,6,70,0,2%
2017-06,המרכז,7900,פתח תקווה,3480,1602,1878,732,2748,764,3382,53,3%
2017-06,המרכז,195,קדימה-צורן,246,108,138,81,165,29,246,0,2%
2017-06,המרכז,638,קלנסווה,328,165,163,13,315,219,299,6,4%
2017-06,המרכז,469,קריית עקרון,206,99,107,21,185,96,196,5,3%
2017-06,המרכז,2640,ראש העין,756,367,389,147,609,120,751,16,3%
2017-06,המרכז,8300,ראשון לציון,3877,1737,2140,810,3067,905,3823,74,3%
2017-06,המרכז,8400,רחובות,2055,885,1170,542,1513,636,1977,41,3%
2017-06,המרכז,8500,רמלה,1371,664,707,110,1261,530,1324,56,4%
2017-06,המרכז,8700,רעננה,676,320,356,297,379,44,664,8,2%
2017-06,המרכז,1304,שוהם,180,74,106,96,84,9,180,1,2%
2017-06,המרכז,154,תל מונד,136,66,70,49,87,15,135,0,2%
2017-06,הצפון,473,אבו סנאן,523,213,310,4,519,415,515,3,9%
2017-06,הצפון,478,אכסאל,407,176,231,12,395,354,403,2,7%
2017-06,הצפון,529,אעבלין,405,182,223,15,390,316,395,3,7%
2017-06,הצפון,482,בועיינה-נוג'ידאת,239,119,120,5,234,186,236,4,6%
2017-06,הצפון,4001,בוקעאתא,391,148,243,7,384,295,369,3,14%
2017-06,הצפון,998,ביר אל-מכסור,284,129,155,4,280,213,280,1,8%
2017-06,הצפון,480,בית ג'ן,363,94,269,6,357,239,341,1,7%
2017-06,הצפון,9200,בית שאן,633,271,362,25,608,273,610,49,6%
2017-06,הצפון,944,בסמת טבעון,162,72,90,3,159,112,150,4,5%
2017-06,הצפון,483,בענה,307,140,167,3,304,257,295,13,9%
2017-06,הצפון,1292,ג'דיידה-מכר,1051,477,574,5,1046,813,1036,9,12%
2017-06,הצפון,485,ג'ולס,178,50,128,6,172,113,178,4,6%
2017-06,הצפון,487,ג'ש (גוש חלב),45,21,24,3,42,24,45,0,3%
2017-06,הצפון,489,דבורייה,251,106,145,14,237,178,248,3,6%
2017-06,הצפון,490,דייר אל-אסד,302,132,170,11,291,245,298,5,6%
2017-06,הצפון,492,דייר חנא,537,226,311,16,521,398,532,6,11%
2017-06,הצפון,975,זרזיר,194,85,109,0,194,135,190,1,6%
2017-06,הצפון,496,חורפיש,97,42,55,5,92,52,94,2,4%
2017-06,הצפון,2034,חצור הגלילית,221,93,128,8,213,111,211,6,5%
2017-06,הצפון,6700,טבריה,1287,615,672,64,1223,656,1100,60,5%
2017-06,הצפון,962,טובא-זנגרייה,324,141,183,3,321,210,314,3,11%
2017-06,הצפון,498,טורעאן,352,157,195,7,345,290,346,6,6%
2017-06,הצפון,8900,טמרה,1205,573,632,16,1189,1022,1175,5,9%
2017-06,הצפון,1295,יאנוח-ג'ת,122,36,86,4,118,74,119,1,4%
2017-06,הצפון,46,יבנאל,102,53,49,8,94,63,80,5,5%
2017-06,הצפון,499,יפיע,502,223,279,20,482,375,493,2,6%
2017-06,הצפון,240,יקנעם עילית,407,180,227,85,322,87,399,28,3%
2017-06,הצפון,502,ירכא,368,130,238,2,366,284,363,1,6%
2017-06,הצפון,504,כאבול,422,213,209,5,417,350,409,3,9%
2017-06,הצפון,505,כאוכב אבו אל-היג'א,191,78,113,2,189,150,190,4,11%
2017-06,הצפון,1296,כסרא-סמיע,186,53,133,5,181,112,171,3,5%
2017-06,הצפון,978,כעביה-טבאש-חג'אג'רה,160,67,93,1,159,115,156,2,7%
2017-06,הצפון,1263,כפר ורדים,45,20,25,20,25,5,43,0,1%
2017-06,הצפון,507,כפר יאסיף,326,138,188,5,321,232,319,4,6%
2017-06,הצפון,508,כפר כמא,40,21,19,2,38,19,40,2,3%
2017-06,הצפון,509,כפר כנא,702,329,373,18,684,562,681,10,8%
2017-06,הצפון,510,כפר מנדא,637,343,294,9,628,466,629,21,9%
2017-06,הצפון,47,כפר תבור,36,11,25,13,23,1,36,2,2%
2017-06,הצפון,1139,כרמיאל,1351,570,781,274,1077,666,1236,45,5%
2017-06,הצפון,481,מגאר,1156,477,679,15,1141,925,1121,2,12%
2017-06,הצפון,516,מג'ד אל-כרום,405,199,206,6,399,304,390,11,6%
2017-06,הצפון,874,מגדל העמק,702,313,389,70,632,281,643,70,5%
2017-06,הצפון,4201,מג'דל שמס,402,150,252,8,394,303,379,2,8%
2017-06,הצפון,517,מזרעה,149,64,85,1,148,112,142,3,7%
2017-06,הצפון,4203,מסעדה,193,76,117,5,188,145,177,4,11%
2017-06,הצפון,518,מעיליא,44,22,22,9,35,17,44,5,3%
2017-06,הצפון,1063,מעלות-תרשיחא,706,364,342,76,630,356,671,35,6%
2017-06,הצפון,520,משהד,176,76,100,7,169,143,168,4,5%
2017-06,הצפון,9100,נהרייה,1694,839,855,182,1512,885,1585,58,5%
2017-06,הצפון,522,נחף,340,158,182,11,329,258,332,5,7%
2017-06,הצפון,7300,נצרת,2478,1109,1369,103,2375,1833,2452,21,7%
2017-06,הצפון,1061,נצרת עילית,1263,579,684,130,1133,603,1123,84,5%
2017-06,הצפון,525,סאג'ור,101,32,69,7,94,59,100,0,6%
2017-06,הצפון,7500,סח'נין,1626,722,904,40,1586,1347,1607,13,12%
2017-06,הצפון,4501,ע'ג'ר,84,23,61,1,83,61,80,0,8%
2017-06,הצפון,530,עיילבון,138,67,71,12,126,84,133,1,5%
2017-06,הצפון,511,עילוט,253,111,142,4,249,200,250,0,9%
2017-06,הצפון,532,עין מאהל,346,176,170,9,337,272,333,2,7%
2017-06,הצפון,7600,עכו,2585,1167,1418,129,2456,1891,2483,32,10%
2017-06,הצפון,7700,עפולה,1417,589,828,163,1254,523,1339,81,5%
2017-06,הצפון,531,עראבה,1188,499,689,25,1163,1016,1172,8,12%
2017-06,הצפון,535,פסוטה,83,43,40,8,75,43,78,2,5%
2017-06,הצפון,536,פקיעין (בוקייעה),117,62,55,8,109,73,108,1,4%
2017-06,הצפון,8000,צפת,928,501,427,95,833,610,851,16,7%
2017-06,הצפון,4100,קצרין,167,78,89,19,148,82,163,8,4%
2017-06,הצפון,2800,קריית שמונה,603,302,301,63,540,255,575,37,4%
2017-06,הצפון,543,ראמה,222,86,136,15,207,155,214,1,6%
2017-06,הצפון,26,ראש פינה,43,18,25,10,33,20,42,0,3%
2017-06,הצפון,542,ריינה,413,190,223,7,406,316,403,4,6%
2017-06,הצפון,122,רמת ישי,81,34,47,34,47,14,78,2,2%
2017-06,הצפון,913,שבלי - אום אל-גנם,169,78,91,8,161,107,167,4,7%
2017-06,הצפון,812,שלומי,201,78,123,17,184,105,195,8,5%
2017-06,הצפון,538,שעב,400,187,213,3,397,331,394,3,13%
2017-06,הצפון,8800,שפרעם,1253,520,733,38,1215,1001,1225,23,7%
2017-06,חיפה,2710,אום אל-פחם,2522,1065,1457,18,2504,2088,2465,30,12%
2017-06,חיפה,1020,אור עקיבא,411,175,236,39,372,108,393,11,4%
2017-06,חיפה,6000,באקה אל-גרביה,519,242,277,10,509,333,516,18,5%
2017-06,חיפה,9800,בנימינה-גבעת עדה*,172,82,90,73,99,31,172,1,2%
2017-06,חיפה,1326,"בסמ""ה",326,156,170,5,321,253,321,7,8%
2017-06,חיפה,541,ג'סר א-זרקא,239,119,120,2,237,107,232,12,4%
2017-06,חיפה,628,ג'ת,183,98,85,8,175,116,182,4,4%
2017-06,חיפה,494,דאלית אל-כרמל,425,164,261,21,404,227,397,8,5%
2017-06,חיפה,9300,זכרון יעקב,230,116,114,96,134,31,225,3,2%
2017-06,חיפה,6500,חדרה,1951,857,1094,228,1723,657,1839,53,4%
2017-06,חיפה,4000,חיפה,5062,2400,2662,1100,3962,2403,4755,144,3%
2017-06,חיפה,1247,חריש,94,32,62,16,78,14,88,0,6%
2017-06,חיפה,2100,טירת כרמל,624,296,328,39,585,306,602,16,6%
2017-06,חיפה,654,כפר קרע,391,184,207,20,371,225,386,8,5%
2017-06,חיפה,1327,מעלה עירון,635,251,384,3,632,497,620,5,11%
2017-06,חיפה,2500,נשר,365,176,189,69,296,131,350,9,3%
2017-06,חיפה,534,עספיא,291,138,153,13,278,152,267,5,5%
2017-06,חיפה,637,ערערה,484,212,272,12,472,326,473,15,6%
2017-06,חיפה,537,פוריידיס,181,98,83,4,177,85,181,2,3%
2017-06,חיפה,7800,פרדס חנה-כרכור,685,331,354,161,524,120,669,33,3%
2017-06,חיפה,6800,קריית אתא,1309,607,702,99,1210,614,1270,28,4%
2017-06,חיפה,9500,קריית ביאליק,860,377,483,108,752,361,830,21,4%
2017-06,חיפה,2300,קריית טבעון,144,65,79,68,76,28,141,1,2%
2017-06,חיפה,9600,קריית ים,1186,548,638,113,1073,641,1139,38,5%
2017-06,חיפה,8200,קריית מוצקין,818,355,463,128,690,329,789,13,4%
2017-06,חיפה,922,רכסים,130,59,71,4,126,60,118,1,3%
2017-06,ירושלים,472,אבו גוש,197,94,103,4,193,157,193,1,6%
2017-06,ירושלים,2610,בית שמש,1075,468,607,84,991,385,1025,44,3%
2017-06,ירושלים,3000,ירושלים,10808,4868,5940,1330,9478,6427,10516,150,4%
2017-06,ירושלים,1015,מבשרת ציון,305,146,159,83,222,96,299,3,2%
2017-06,ירושלים,1137,קריית יערים,39,19,20,5,34,12,39,1,3%
2017-06,תל אביב,2400,אור יהודה,571,291,280,50,521,115,548,38,3%
2017-06,תל אביב,565,אזור,184,100,84,35,149,26,181,5,3%
2017-06,תל אביב,6100,בני ברק,1519,727,792,97,1422,598,1396,27,3%
2017-06,תל אביב,6200,בת ים,2355,1132,1223,375,1980,802,2223,75,3%
2017-06,תל אביב,6300,גבעתיים,722,344,378,366,356,70,715,1,2%
2017-06,תל אביב,6400,הרצלייה,995,456,538,398,597,35,983,7,2%
2017-06,תל אביב,6600,חולון,2729,1216,1513,492,2237,583,2662,65,3%
2017-06,תל אביב,2620,קריית אונו,368,164,204,183,185,28,364,1,2%
2017-06,תל אביב,8600,רמת גן,1932,919,1013,722,1210,270,1897,16,2%
2017-06,תל אביב,2650,רמת השרון,406,166,240,199,207,16,401,0,2%
2017-06,תל אביב,5000,תל אביב -יפו,6945,3487,3458,2783,4162,1379,6817,47,3%
2017-07,אזור יהודה והשומרון,3760,אורנית,92,47,45,29,63,2,92,0,2%
2017-07,אזור יהודה והשומרון,3750,אלפי מנשה,77,32,45,25,52,1,76,2,2%
2017-07,אזור יהודה והשומרון,3560,אלקנה,36,15,21,21,15,0,36,0,2%
2017-07,אזור יהודה והשומרון,3650,אפרת,120,64,56,68,52,4,118,1,3%
2017-07,אזור יהודה והשומרון,3570,אריאל,286,121,165,72,214,27,284,11,3%
2017-07,אזור יהודה והשומרון,3574,בית אל,57,31,26,18,39,13,55,0,2%
2017-07,אזור יהודה והשומרון,3652,בית אריה,62,31,31,15,47,3,62,2,2%
2017-07,אזור יהודה והשומרון,3780,ביתר עילית,786,250,536,17,769,180,779,2,6%
2017-07,אזור יהודה והשומרון,3730,גבעת זאב,190,92,98,43,147,31,189,0,3%
2017-07,אזור יהודה והשומרון,3769,הר אדר,34,16,18,16,18,3,34,0,2%
2017-07,אזור יהודה והשומרון,3797,מודיעין עילית,893,133,760,25,868,40,889,8,7%
2017-07,אזור יהודה והשומרון,3616,מעלה אדומים,630,265,365,99,531,153,620,10,3%
2017-07,אזור יהודה והשומרון,3660,עמנואל,69,32,37,2,67,23,68,0,6%
2017-07,אזור יהודה והשומרון,3557,קדומים,28,16,12,9,19,3,27,0,1%
2017-07,אזור יהודה והשומרון,3611,קריית ארבע,100,65,35,16,84,38,97,5,3%
2017-07,אזור יהודה והשומרון,3640,קרני שומרון,70,34,36,25,45,4,70,1,2%
2017-07,הדרום,31,אופקים,979,397,582,57,922,438,945,46,8%
2017-07,הדרום,2600,אילת,948,490,458,61,887,314,886,49,3%
2017-07,הדרום,70,אשדוד,5572,2169,3403,683,4889,2173,5333,118,5%
2017-07,הדרום,7100,אשקלון,3700,1498,2202,417,3283,1543,3319,69,5%
2017-07,הדרום,9000,באר שבע,5571,2551,3020,768,4803,2711,5276,91,5%
2017-07,הדרום,2200,דימונה,1809,822,987,91,1718,1077,1707,32,9%
2017-07,הדרום,1303,חורה,535,228,307,7,528,452,513,3,14%
2017-07,הדרום,831,ירוחם,431,196,235,18,413,228,400,16,9%
2017-07,הדרום,1059,כסיפה,996,378,618,3,993,875,982,6,21%
2017-07,הדרום,1271,להבים,48,21,27,20,28,5,47,1,1%
2017-07,הדרום,1060,לקיה,650,268,382,4,646,523,626,5,16%
2017-07,הדרום,1268,מיתר,56,23,33,18,38,5,54,2,1%
2017-07,הדרום,99,מצפה רמון,224,82,142,21,203,130,214,16,9%
2017-07,הדרום,246,נתיבות,1221,470,751,63,1158,413,1159,67,8%
2017-07,הדרום,666,עומר,61,25,36,24,37,2,61,0,2%
2017-07,הדרום,2560,ערד,645,286,359,62,583,308,611,28,5%
2017-07,הדרום,1192,ערערה-בנגב,1115,461,654,5,1110,995,1087,1,26%
2017-07,הדרום,2630,קריית גת,1588,681,907,110,1478,632,1512,58,5%
2017-07,הדרום,1034,קריית מלאכי,728,313,415,15,713,297,697,38,6%
2017-07,הדרום,1161,רהט,2429,971,1458,12,2417,1719,2394,56,13%
2017-07,הדרום,1286,שגב-שלום,371,143,228,4,367,281,357,2,14%
2017-07,הדרום,1031,שדרות,1021,465,556,80,941,490,941,31,7%
2017-07,הדרום,1054,תל שבע,767,328,439,1,766,631,725,5,16%
2017-07,המרכז,182,אבן יהודה,141,63,78,48,93,19,141,0,2%
2017-07,המרכז,41,אליכין,65,30,35,7,58,15,61,3,3%
2017-07,המרכז,1309,אלעד,601,155,446,22,579,32,595,4,5%
2017-07,המרכז,2530,באר יעקב,260,91,169,70,190,36,256,4,3%
2017-07,המרכז,466,בית דגן,104,48,56,10,94,29,102,1,3%
2017-07,המרכז,1066,"בני עי""ש",144,66,78,22,122,36,142,3,4%
2017-07,המרכז,681,גבעת שמואל,256,138,118,97,159,36,253,1,2%
2017-07,המרכז,2550,גדרה,308,145,163,62,246,72,302,6,3%
2017-07,המרכז,627,ג'לג'וליה,73,34,39,2,71,38,72,2,2%
2017-07,המרכז,166,גן יבנה,321,127,194,54,267,71,313,2,3%
2017-07,המרכז,229,גני תקווה,221,111,110,78,143,24,219,1,3%
2017-07,המרכז,9700,הוד השרון,710,298,412,325,385,29,707,6,2%
2017-07,המרכז,1290,זמר,124,47,77,3,121,83,121,1,4%
2017-07,המרכז,2730,טייבה,964,438,526,27,937,688,821,30,5%
2017-07,המרכז,2720,טירה,191,89,102,14,177,55,182,4,2%
2017-07,המרכז,2660,יבנה,762,323,439,155,607,150,752,33,3%
2017-07,המרכז,9400,יהוד,356,155,201,95,261,33,349,4,2%
2017-07,המרכז,1224,כוכב יאיר,77,29,48,48,29,0,77,0,1%
2017-07,המרכז,633,כפר ברא,15,7,8,0,15,6,15,0,1%
2017-07,המרכז,168,כפר יונה,289,122,167,58,231,37,288,3,3%
2017-07,המרכז,6900,כפר סבא,1110,501,609,458,652,86,1090,15,2%
2017-07,המרכז,634,כפר קאסם,297,102,195,9,288,116,286,3,3%
2017-07,המרכז,7000,לוד,1714,808,906,141,1573,809,1672,36,5%
2017-07,המרכז,1200,מודיעין-מכבים-רעות*,887,382,505,364,523,40,878,21,2%
2017-07,המרכז,28,מזכרת בתיה,165,66,99,47,118,16,162,1,2%
2017-07,המרכז,7200,נס ציונה,683,314,369,182,501,145,673,10,3%
2017-07,המרכז,7400,נתניה,4041,1836,2205,488,3553,1125,3962,88,4%
2017-07,המרכז,587,סביון*,19,1,18,8,11,2,19,0,1%
2017-07,המרכז,171,פרדסייה,73,39,34,23,50,5,73,1,2%
2017-07,המרכז,7900,פתח תקווה,3696,1646,2050,747,2949,764,3600,54,3%
2017-07,המרכז,195,קדימה-צורן,262,114,148,75,187,30,261,4,2%
2017-07,המרכז,638,קלנסווה,331,166,165,10,321,217,302,8,4%
2017-07,המרכז,469,קריית עקרון,247,104,143,19,228,91,243,5,4%
2017-07,המרכז,2640,ראש העין,795,372,423,161,634,118,787,17,3%
2017-07,המרכז,8300,ראשון לציון,4040,1750,2290,841,3199,884,3987,66,3%
2017-07,המרכז,8400,רחובות,2392,918,1474,565,1827,622,2322,34,3%
2017-07,המרכז,8500,רמלה,1508,688,820,114,1394,537,1455,39,4%
2017-07,המרכז,8700,רעננה,697,309,388,309,388,39,690,8,2%
2017-07,המרכז,1304,שוהם,194,75,119,100,94,8,194,2,2%
2017-07,המרכז,154,תל מונד,137,59,78,47,90,16,137,1,2%
2017-07,הצפון,473,אבו סנאן,536,219,317,5,531,413,529,7,9%
2017-07,הצפון,478,אכסאל,408,173,235,13,395,349,405,1,7%
2017-07,הצפון,529,אעבלין,417,177,240,22,395,306,410,10,8%
2017-07,הצפון,482,בועיינה-נוג'ידאת,241,124,117,7,234,179,236,17,6%
2017-07,הצפון,4001,בוקעאתא,387,143,244,7,380,294,372,3,14%
2017-07,הצפון,998,ביר אל-מכסור,278,127,151,3,275,205,276,4,8%
2017-07,הצפון,480,בית ג'ן,361,94,267,9,352,232,346,2,7%
2017-07,הצפון,9200,בית שאן,682,285,397,23,659,284,659,46,7%
2017-07,הצפון,944,בסמת טבעון,164,66,98,4,160,108,155,1,5%
2017-07,הצפון,483,בענה,327,140,187,6,321,258,309,6,10%
2017-07,הצפון,1292,ג'דיידה-מכר,1041,468,573,6,1035,792,1026,13,12%
2017-07,הצפון,485,ג'ולס,177,48,129,5,172,113,177,0,6%
2017-07,הצפון,487,ג'ש (גוש חלב),46,20,26,3,43,23,46,1,3%
2017-07,הצפון,489,דבורייה,261,113,148,12,249,184,258,4,6%
2017-07,הצפון,490,דייר אל-אסד,335,137,198,14,321,252,323,4,6%
2017-07,הצפון,492,דייר חנא,528,223,305,18,510,383,523,4,11%
2017-07,הצפון,975,זרזיר,220,85,135,2,218,137,217,5,7%
2017-07,הצפון,496,חורפיש,91,42,49,5,86,50,87,1,3%
2017-07,הצפון,2034,חצור הגלילית,239,91,148,16,223,109,227,3,5%
2017-07,הצפון,6700,טבריה,1385,628,757,78,1307,649,1206,54,6%
2017-07,הצפון,962,טובא-זנגרייה,317,139,178,3,314,207,307,5,10%
2017-07,הצפון,498,טורעאן,362,153,209,8,354,284,355,2,6%
2017-07,הצפון,8900,טמרה,1238,567,671,24,1214,1019,1203,9,9%
2017-07,הצפון,1295,יאנוח-ג'ת,136,42,94,4,132,75,134,2,5%
2017-07,הצפון,46,יבנאל,110,59,51,7,103,64,90,2,6%
2017-07,הצפון,499,יפיע,500,209,291,19,481,368,493,2,6%
2017-07,הצפון,240,יקנעם עילית,433,183,250,89,344,89,419,27,4%
2017-07,הצפון,502,ירכא,379,147,232,2,377,283,377,5,7%
2017-07,הצפון,504,כאבול,450,220,230,10,440,359,431,3,9%
2017-07,הצפון,505,כאוכב אבו אל-היג'א,183,70,113,4,179,146,183,1,11%
2017-07,הצפון,1296,כסרא-סמיע,180,50,130,8,172,104,171,3,5%
2017-07,הצפון,978,כעביה-טבאש-חג'אג'רה,165,65,100,3,162,116,162,1,7%
2017-07,הצפון,1263,כפר ורדים,53,22,31,20,33,4,52,1,2%
2017-07,הצפון,507,כפר יאסיף,334,144,190,6,328,237,324,7,6%
2017-07,הצפון,508,כפר כמא,40,22,18,2,38,17,40,1,3%
2017-07,הצפון,509,כפר כנא,729,333,396,20,709,562,705,11,8%
2017-07,הצפון,510,כפר מנדא,618,322,296,9,609,456,611,9,9%
2017-07,הצפון,47,כפר תבור,42,14,28,16,26,3,42,0,2%
2017-07,הצפון,1139,כרמיאל,1347,556,791,287,1060,632,1241,45,5%
2017-07,הצפון,481,מגאר,1204,492,712,19,1185,950,1156,6,13%
2017-07,הצפון,516,מג'ד אל-כרום,429,184,245,10,419,306,415,8,7%
2017-07,הצפון,874,מגדל העמק,802,336,466,73,729,273,745,67,6%
2017-07,הצפון,4201,מג'דל שמס,406,144,262,9,397,300,389,3,8%
2017-07,הצפון,517,מזרעה,144,60,84,1,143,106,138,2,7%
2017-07,הצפון,4203,מסעדה,194,75,119,5,189,146,184,9,11%
2017-07,הצפון,518,מעיליא,38,17,21,7,31,16,37,1,2%
2017-07,הצפון,1063,מעלות-תרשיחא,748,375,373,84,664,360,699,39,6%
2017-07,הצפון,520,משהד,195,81,114,7,188,152,184,2,6%
2017-07,הצפון,9100,נהרייה,1714,841,873,190,1524,874,1610,66,5%
2017-07,הצפון,522,נחף,350,167,183,13,337,257,337,2,7%
2017-07,הצפון,7300,נצרת,2605,1114,1491,118,2487,1840,2581,25,8%
2017-07,הצפון,1061,נצרת עילית,1375,615,760,150,1225,608,1233,73,5%
2017-07,הצפון,525,סאג'ור,92,30,62,6,86,57,91,0,5%
2017-07,הצפון,7500,סח'נין,1627,699,928,43,1584,1332,1607,7,12%
2017-07,הצפון,4501,ע'ג'ר,80,27,53,1,79,55,78,0,8%
2017-07,הצפון,530,עיילבון,126,65,61,10,116,75,123,1,5%
2017-07,הצפון,511,עילוט,253,101,152,5,248,187,253,2,9%
2017-07,הצפון,532,עין מאהל,357,172,185,7,350,279,343,2,7%
2017-07,הצפון,7600,עכו,2747,1186,1561,138,2609,1904,2643,38,10%
2017-07,הצפון,7700,עפולה,1520,612,908,159,1361,500,1435,57,6%
2017-07,הצפון,531,עראבה,1174,502,672,37,1137,974,1160,11,12%
2017-07,הצפון,535,פסוטה,95,42,53,9,86,42,90,1,5%
2017-07,הצפון,536,פקיעין (בוקייעה),115,60,55,9,106,70,109,3,4%
2017-07,הצפון,8000,צפת,1006,488,518,96,910,596,930,14,7%
2017-07,הצפון,4100,קצרין,184,84,100,28,156,86,180,6,5%
2017-07,הצפון,2800,קריית שמונה,619,296,323,71,548,262,595,37,5%
2017-07,הצפון,543,ראמה,232,85,147,15,217,153,224,2,6%
2017-07,הצפון,26,ראש פינה,41,17,24,7,34,19,40,0,3%
2017-07,הצפון,542,ריינה,454,196,258,10,444,341,442,8,7%
2017-07,הצפון,122,רמת ישי,85,33,52,34,51,12,82,2,2%
2017-07,הצפון,913,שבלי - אום אל-גנם,184,80,104,8,176,110,182,4,7%
2017-07,הצפון,812,שלומי,197,73,124,14,183,101,191,3,5%
2017-07,הצפון,538,שעב,381,172,209,3,378,315,376,3,13%
2017-07,הצפון,8800,שפרעם,1263,529,734,39,1224,985,1229,22,7%
2017-07,חיפה,2710,אום אל-פחם,2673,1096,1577,29,2644,2118,2613,22,13%
2017-07,חיפה,1020,אור עקיבא,436,182,254,40,396,111,421,11,4%
2017-07,חיפה,6000,באקה אל-גרביה,566,282,284,16,550,332,562,24,5%
2017-07,חיפה,9800,בנימינה-גבעת עדה*,173,82,91,72,101,31,172,2,2%
2017-07,חיפה,1326,"בסמ""ה",341,161,180,5,336,260,336,5,9%
2017-07,חיפה,541,ג'סר א-זרקא,259,135,124,2,257,106,255,12,5%
2017-07,חיפה,628,ג'ת,204,111,93,11,193,117,203,7,4%
2017-07,חיפה,494,דאלית אל-כרמל,435,160,275,23,412,225,406,7,5%
2017-07,חיפה,9300,זכרון יעקב,264,122,142,108,156,29,263,4,2%
2017-07,חיפה,6500,חדרה,2099,919,1180,246,1853,650,1980,52,4%
2017-07,חיפה,4000,חיפה,5255,2424,2831,1120,4135,2346,4950,144,4%
2017-07,חיפה,1247,חריש,116,46,70,24,92,18,110,0,7%
2017-07,חיפה,2100,טירת כרמל,642,299,343,37,605,299,624,13,6%
2017-07,חיפה,654,כפר קרע,392,187,205,21,371,222,386,6,5%
2017-07,חיפה,1327,מעלה עירון,658,245,413,2,656,497,641,3,11%
2017-07,חיפה,2500,נשר,368,184,184,66,302,123,357,11,3%
2017-07,חיפה,534,עספיא,280,137,143,10,270,149,263,7,5%
2017-07,חיפה,637,ערערה,526,226,300,14,512,332,515,15,6%
2017-07,חיפה,537,פוריידיס,207,99,108,8,199,80,207,4,4%
2017-07,חיפה,7800,פרדס חנה-כרכור,696,318,378,168,528,119,680,26,3%
2017-07,חיפה,6800,קריית אתא,1457,612,845,110,1347,600,1424,38,5%
2017-07,חיפה,9500,קריית ביאליק,855,364,491,99,756,360,821,18,4%
2017-07,חיפה,2300,קריית טבעון,149,72,77,67,82,25,149,2,2%
2017-07,חיפה,9600,קריית ים,1225,568,657,123,1102,643,1181,30,6%
2017-07,חיפה,8200,קריית מוצקין,831,359,472,130,701,316,801,19,4%
2017-07,חיפה,922,רכסים,210,61,149,8,202,62,197,3,6%
2017-07,ירושלים,472,אבו גוש,196,89,107,3,193,149,193,10,6%
2017-07,ירושלים,2610,בית שמש,1561,522,1039,110,1451,402,1502,42,5%
2017-07,ירושלים,3000,ירושלים,11992,5013,6979,1439,10553,6514,11684,156,4%
2017-07,ירושלים,1015,מבשרת ציון,326,156,170,87,239,97,318,2,2%
2017-07,ירושלים,1137,קריית יערים,55,21,34,6,49,13,55,0,4%
2017-07,תל אביב,2400,אור יהודה,689,307,382,54,635,125,657,35,4%
2017-07,תל אביב,565,אזור,184,93,91,33,151,25,182,2,3%
2017-07,תל אביב,6100,בני ברק,2490,771,1719,96,2394,567,2390,15,4%
2017-07,תל אביב,6200,בת ים,2464,1173,1291,365,2099,790,2332,81,3%
2017-07,תל אביב,6300,גבעתיים,768,342,426,381,387,71,761,1,3%
2017-07,תל אביב,6400,הרצלייה,1080,476,604,416,664,46,1067,12,2%
2017-07,תל אביב,6600,חולון,2893,1235,1658,513,2380,564,2833,60,3%
2017-07,תל אביב,2620,קריית אונו,395,169,226,180,215,27,393,3,2%
2017-07,תל אביב,8600,רמת גן,2064,896,1168,733,1331,270,2035,29,3%
2017-07,תל אביב,2650,רמת השרון,448,183,265,216,232,14,447,3,2%
2017-07,תל אביב,5000,תל אביב -יפו,7111,3542,3569,2833,4278,1377,6980,74,3%
2017-08,אזור יהודה והשומרון,3760,אורנית,99,51,48,34,65,2,98,1,2%
2017-08,אזור יהודה והשומרון,3750,אלפי מנשה,83,41,42,25,58,0,83,2,2%
2017-08,אזור יהודה והשומרון,3560,אלקנה,33,17,16,18,15,1,33,0,2%
2017-08,אזור יהודה והשומרון,3650,אפרת,130,72,58,74,56,4,128,0,3%
2017-08,אזור יהודה והשומרון,3570,אריאל,276,119,157,70,206,24,275,9,3%
2017-08,אזור יהודה והשומרון,3574,בית אל,52,31,21,17,35,12,51,0,2%
2017-08,אזור יהודה והשומרון,3652,בית אריה,54,22,32,11,43,2,54,1,2%
2017-08,אזור יהודה והשומרון,3780,ביתר עילית,819,234,585,18,801,172,816,1,7%
2017-08,אזור יהודה והשומרון,3730,גבעת זאב,186,87,99,40,146,32,185,3,2%
2017-08,אזור יהודה והשומרון,3769,הר אדר,36,17,19,18,18,2,36,0,2%
2017-08,אזור יהודה והשומרון,3797,מודיעין עילית,1000,141,859,25,975,36,996,4,7%
2017-08,אזור יהודה והשומרון,3616,מעלה אדומים,656,282,374,99,557,153,647,10,3%
2017-08,אזור יהודה והשומרון,3660,עמנואל,74,32,42,4,70,21,73,2,6%
2017-08,אזור יהודה והשומרון,3557,קדומים,27,15,12,8,19,3,26,0,1%
2017-08,אזור יהודה והשומרון,3611,קריית ארבע,98,61,37,18,80,38,95,4,3%
2017-08,אזור יהודה והשומרון,3640,קרני שומרון,73,36,37,25,48,5,72,1,2%
2017-08,הדרום,31,אופקים,994,380,614,55,939,401,963,30,8%
2017-08,הדרום,2600,אילת,923,445,478,61,862,292,861,44,3%
2017-08,הדרום,70,אשדוד,5631,2139,3492,693,4938,2101,5395,103,5%
2017-08,הדרום,7100,אשקלון,3795,1496,2299,404,3391,1540,3411,64,5%
2017-08,הדרום,9000,באר שבע,5667,2547,3120,780,4887,2720,5376,81,5%
2017-08,הדרום,2200,דימונה,1831,804,1027,95,1736,1061,1739,45,10%
2017-08,הדרום,1303,חורה,519,223,296,7,512,443,501,3,13%
2017-08,הדרום,831,ירוחם,448,200,248,19,429,223,420,26,9%
2017-08,הדרום,1059,כסיפה,1013,386,627,3,1010,880,999,2,22%
2017-08,הדרום,1271,להבים,41,15,26,16,25,3,40,0,1%
2017-08,הדרום,1060,לקיה,628,270,358,8,620,507,605,5,16%
2017-08,הדרום,1268,מיתר,59,24,35,17,42,5,57,0,1%
2017-08,הדרום,99,מצפה רמון,233,89,144,18,215,130,225,13,9%
2017-08,הדרום,246,נתיבות,1217,452,765,75,1142,420,1160,61,8%
2017-08,הדרום,666,עומר,62,22,40,22,40,2,62,1,2%
2017-08,הדרום,2560,ערד,653,274,379,66,587,302,617,17,5%
2017-08,הדרום,1192,ערערה-בנגב,1115,461,654,7,1108,1006,1088,1,26%
2017-08,הדרום,2630,קריית גת,1585,631,954,93,1492,620,1521,36,5%
2017-08,הדרום,1034,קריית מלאכי,762,305,457,18,744,295,730,43,6%
2017-08,הדרום,1161,רהט,2259,908,1351,15,2244,1671,2225,59,12%
2017-08,הדרום,1286,שגב-שלום,381,134,247,1,380,288,369,2,15%
2017-08,הדרום,1031,שדרות,992,448,544,79,913,466,915,45,7%
2017-08,הדרום,1054,תל שבע,749,309,440,1,748,623,715,5,16%
2017-08,המרכז,182,אבן יהודה,157,67,90,55,102,18,157,0,2%
2017-08,המרכז,41,אליכין,59,27,32,7,52,14,57,1,3%
2017-08,המרכז,1309,אלעד,664,189,475,26,638,28,659,3,5%
2017-08,המרכז,2530,באר יעקב,276,95,181,66,210,35,272,3,3%
2017-08,המרכז,466,בית דגן,97,43,54,10,87,28,95,0,3%
2017-08,המרכז,1066,"בני עי""ש",156,65,91,20,136,41,150,4,4%
2017-08,המרכז,681,גבעת שמואל,250,129,121,85,165,34,247,2,2%
2017-08,המרכז,2550,גדרה,335,138,197,69,266,73,327,5,3%
2017-08,המרכז,627,ג'לג'וליה,72,32,40,2,70,40,68,0,2%
2017-08,המרכז,166,גן יבנה,328,127,201,54,274,68,321,7,3%
2017-08,המרכז,229,גני תקווה,224,103,121,80,144,26,223,1,3%
2017-08,המרכז,9700,הוד השרון,740,294,446,328,412,30,736,10,2%
2017-08,המרכז,1290,זמר,122,49,73,3,119,78,119,2,4%
2017-08,המרכז,2730,טייבה,941,422,519,28,913,654,782,29,5%
2017-08,המרכז,2720,טירה,193,83,110,18,175,44,186,6,2%
2017-08,המרכז,2660,יבנה,774,308,466,159,615,136,766,20,3%
2017-08,המרכז,9400,יהוד,376,160,216,93,283,31,366,7,2%
2017-08,המרכז,1224,כוכב יאיר,73,22,51,44,29,0,73,0,1%
2017-08,המרכז,633,כפר ברא,15,9,6,1,14,5,15,0,1%
2017-08,המרכז,168,כפר יונה,318,129,189,62,256,37,317,3,3%
2017-08,המרכז,6900,כפר סבא,1171,504,667,465,706,85,1155,20,2%
2017-08,המרכז,634,כפר קאסם,265,97,168,8,257,107,255,2,3%
2017-08,המרכז,7000,לוד,1734,808,926,146,1588,797,1694,34,5%
2017-08,המרכז,1200,מודיעין-מכבים-רעות*,981,399,582,391,590,38,967,22,2%
2017-08,המרכז,28,מזכרת בתיה,184,71,113,54,130,22,181,3,3%
2017-08,המרכז,7200,נס ציונה,690,303,387,195,495,140,681,8,3%
2017-08,המרכז,7400,נתניה,4315,1827,2488,505,3810,1095,4225,103,4%
2017-08,המרכז,587,סביון*,14,2,12,7,7,1,14,0,1%
2017-08,המרכז,171,פרדסייה,86,38,48,23,63,4,85,0,2%
2017-08,המרכז,7900,פתח תקווה,3839,1629,2210,757,3082,751,3747,42,3%
2017-08,המרכז,195,קדימה-צורן,258,111,147,83,175,33,255,0,2%
2017-08,המרכז,638,קלנסווה,328,164,164,10,318,212,295,11,4%
2017-08,המרכז,469,קריית עקרון,254,98,156,18,236,93,248,8,4%
2017-08,המרכז,2640,ראש העין,884,363,521,188,696,110,877,9,4%
2017-08,המרכז,8300,ראשון לציון,4002,1720,2282,859,3143,858,3967,70,3%
2017-08,המרכז,8400,רחובות,2509,926,1583,559,1950,641,2441,48,4%
2017-08,המרכז,8500,רמלה,1547,687,860,103,1444,520,1502,49,4%
2017-08,המרכז,8700,רעננה,738,336,402,325,413,33,732,6,2%
2017-08,המרכז,1304,שוהם,200,78,122,95,105,9,200,1,2%
2017-08,המרכז,154,תל מונד,143,51,92,50,93,15,143,0,2%
2017-08,הצפון,473,אבו סנאן,518,216,302,5,513,399,509,4,9%
2017-08,הצפון,478,אכסאל,411,178,233,17,394,348,407,1,7%
2017-08,הצפון,529,אעבלין,402,173,229,21,381,296,396,3,7%
2017-08,הצפון,482,בועיינה-נוג'ידאת,231,117,114,8,223,182,222,2,6%
2017-08,הצפון,4001,בוקעאתא,376,135,241,9,367,296,363,4,13%
2017-08,הצפון,998,ביר אל-מכסור,265,116,149,2,263,204,262,3,7%
2017-08,הצפון,480,בית ג'ן,352,90,262,12,340,223,334,2,6%
2017-08,הצפון,9200,בית שאן,700,306,394,24,676,296,675,46,7%
2017-08,הצפון,944,בסמת טבעון,156,64,92,5,151,104,148,1,5%
2017-08,הצפון,483,בענה,303,130,173,3,300,247,294,1,9%
2017-08,הצפון,1292,ג'דיידה-מכר,1064,476,588,5,1059,790,1045,10,12%
2017-08,הצפון,485,ג'ולס,166,48,118,3,163,102,165,0,6%
2017-08,הצפון,487,ג'ש (גוש חלב),46,22,24,4,42,24,45,0,3%
2017-08,הצפון,489,דבורייה,256,111,145,11,245,182,252,3,6%
2017-08,הצפון,490,דייר אל-אסד,336,131,205,10,326,242,324,3,6%
2017-08,הצפון,492,דייר חנא,510,215,295,16,494,370,506,6,11%
2017-08,הצפון,975,זרזיר,230,92,138,2,228,135,230,8,8%
2017-08,הצפון,496,חורפיש,90,42,48,5,85,49,86,1,3%
2017-08,הצפון,2034,חצור הגלילית,247,90,157,19,228,111,231,2,5%
2017-08,הצפון,6700,טבריה,1377,612,765,73,1304,650,1191,56,6%
2017-08,הצפון,962,טובא-זנגרייה,309,132,177,3,306,202,299,3,10%
2017-08,הצפון,498,טורעאן,364,148,216,7,357,279,353,6,6%
2017-08,הצפון,8900,טמרה,1237,572,665,24,1213,1007,1205,8,9%
2017-08,הצפון,1295,יאנוח-ג'ת,123,35,88,3,120,74,120,9,4%
2017-08,הצפון,46,יבנאל,119,59,60,6,113,59,97,2,6%
2017-08,הצפון,499,יפיע,500,205,295,24,476,366,492,2,6%
2017-08,הצפון,240,יקנעם עילית,431,173,258,95,336,91,415,26,4%
2017-08,הצפון,502,ירכא,372,146,226,1,371,274,367,2,7%
2017-08,הצפון,504,כאבול,431,206,225,11,420,346,419,8,9%
2017-08,הצפון,505,כאוכב אבו אל-היג'א,186,72,114,6,180,141,186,2,11%
2017-08,הצפון,1296,כסרא-סמיע,184,54,130,6,178,106,177,2,5%
2017-08,הצפון,978,כעביה-טבאש-חג'אג'רה,167,65,102,5,162,118,163,3,7%
2017-08,הצפון,1263,כפר ורדים,51,20,31,19,32,5,50,0,2%
2017-08,הצפון,507,כפר יאסיף,332,145,187,5,327,232,323,6,6%
2017-08,הצפון,508,כפר כמא,38,21,17,2,36,16,38,1,2%
2017-08,הצפון,509,כפר כנא,696,325,371,21,675,549,672,13,8%
2017-08,הצפון,510,כפר מנדא,658,349,309,7,651,458,647,5,9%
2017-08,הצפון,47,כפר תבור,44,15,29,17,27,3,43,0,2%
2017-08,הצפון,1139,כרמיאל,1358,541,817,290,1068,619,1248,48,5%
2017-08,הצפון,481,מגאר,1158,482,676,20,1138,918,1119,6,12%
2017-08,הצפון,516,מג'ד אל-כרום,431,189,242,13,418,298,419,4,7%
2017-08,הצפון,874,מגדל העמק,818,338,480,84,734,273,757,64,6%
2017-08,הצפון,4201,מג'דל שמס,394,141,253,10,384,302,373,4,8%
2017-08,הצפון,517,מזרעה,144,59,85,1,143,107,140,6,7%
2017-08,הצפון,4203,מסעדה,190,74,116,5,185,143,179,3,11%
2017-08,הצפון,518,מעיליא,44,21,23,8,36,19,43,1,3%
2017-08,הצפון,1063,מעלות-תרשיחא,788,377,411,84,704,364,745,38,6%
2017-08,הצפון,520,משהד,187,80,107,8,179,145,175,4,6%
2017-08,הצפון,9100,נהרייה,1712,839,873,187,1525,855,1610,70,5%
2017-08,הצפון,522,נחף,337,161,176,17,320,258,326,6,7%
2017-08,הצפון,7300,נצרת,2658,1126,1532,120,2538,1856,2628,17,8%
2017-08,הצפון,1061,נצרת עילית,1418,656,762,159,1259,617,1273,82,5%
2017-08,הצפון,525,סאג'ור,95,33,62,7,88,61,93,0,5%
2017-08,הצפון,7500,סח'נין,1583,667,916,43,1540,1289,1564,15,12%
2017-08,הצפון,4501,ע'ג'ר,77,25,52,0,77,52,76,0,8%
2017-08,הצפון,530,עיילבון,124,65,59,8,116,75,121,0,5%
2017-08,הצפון,511,עילוט,260,107,153,6,254,194,259,1,9%
2017-08,הצפון,532,עין מאהל,342,161,181,6,336,273,328,4,7%
2017-08,הצפון,7600,עכו,2766,1175,1591,138,2628,1870,2656,49,10%
2017-08,הצפון,7700,עפולה,1522,586,936,166,1356,502,1456,58,6%
2017-08,הצפון,531,עראבה,1151,495,656,40,1111,949,1138,18,12%
2017-08,הצפון,535,פסוטה,90,39,51,9,81,41,86,4,5%
2017-08,הצפון,536,פקיעין (בוקייעה),120,66,54,11,109,69,114,3,4%
2017-08,הצפון,8000,צפת,1019,475,544,96,923,579,956,20,7%
2017-08,הצפון,4100,קצרין,183,79,104,29,154,87,176,9,4%
2017-08,הצפון,2800,קריית שמונה,625,304,321,76,549,254,602,24,5%
2017-08,הצפון,543,ראמה,231,79,152,16,215,153,222,3,6%
2017-08,הצפון,26,ראש פינה,47,19,28,8,39,19,46,1,3%
2017-08,הצפון,542,ריינה,437,189,248,5,432,337,419,7,6%
2017-08,הצפון,122,רמת ישי,92,36,56,31,61,13,89,1,2%
2017-08,הצפון,913,שבלי - אום אל-גנם,176,73,103,10,166,105,175,6,7%
2017-08,הצפון,812,שלומי,207,71,136,15,192,106,195,4,5%
2017-08,הצפון,538,שעב,364,163,201,3,361,301,361,1,12%
2017-08,הצפון,8800,שפרעם,1277,515,762,39,1238,974,1243,24,7%
2017-08,חיפה,2710,אום אל-פחם,2614,1065,1549,30,2584,2058,2566,24,13%
2017-08,חיפה,1020,אור עקיבא,458,193,265,43,415,119,447,10,5%
2017-08,חיפה,6000,באקה אל-גרביה,583,279,304,21,562,339,579,26,5%
2017-08,חיפה,9800,בנימינה-גבעת עדה*,180,87,93,78,102,30,179,0,3%
2017-08,חיפה,1326,"בסמ""ה",328,151,177,4,324,253,325,5,8%
2017-08,חיפה,541,ג'סר א-זרקא,247,127,120,3,244,101,243,11,4%
2017-08,חיפה,628,ג'ת,192,101,91,12,180,116,190,7,4%
2017-08,חיפה,494,דאלית אל-כרמל,404,146,258,17,387,222,379,4,5%
2017-08,חיפה,9300,זכרון יעקב,257,120,137,105,152,31,255,3,2%
2017-08,חיפה,6500,חדרה,2078,913,1165,248,1830,634,1977,48,4%
2017-08,חיפה,4000,חיפה,5357,2416,2941,1087,4270,2287,5072,131,4%
2017-08,חיפה,1247,חריש,146,42,104,34,112,20,140,0,9%
2017-08,חיפה,2100,טירת כרמל,663,291,372,46,617,307,640,15,6%
2017-08,חיפה,654,כפר קרע,392,185,207,28,364,227,385,8,5%
2017-08,חיפה,1327,מעלה עירון,652,247,405,2,650,491,637,4,11%
2017-08,חיפה,2500,נשר,376,178,198,66,310,118,364,11,3%
2017-08,חיפה,534,עספיא,285,132,153,11,274,153,267,7,5%
2017-08,חיפה,637,ערערה,511,224,287,17,494,313,498,18,6%
2017-08,חיפה,537,פוריידיס,202,99,103,9,193,72,200,3,4%
2017-08,חיפה,7800,פרדס חנה-כרכור,720,321,399,182,538,128,702,21,4%
2017-08,חיפה,6800,קריית אתא,1539,610,929,115,1424,621,1496,39,5%
2017-08,חיפה,9500,קריית ביאליק,869,369,500,105,764,360,841,27,4%
2017-08,חיפה,2300,קריית טבעון,172,82,90,77,95,27,169,2,2%
2017-08,חיפה,9600,קריית ים,1235,579,656,119,1116,633,1188,34,6%
2017-08,חיפה,8200,קריית מוצקין,851,377,474,137,714,319,828,21,4%
2017-08,חיפה,922,רכסים,234,51,183,10,224,55,225,1,6%
2017-08,ירושלים,472,אבו גוש,191,86,105,3,188,147,189,2,6%
2017-08,ירושלים,2610,בית שמש,1588,520,1068,100,1488,412,1538,28,5%
2017-08,ירושלים,3000,ירושלים,12383,4979,7404,1500,10883,6357,12094,120,4%
2017-08,ירושלים,1015,מבשרת ציון,331,153,178,90,241,93,326,4,2%
2017-08,ירושלים,1137,קריית יערים,59,21,38,8,51,12,59,1,4%
2017-08,תל אביב,2400,אור יהודה,762,285,477,46,716,130,734,33,4%
2017-08,תל אביב,565,אזור,183,88,95,28,155,24,179,2,3%
2017-08,תל אביב,6100,בני ברק,2836,818,2018,96,2740,578,2721,12,5%
2017-08,תל אביב,6200,בת ים,2514,1152,1362,375,2139,781,2380,66,3%
2017-08,תל אביב,6300,גבעתיים,815,361,454,405,410,75,807,3,3%
2017-08,תל אביב,6400,הרצלייה,1131,467,664,420,711,43,1120,10,2%
2017-08,תל אביב,6600,חולון,2914,1226,1688,535,2379,574,2850,41,3%
2017-08,תל אביב,2620,קריית אונו,423,170,253,184,239,34,417,2,2%
2017-08,תל אביב,8600,רמת גן,2070,903,1167,732,1338,265,2044,18,3%
2017-08,תל אביב,2650,רמת השרון,483,188,295,223,260,15,481,4,2%
2017-08,תל אביב,5000,תל אביב -יפו,7139,3553,3586,2840,4299,1342,7022,64,3%
2017-09,אזור יהודה והשומרון,3760,אורנית,97,51,46,33,64,1,96,0,2%
2017-09,אזור יהודה והשומרון,3750,אלפי מנשה,87,44,43,29,58,0,87,1,2%
2017-09,אזור יהודה והשומרון,3560,אלקנה,28,17,11,15,13,0,28,0,1%
2017-09,אזור יהודה והשומרון,3650,אפרת,116,62,54,70,46,4,114,1,3%
2017-09,אזור יהודה והשומרון,3570,אריאל,274,124,150,69,205,22,272,7,3%
2017-09,אזור יהודה והשומרון,3574,בית אל,48,27,21,16,32,14,47,0,2%
2017-09,אזור יהודה והשומרון,3652,בית אריה,48,18,30,11,37,1,48,0,2%
2017-09,אזור יהודה והשומרון,3780,ביתר עילית,570,222,348,17,553,166,567,0,5%
2017-09,אזור יהודה והשומרון,3730,גבעת זאב,171,86,85,39,132,30,169,2,2%
2017-09,אזור יהודה והשומרון,3769,הר אדר,35,16,19,13,22,3,35,1,2%
2017-09,אזור יהודה והשומרון,3797,מודיעין עילית,524,131,393,21,503,34,515,3,4%
2017-09,אזור יהודה והשומרון,3616,מעלה אדומים,602,265,337,103,499,138,592,13,3%
2017-09,אזור יהודה והשומרון,3660,עמנואל,50,28,22,3,47,21,48,2,4%
2017-09,אזור יהודה והשומרון,3557,קדומים,36,17,19,14,22,2,36,1,2%
2017-09,אזור יהודה והשומרון,3611,קריית ארבע,89,51,38,15,74,38,84,6,3%
2017-09,אזור יהודה והשומרון,3640,קרני שומרון,63,34,29,27,36,3,63,1,2%
2017-09,הדרום,31,אופקים,857,348,509,49,808,394,828,35,7%
2017-09,הדרום,2600,אילת,904,444,460,62,842,297,840,51,3%
2017-09,הדרום,70,אשדוד,4983,2016,2967,651,4332,2049,4759,101,4%
2017-09,הדרום,7100,אשקלון,3570,1453,2117,408,3162,1516,3209,67,5%
2017-09,הדרום,9000,באר שבע,5384,2432,2952,780,4604,2599,5098,94,5%
2017-09,הדרום,2200,דימונה,1699,773,926,89,1610,1048,1608,25,9%
2017-09,הדרום,1303,חורה,501,208,293,3,498,428,480,3,13%
2017-09,הדרום,831,ירוחם,403,197,206,19,384,209,374,13,8%
2017-09,הדרום,1059,כסיפה,980,370,610,3,977,866,966,2,21%
2017-09,הדרום,1271,להבים,43,20,23,17,26,2,42,0,1%
2017-09,הדרום,1060,לקיה,564,251,313,8,556,484,548,7,14%
2017-09,הדרום,1268,מיתר,66,25,41,21,45,3,64,1,2%
2017-09,הדרום,99,מצפה רמון,227,88,139,16,211,125,215,16,9%
2017-09,הדרום,246,נתיבות,1014,416,598,69,945,417,953,53,7%
2017-09,הדרום,666,עומר,58,21,37,21,37,2,58,0,1%
2017-09,הדרום,2560,ערד,623,258,365,76,547,306,593,20,5%
2017-09,הדרום,1192,ערערה-בנגב,1091,451,640,7,1084,982,1062,2,25%
2017-09,הדרום,2630,קריית גת,1512,628,884,104,1408,600,1446,46,5%
2017-09,הדרום,1034,קריית מלאכי,695,290,405,11,684,281,666,38,6%
2017-09,הדרום,1161,רהט,2181,887,1294,11,2170,1623,2152,49,12%
2017-09,הדרום,1286,שגב-שלום,354,133,221,2,352,273,341,3,14%
2017-09,הדרום,1031,שדרות,930,428,502,72,858,451,860,26,7%
2017-09,הדרום,1054,תל שבע,709,307,402,2,707,602,672,6,15%
2017-09,המרכז,182,אבן יהודה,143,60,83,43,100,17,143,0,2%
2017-09,המרכז,41,אליכין,57,28,29,7,50,13,55,1,3%
2017-09,המרכז,1309,אלעד,388,131,257,21,367,25,382,4,3%
2017-09,המרכז,2530,באר יעקב,257,96,161,72,185,28,254,5,3%
2017-09,המרכז,466,בית דגן,89,39,50,10,79,29,86,1,2%
2017-09,המרכז,1066,"בני עי""ש",131,56,75,19,112,33,128,1,3%
2017-09,המרכז,681,גבעת שמואל,227,117,110,86,141,34,225,0,2%
2017-09,המרכז,2550,גדרה,310,133,177,67,243,67,302,4,3%
2017-09,המרכז,627,ג'לג'וליה,80,35,45,3,77,41,74,0,2%
2017-09,המרכז,166,גן יבנה,298,118,180,50,248,66,293,4,3%
2017-09,המרכז,229,גני תקווה,213,101,112,90,123,26,212,2,3%
2017-09,המרכז,9700,הוד השרון,631,265,366,302,329,22,630,7,2%
2017-09,המרכז,1290,זמר,126,51,75,5,121,73,123,4,4%
2017-09,המרכז,2730,טייבה,895,398,497,25,870,629,754,23,5%
2017-09,המרכז,2720,טירה,172,78,94,19,153,40,168,11,2%
2017-09,המרכז,2660,יבנה,710,296,414,155,555,135,708,19,3%
2017-09,המרכז,9400,יהוד,347,159,188,101,246,34,338,5,2%
2017-09,המרכז,1224,כוכב יאיר,68,27,41,46,22,0,68,0,1%
2017-09,המרכז,633,כפר ברא,12,8,4,2,10,4,12,1,1%
2017-09,המרכז,168,כפר יונה,280,122,158,56,224,43,279,2,3%
2017-09,המרכז,6900,כפר סבא,1089,484,605,437,652,77,1072,21,2%
2017-09,המרכז,634,כפר קאסם,180,83,97,6,174,94,175,5,2%
2017-09,המרכז,7000,לוד,1597,757,840,154,1443,775,1555,26,4%
2017-09,המרכז,1200,מודיעין-מכבים-רעות*,918,401,517,417,501,41,907,17,2%
2017-09,המרכז,28,מזכרת בתיה,141,63,78,56,85,23,138,3,2%
2017-09,המרכז,7200,נס ציונה,644,296,348,194,450,130,636,7,3%
2017-09,המרכז,7400,נתניה,3820,1739,2081,502,3318,1079,3749,63,4%
2017-09,המרכז,587,סביון*,21,6,15,11,10,0,21,0,1%
2017-09,המרכז,171,פרדסייה,79,34,45,26,53,3,78,1,2%
2017-09,המרכז,7900,פתח תקווה,3496,1567,1929,726,2770,766,3392,28,3%
2017-09,המרכז,195,קדימה-צורן,237,108,129,77,160,26,235,0,2%
2017-09,המרכז,638,קלנסווה,319,160,159,9,310,202,288,11,3%
2017-09,המרכז,469,קריית עקרון,203,95,108,20,183,80,196,3,3%
2017-09,המרכז,2640,ראש העין,753,344,409,191,562,104,745,11,3%
2017-09,המרכז,8300,ראשון לציון,3668,1632,2036,796,2872,830,3632,48,3%
2017-09,המרכז,8400,רחובות,2114,877,1237,532,1582,596,2048,46,3%
2017-09,המרכז,8500,רמלה,1376,629,747,96,1280,514,1323,65,4%
2017-09,המרכז,8700,רעננה,705,315,390,330,375,32,697,11,2%
2017-09,המרכז,1304,שוהם,187,69,118,89,98,7,186,1,2%
2017-09,המרכז,154,תל מונד,143,57,86,47,96,19,143,0,2%
2017-09,הצפון,473,אבו סנאן,516,215,301,6,510,393,508,2,9%
2017-09,הצפון,478,אכסאל,404,177,227,12,392,349,400,3,7%
2017-09,הצפון,529,אעבלין,405,181,224,18,387,299,395,9,7%
2017-09,הצפון,482,בועיינה-נוג'ידאת,220,105,115,7,213,177,217,3,6%
2017-09,הצפון,4001,בוקעאתא,360,121,239,9,351,288,345,2,13%
2017-09,הצפון,998,ביר אל-מכסור,252,106,146,2,250,194,247,2,7%
2017-09,הצפון,480,בית ג'ן,350,93,257,12,338,225,336,1,6%
2017-09,הצפון,9200,בית שאן,679,283,396,24,655,292,663,45,7%
2017-09,הצפון,944,בסמת טבעון,154,64,90,6,148,98,144,2,5%
2017-09,הצפון,483,בענה,291,122,169,3,288,241,283,7,9%
2017-09,הצפון,1292,ג'דיידה-מכר,989,438,551,5,984,752,973,15,11%
2017-09,הצפון,485,ג'ולס,157,46,111,2,155,100,157,1,6%
2017-09,הצפון,487,ג'ש (גוש חלב),46,17,29,6,40,20,45,2,3%
2017-09,הצפון,489,דבורייה,234,98,136,12,222,173,232,0,6%
2017-09,הצפון,490,דייר אל-אסד,308,135,173,10,298,230,300,2,6%
2017-09,הצפון,492,דייר חנא,492,214,278,17,475,362,487,3,10%
2017-09,הצפון,975,זרזיר,202,82,120,2,200,124,200,6,7%
2017-09,הצפון,496,חורפיש,85,39,46,6,79,45,82,1,3%
2017-09,הצפון,2034,חצור הגלילית,258,91,167,20,238,110,239,6,5%
2017-09,הצפון,6700,טבריה,1311,580,731,78,1233,638,1122,63,5%
2017-09,הצפון,962,טובא-זנגרייה,277,124,153,3,274,196,267,0,9%
2017-09,הצפון,498,טורעאן,342,146,196,8,334,270,333,1,6%
2017-09,הצפון,8900,טמרה,1170,548,622,16,1154,961,1147,8,9%
2017-09,הצפון,1295,יאנוח-ג'ת,112,32,80,2,110,65,110,0,4%
2017-09,הצפון,46,יבנאל,91,48,43,6,85,55,73,2,5%
2017-09,הצפון,499,יפיע,497,204,293,23,474,355,489,4,6%
2017-09,הצפון,240,יקנעם עילית,379,150,229,87,292,91,369,25,3%
2017-09,הצפון,502,ירכא,354,141,213,1,353,255,347,1,6%
2017-09,הצפון,504,כאבול,392,195,197,7,385,318,380,4,8%
2017-09,הצפון,505,כאוכב אבו אל-היג'א,188,75,113,7,181,138,188,2,11%
2017-09,הצפון,1296,כסרא-סמיע,184,52,132,5,179,107,175,5,5%
2017-09,הצפון,978,כעביה-טבאש-חג'אג'רה,162,69,93,5,157,111,157,2,7%
2017-09,הצפון,1263,כפר ורדים,50,18,32,21,29,4,49,0,2%
2017-09,הצפון,507,כפר יאסיף,330,147,183,3,327,234,320,7,6%
2017-09,הצפון,508,כפר כמא,35,16,19,1,34,16,35,0,2%
2017-09,הצפון,509,כפר כנא,665,318,347,22,643,537,640,8,8%
2017-09,הצפון,510,כפר מנדא,621,339,282,13,608,442,617,2,9%
2017-09,הצפון,47,כפר תבור,38,11,27,14,24,1,38,0,2%
2017-09,הצפון,1139,כרמיאל,1378,544,834,283,1095,613,1277,45,5%
2017-09,הצפון,481,מגאר,1107,457,650,17,1090,879,1078,9,12%
2017-09,הצפון,516,מג'ד אל-כרום,414,183,231,11,403,286,403,10,6%
2017-09,הצפון,874,מגדל העמק,761,304,457,89,672,281,716,52,5%
2017-09,הצפון,4201,מג'דל שמס,391,134,257,9,382,301,365,3,8%
2017-09,הצפון,517,מזרעה,151,64,87,2,149,103,145,1,8%
2017-09,הצפון,4203,מסעדה,179,65,114,6,173,143,169,2,10%
2017-09,הצפון,518,מעיליא,34,19,15,5,29,16,33,0,2%
2017-09,הצפון,1063,מעלות-תרשיחא,702,342,360,76,626,342,669,38,6%
2017-09,הצפון,520,משהד,169,68,101,8,161,132,164,2,5%
2017-09,הצפון,9100,נהרייה,1655,794,861,201,1454,820,1566,65,5%
2017-09,הצפון,522,נחף,330,153,177,14,316,246,323,4,7%
2017-09,הצפון,7300,נצרת,2518,1092,1426,124,2394,1855,2492,22,7%
2017-09,הצפון,1061,נצרת עילית,1339,620,719,158,1181,608,1198,70,5%
2017-09,הצפון,525,סאג'ור,93,35,58,6,87,60,91,0,5%
2017-09,הצפון,7500,סח'נין,1544,656,888,38,1506,1263,1529,11,11%
2017-09,הצפון,4501,ע'ג'ר,75,26,49,0,75,50,73,0,7%
2017-09,הצפון,530,עיילבון,121,59,62,5,116,78,117,0,4%
2017-09,הצפון,511,עילוט,251,103,148,4,247,195,250,1,9%
2017-09,הצפון,532,עין מאהל,332,158,174,4,328,262,321,1,6%
2017-09,הצפון,7600,עכו,2501,1113,1388,136,2365,1797,2403,42,9%
2017-09,הצפון,7700,עפולה,1426,557,869,168,1258,505,1363,54,6%
2017-09,הצפון,531,עראבה,1140,489,651,33,1107,940,1129,8,12%
2017-09,הצפון,535,פסוטה,76,34,42,9,67,39,73,2,4%
2017-09,הצפון,536,פקיעין (בוקייעה),114,62,52,7,107,68,110,2,4%
2017-09,הצפון,8000,צפת,962,466,496,92,870,550,904,15,7%
2017-09,הצפון,4100,קצרין,179,77,102,28,151,78,174,6,4%
2017-09,הצפון,2800,קריית שמונה,612,295,317,85,527,253,591,24,5%
2017-09,הצפון,543,ראמה,229,87,142,13,216,161,220,4,6%
2017-09,הצפון,26,ראש פינה,52,17,35,8,44,19,51,0,3%
2017-09,הצפון,542,ריינה,413,181,232,7,406,321,399,3,6%
2017-09,הצפון,122,רמת ישי,92,31,61,33,59,14,89,0,2%
2017-09,הצפון,913,שבלי - אום אל-גנם,165,64,101,10,155,102,163,2,6%
2017-09,הצפון,812,שלומי,191,77,114,14,177,94,183,2,5%
2017-09,הצפון,538,שעב,354,158,196,3,351,293,352,0,12%
2017-09,הצפון,8800,שפרעם,1212,508,704,37,1175,926,1184,20,7%
2017-09,חיפה,2710,אום אל-פחם,2518,1021,1497,33,2485,2024,2476,30,12%
2017-09,חיפה,1020,אור עקיבא,427,163,264,44,383,111,408,13,4%
2017-09,חיפה,6000,באקה אל-גרביה,569,274,295,23,546,329,559,12,5%
2017-09,חיפה,9800,בנימינה-גבעת עדה*,171,79,92,74,97,29,168,2,2%
2017-09,חיפה,1326,"בסמ""ה",321,152,169,4,317,251,318,3,8%
2017-09,חיפה,541,ג'סר א-זרקא,222,123,99,1,221,87,221,12,4%
2017-09,חיפה,628,ג'ת,188,97,91,14,174,107,186,4,4%
2017-09,חיפה,494,דאלית אל-כרמל,387,136,251,15,372,213,364,10,5%
2017-09,חיפה,9300,זכרון יעקב,261,123,138,114,147,30,259,5,2%
2017-09,חיפה,6500,חדרה,2051,897,1154,258,1793,620,1950,47,4%
2017-09,חיפה,4000,חיפה,4979,2357,2622,1061,3918,2198,4723,106,3%
2017-09,חיפה,1247,חריש,178,52,126,48,130,22,174,0,11%
2017-09,חיפה,2100,טירת כרמל,649,289,360,47,602,306,630,12,6%
2017-09,חיפה,654,כפר קרע,395,188,207,28,367,227,388,11,5%
2017-09,חיפה,1327,מעלה עירון,622,250,372,6,616,477,610,5,11%
2017-09,חיפה,2500,נשר,363,177,186,67,296,110,353,9,3%
2017-09,חיפה,534,עספיא,296,127,169,12,284,151,279,5,5%
2017-09,חיפה,637,ערערה,500,210,290,19,481,314,491,10,6%
2017-09,חיפה,537,פוריידיס,192,105,87,10,182,70,191,3,4%
2017-09,חיפה,7800,פרדס חנה-כרכור,719,294,425,196,523,122,699,13,4%
2017-09,חיפה,6800,קריית אתא,1335,598,737,110,1225,596,1297,38,4%
2017-09,חיפה,9500,קריית ביאליק,833,356,477,94,739,345,809,20,4%
2017-09,חיפה,2300,קריית טבעון,172,75,97,76,96,24,166,1,2%
2017-09,חיפה,9600,קריית ים,1203,574,629,113,1090,629,1152,25,5%
2017-09,חיפה,8200,קריית מוצקין,832,374,458,142,690,305,809,20,4%
2017-09,חיפה,922,רכסים,153,54,99,10,143,56,142,1,4%
2017-09,ירושלים,472,אבו גוש,198,92,106,6,192,148,197,3,7%
2017-09,ירושלים,2610,בית שמש,1308,502,806,101,1207,402,1263,18,4%
2017-09,ירושלים,3000,ירושלים,10923,4761,6162,1446,9477,6254,10663,123,4%
2017-09,ירושלים,1015,מבשרת ציון,307,152,155,81,226,93,302,7,2%
2017-09,ירושלים,1137,קריית יערים,53,21,32,10,43,13,53,0,4%
2017-09,תל אביב,2400,אור יהודה,638,275,363,52,586,123,616,42,3%
2017-09,תל אביב,565,אזור,155,75,80,29,126,23,153,1,2%
2017-09,תל אביב,6100,בני ברק,1764,761,1003,98,1666,560,1661,20,3%
2017-09,תל אביב,6200,בת ים,2397,1115,1282,358,2039,800,2268,74,3%
2017-09,תל אביב,6300,גבעתיים,769,343,426,389,380,71,763,4,3%
2017-09,תל אביב,6400,הרצלייה,1040,443,597,415,625,44,1030,7,2%
2017-09,תל אביב,6600,חולון,2821,1201,1620,544,2277,545,2760,33,3%
2017-09,תל אביב,2620,קריית אונו,411,170,241,190,221,32,401,2,2%
2017-09,תל אביב,8600,רמת גן,1897,843,1054,706,1191,272,1869,8,2%
2017-09,תל אביב,2650,רמת השרון,439,170,269,219,220,16,432,2,2%
2017-09,תל אביב,5000,תל אביב -יפו,6874,3382,3492,2858,4016,1255,6774,40,3%
2017-10,אזור יהודה והשומרון,3760,אורנית,89,49,40,32,57,1,88,0,2%
2017-10,אזור יהודה והשומרון,3750,אלפי מנשה,78,39,39,26,52,1,78,0,2%
2017-10,אזור יהודה והשומרון,3560,אלקנה,30,18,12,20,10,0,30,0,2%
2017-10,אזור יהודה והשומרון,3650,אפרת,120,62,58,64,56,4,118,0,3%
2017-10,אזור יהודה והשומרון,3570,אריאל,265,111,154,65,200,24,264,9,3%
2017-10,אזור יהודה והשומרון,3574,בית אל,38,26,12,12,26,7,37,0,2%
2017-10,אזור יהודה והשומרון,3652,בית אריה,49,20,29,11,38,0,49,1,2%
2017-10,אזור יהודה והשומרון,3780,ביתר עילית,476,216,260,12,464,151,471,3,4%
2017-10,אזור יהודה והשומרון,3730,גבעת זאב,169,82,87,36,133,27,168,1,2%
2017-10,אזור יהודה והשומרון,3769,הר אדר,42,19,23,15,27,3,42,0,2%
2017-10,אזור יהודה והשומרון,3797,מודיעין עילית,464,138,326,27,437,32,461,1,4%
2017-10,אזור יהודה והשומרון,3616,מעלה אדומים,561,251,310,104,457,129,552,10,3%
2017-10,אזור יהודה והשומרון,3660,עמנואל,49,27,22,3,46,21,47,1,4%
2017-10,אזור יהודה והשומרון,3557,קדומים,37,18,19,14,23,2,37,0,2%
2017-10,אזור יהודה והשומרון,3611,קריית ארבע,84,44,40,14,70,35,83,2,3%
2017-10,אזור יהודה והשומרון,3640,קרני שומרון,60,32,28,23,37,3,59,0,2%
2017-10,הדרום,31,אופקים,815,355,460,45,770,375,784,28,6%
2017-10,הדרום,2600,אילת,901,471,430,52,849,282,841,44,3%
2017-10,הדרום,70,אשדוד,4873,2004,2869,630,4243,2014,4633,116,4%
2017-10,הדרום,7100,אשקלון,3366,1418,1948,398,2968,1401,3047,63,4%
2017-10,הדרום,9000,באר שבע,5365,2461,2904,761,4604,2593,5075,80,5%
2017-10,הדרום,2200,דימונה,1676,751,925,86,1590,1046,1586,39,9%
2017-10,הדרום,1303,חורה,490,196,294,3,487,424,474,3,13%
2017-10,הדרום,831,ירוחם,411,200,211,17,394,210,383,15,8%
2017-10,הדרום,1059,כסיפה,985,371,614,3,982,875,968,10,21%
2017-10,הדרום,1271,להבים,39,18,21,15,24,0,38,0,1%
2017-10,הדרום,1060,לקיה,544,237,307,5,539,477,523,1,14%
2017-10,הדרום,1268,מיתר,60,22,38,21,39,4,58,0,1%
2017-10,הדרום,99,מצפה רמון,214,78,136,19,195,134,204,12,8%
2017-10,הדרום,246,נתיבות,951,410,541,64,887,401,894,36,6%
2017-10,הדרום,666,עומר,55,18,37,17,38,2,54,1,1%
2017-10,הדרום,2560,ערד,624,269,355,75,549,304,590,22,5%
2017-10,הדרום,1192,ערערה-בנגב,1071,444,627,9,1062,954,1046,23,25%
2017-10,הדרום,2630,קריית גת,1458,634,824,93,1365,592,1402,46,5%
2017-10,הדרום,1034,קריית מלאכי,703,300,403,12,691,284,669,46,6%
2017-10,הדרום,1161,רהט,2182,900,1282,8,2174,1608,2154,47,12%
2017-10,הדרום,1286,שגב-שלום,339,124,215,2,337,267,327,5,13%
2017-10,הדרום,1031,שדרות,910,413,497,69,841,441,849,44,7%
2017-10,הדרום,1054,תל שבע,691,306,385,4,687,595,654,5,15%
2017-10,המרכז,182,אבן יהודה,144,61,83,50,94,18,143,0,2%
2017-10,המרכז,41,אליכין,53,25,28,6,47,12,51,1,3%
2017-10,המרכז,1309,אלעד,351,131,220,20,331,32,343,1,3%
2017-10,המרכז,2530,באר יעקב,266,101,165,70,196,31,259,2,3%
2017-10,המרכז,466,בית דגן,93,39,54,13,80,26,90,0,3%
2017-10,המרכז,1066,"בני עי""ש",133,55,78,21,112,34,128,4,3%
2017-10,המרכז,681,גבעת שמואל,230,112,118,89,141,32,225,1,2%
2017-10,המרכז,2550,גדרה,305,138,167,70,235,66,298,7,3%
2017-10,המרכז,627,ג'לג'וליה,71,34,37,3,68,33,71,0,2%
2017-10,המרכז,166,גן יבנה,272,107,165,44,228,56,267,9,2%
2017-10,המרכז,229,גני תקווה,201,98,103,78,123,26,201,0,2%
2017-10,המרכז,9700,הוד השרון,647,255,392,292,355,30,640,5,2%
2017-10,המרכז,1290,זמר,128,51,77,5,123,75,124,1,4%
2017-10,המרכז,2730,טייבה,877,398,479,20,857,628,743,20,4%
2017-10,המרכז,2720,טירה,169,75,94,15,154,44,167,9,1%
2017-10,המרכז,2660,יבנה,695,318,377,156,539,135,684,22,3%
2017-10,המרכז,9400,יהוד,348,155,193,96,252,42,336,7,2%
2017-10,המרכז,1224,כוכב יאיר,75,25,50,46,29,0,75,1,1%
2017-10,המרכז,633,כפר ברא,13,7,6,2,11,3,13,0,1%
2017-10,המרכז,168,כפר יונה,289,121,168,54,235,45,286,2,3%
2017-10,המרכז,6900,כפר סבא,1056,463,593,388,668,85,1041,10,2%
2017-10,המרכז,634,כפר קאסם,170,87,83,5,165,86,165,3,2%
2017-10,המרכז,7000,לוד,1550,764,786,139,1411,747,1509,17,4%
2017-10,המרכז,1200,מודיעין-מכבים-רעות*,861,367,494,398,463,35,851,6,2%
2017-10,המרכז,28,מזכרת בתיה,137,53,84,50,87,21,133,4,2%
2017-10,המרכז,7200,נס ציונה,612,290,322,188,424,127,606,3,3%
2017-10,המרכז,7400,נתניה,3784,1761,2023,474,3310,1071,3701,61,4%
2017-10,המרכז,587,סביון*,22,5,17,12,10,0,22,0,1%
2017-10,המרכז,171,פרדסייה,71,31,40,23,48,4,70,0,2%
2017-10,המרכז,7900,פתח תקווה,3527,1589,1938,724,2803,776,3434,31,3%
2017-10,המרכז,195,קדימה-צורן,241,116,125,77,164,27,239,0,2%
2017-10,המרכז,638,קלנסווה,324,167,157,8,316,208,294,10,4%
2017-10,המרכז,469,קריית עקרון,202,96,106,18,184,77,198,2,3%
2017-10,המרכז,2640,ראש העין,732,332,400,175,557,107,724,6,3%
2017-10,המרכז,8300,ראשון לציון,3648,1585,2063,793,2855,810,3610,40,3%
2017-10,המרכז,8400,רחובות,2095,907,1188,530,1565,581,2030,45,3%
2017-10,המרכז,8500,רמלה,1392,667,725,93,1299,505,1335,37,4%
2017-10,המרכז,8700,רעננה,690,308,382,312,378,36,681,1,2%
2017-10,המרכז,1304,שוהם,173,72,101,82,91,7,172,0,2%
2017-10,המרכז,154,תל מונד,150,62,88,47,103,16,150,1,2%
2017-10,הצפון,473,אבו סנאן,512,209,303,7,505,383,504,8,9%
2017-10,הצפון,478,אכסאל,399,182,217,11,388,337,397,1,7%
2017-10,הצפון,529,אעבלין,378,169,209,10,368,285,372,4,7%
2017-10,הצפון,482,בועיינה-נוג'ידאת,213,108,105,6,207,168,209,2,6%
2017-10,הצפון,4001,בוקעאתא,349,117,232,8,341,283,332,2,12%
2017-10,הצפון,998,ביר אל-מכסור,244,107,137,1,243,189,239,3,7%
2017-10,הצפון,480,בית ג'ן,357,98,259,10,347,232,342,1,7%
2017-10,הצפון,9200,בית שאן,643,275,368,19,624,281,627,31,6%
2017-10,הצפון,944,בסמת טבעון,143,62,81,3,140,100,135,3,4%
2017-10,הצפון,483,בענה,294,126,168,4,290,247,280,2,9%
2017-10,הצפון,1292,ג'דיידה-מכר,986,435,551,3,983,746,966,9,11%
2017-10,הצפון,485,ג'ולס,157,47,110,3,154,102,157,2,6%
2017-10,הצפון,487,ג'ש (גוש חלב),45,18,27,7,38,20,44,0,3%
2017-10,הצפון,489,דבורייה,244,110,134,13,231,172,239,3,6%
2017-10,הצפון,490,דייר אל-אסד,304,137,167,10,294,232,299,0,6%
2017-10,הצפון,492,דייר חנא,487,215,272,15,472,353,486,3,10%
2017-10,הצפון,975,זרזיר,186,73,113,2,184,125,183,4,6%
2017-10,הצפון,496,חורפיש,87,37,50,5,82,47,82,1,3%
2017-10,הצפון,2034,חצור הגלילית,248,99,149,17,231,114,226,4,5%
2017-10,הצפון,6700,טבריה,1316,627,689,83,1233,620,1143,39,5%
2017-10,הצפון,962,טובא-זנגרייה,285,126,159,6,279,201,275,3,9%
2017-10,הצפון,498,טורעאן,307,132,175,8,299,256,303,2,6%
2017-10,הצפון,8900,טמרה,1164,532,632,16,1148,942,1137,10,9%
2017-10,הצפון,1295,יאנוח-ג'ת,109,29,80,2,107,65,105,0,4%
2017-10,הצפון,46,יבנאל,85,46,39,6,79,52,70,3,5%
2017-10,הצפון,499,יפיע,483,200,283,22,461,354,473,7,6%
2017-10,הצפון,240,יקנעם עילית,378,161,217,88,290,88,365,16,3%
2017-10,הצפון,502,ירכא,358,142,216,0,358,253,351,2,6%
2017-10,הצפון,504,כאבול,386,193,193,6,380,318,378,2,8%
2017-10,הצפון,505,כאוכב אבו אל-היג'א,178,65,113,7,171,137,177,2,11%
2017-10,הצפון,1296,כסרא-סמיע,159,47,112,5,154,97,155,2,5%
2017-10,הצפון,978,כעביה-טבאש-חג'אג'רה,156,66,90,6,150,109,154,0,7%
2017-10,הצפון,1263,כפר ורדים,53,15,38,23,30,4,52,0,2%
2017-10,הצפון,507,כפר יאסיף,331,144,187,2,329,232,318,5,6%
2017-10,הצפון,508,כפר כמא,35,14,21,2,33,17,35,0,2%
2017-10,הצפון,509,כפר כנא,633,308,325,15,618,512,611,5,7%
2017-10,הצפון,510,כפר מנדא,574,327,247,10,564,413,567,2,8%
2017-10,הצפון,47,כפר תבור,40,12,28,13,27,1,40,0,2%
2017-10,הצפון,1139,כרמיאל,1361,540,821,288,1073,608,1247,32,5%
2017-10,הצפון,481,מגאר,1082,459,623,13,1069,876,1049,11,12%
2017-10,הצפון,516,מג'ד אל-כרום,397,180,217,12,385,275,387,8,6%
2017-10,הצפון,874,מגדל העמק,755,316,439,88,667,284,704,43,5%
2017-10,הצפון,4201,מג'דל שמס,373,137,236,9,364,294,353,1,8%
2017-10,הצפון,517,מזרעה,156,66,90,3,153,105,147,5,8%
2017-10,הצפון,4203,מסעדה,186,65,121,6,180,143,178,0,11%
2017-10,הצפון,518,מעיליא,38,19,19,5,33,18,35,1,2%
2017-10,הצפון,1063,מעלות-תרשיחא,683,332,351,78,605,331,645,29,5%
2017-10,הצפון,520,משהד,161,70,91,8,153,123,155,2,5%
2017-10,הצפון,9100,נהרייה,1632,760,872,198,1434,807,1553,36,5%
2017-10,הצפון,522,נחף,330,155,175,14,316,243,324,5,7%
2017-10,הצפון,7300,נצרת,2416,1072,1344,95,2321,1812,2389,10,7%
2017-10,הצפון,1061,נצרת עילית,1264,602,662,126,1138,573,1130,74,5%
2017-10,הצפון,525,סאג'ור,86,34,52,5,81,59,85,0,5%
2017-10,הצפון,7500,סח'נין,1508,650,858,33,1475,1235,1494,17,11%
2017-10,הצפון,4501,ע'ג'ר,77,31,46,1,76,51,75,2,7%
2017-10,הצפון,530,עיילבון,130,64,66,7,123,73,127,1,5%
2017-10,הצפון,511,עילוט,238,100,138,4,234,184,238,2,9%
2017-10,הצפון,532,עין מאהל,331,162,169,6,325,267,319,0,6%
2017-10,הצפון,7600,עכו,2424,1098,1326,127,2297,1747,2338,31,9%
2017-10,הצפון,7700,עפולה,1380,557,823,164,1216,502,1304,54,5%
2017-10,הצפון,531,עראבה,1101,472,629,25,1076,910,1089,10,11%
2017-10,הצפון,535,פסוטה,78,39,39,8,70,41,75,2,5%
2017-10,הצפון,536,פקיעין (בוקייעה),117,62,55,6,111,72,111,4,4%
2017-10,הצפון,8000,צפת,926,459,467,90,836,564,865,9,7%
2017-10,הצפון,4100,קצרין,177,80,97,27,150,77,171,1,4%
2017-10,הצפון,2800,קריית שמונה,636,299,337,80,556,257,613,20,5%
2017-10,הצפון,543,ראמה,213,87,126,10,203,154,204,2,5%
2017-10,הצפון,26,ראש פינה,50,16,34,11,39,20,48,0,3%
2017-10,הצפון,542,ריינה,378,173,205,5,373,308,365,4,6%
2017-10,הצפון,122,רמת ישי,86,30,56,30,56,11,85,0,2%
2017-10,הצפון,913,שבלי - אום אל-גנם,156,65,91,6,150,96,153,2,6%
2017-10,הצפון,812,שלומי,193,79,114,16,177,99,184,5,5%
2017-10,הצפון,538,שעב,355,163,192,1,354,284,353,3,12%
2017-10,הצפון,8800,שפרעם,1201,500,701,41,1160,895,1170,14,7%
2017-10,חיפה,2710,אום אל-פחם,2477,1008,1469,31,2446,2016,2431,24,12%
2017-10,חיפה,1020,אור עקיבא,410,171,239,38,372,106,398,12,4%
2017-10,חיפה,6000,באקה אל-גרביה,539,252,287,19,520,321,529,15,5%
2017-10,חיפה,9800,בנימינה-גבעת עדה*,169,81,88,71,98,25,167,1,2%
2017-10,חיפה,1326,"בסמ""ה",313,146,167,4,309,245,310,2,8%
2017-10,חיפה,541,ג'סר א-זרקא,228,122,106,1,227,91,224,6,4%
2017-10,חיפה,628,ג'ת,189,99,90,15,174,104,188,5,4%
2017-10,חיפה,494,דאלית אל-כרמל,377,143,234,16,361,214,357,6,5%
2017-10,חיפה,9300,זכרון יעקב,246,116,130,110,136,28,245,4,2%
2017-10,חיפה,6500,חדרה,1960,875,1085,242,1718,591,1857,34,4%
2017-10,חיפה,4000,חיפה,4989,2347,2642,1071,3918,2240,4720,114,3%
2017-10,חיפה,1247,חריש,194,58,136,54,140,24,188,4,12%
2017-10,חיפה,2100,טירת כרמל,628,289,339,41,587,300,610,7,6%
2017-10,חיפה,654,כפר קרע,379,173,206,26,353,228,371,5,4%
2017-10,חיפה,1327,מעלה עירון,603,242,361,7,596,473,588,0,11%
2017-10,חיפה,2500,נשר,359,176,183,67,292,122,347,3,3%
2017-10,חיפה,534,עספיא,318,140,178,14,304,155,300,5,6%
2017-10,חיפה,637,ערערה,503,210,293,20,483,313,492,8,6%
2017-10,חיפה,537,פוריידיס,203,116,87,8,195,68,201,2,4%
2017-10,חיפה,7800,פרדס חנה-כרכור,686,297,389,179,507,119,668,16,3%
2017-10,חיפה,6800,קריית אתא,1273,568,705,105,1168,548,1240,37,4%
2017-10,חיפה,9500,קריית ביאליק,799,341,458,98,701,322,777,22,4%
2017-10,חיפה,2300,קריית טבעון,174,81,93,80,94,19,172,1,2%
2017-10,חיפה,9600,קריית ים,1177,555,622,117,1060,609,1133,29,5%
2017-10,חיפה,8200,קריית מוצקין,797,359,438,134,663,297,777,13,3%
2017-10,חיפה,922,רכסים,129,50,79,9,120,49,121,1,4%
2017-10,ירושלים,472,אבו גוש,198,96,102,5,193,153,194,0,6%
2017-10,ירושלים,2610,בית שמש,1184,488,696,101,1083,378,1146,13,4%
2017-10,ירושלים,3000,ירושלים,10675,4722,5953,1381,9294,6148,10393,72,4%
2017-10,ירושלים,1015,מבשרת ציון,290,148,142,71,219,84,284,0,2%
2017-10,ירושלים,1137,קריית יערים,46,20,26,11,35,13,46,0,3%
2017-10,תל אביב,2400,אור יהודה,603,278,325,44,559,121,580,14,3%
2017-10,תל אביב,565,אזור,169,84,85,32,137,24,166,2,3%
2017-10,תל אביב,6100,בני ברק,1647,776,871,100,1547,544,1554,11,3%
2017-10,תל אביב,6200,בת ים,2406,1165,1241,353,2053,790,2281,45,3%
2017-10,תל אביב,6300,גבעתיים,759,333,426,368,391,69,752,2,2%
2017-10,תל אביב,6400,הרצלייה,999,447,552,374,625,47,989,7,2%
2017-10,תל אביב,6600,חולון,2797,1231,1566,521,2276,528,2736,39,3%
2017-10,תל אביב,2620,קריית אונו,405,167,238,187,218,30,399,1,2%
2017-10,תל אביב,8600,רמת גן,1874,829,1045,681,1193,258,1847,12,2%
2017-10,תל אביב,2650,רמת השרון,407,161,246,205,202,14,406,0,2%
2017-10,תל אביב,5000,תל אביב -יפו,6901,3433,3468,2766,4135,1243,6789,53,3%
2017-11,אזור יהודה והשומרון,3760,אורנית,87,44,43,31,56,2,86,2,2%
2017-11,אזור יהודה והשומרון,3750,אלפי מנשה,87,41,46,30,57,1,87,0,2%
2017-11,אזור יהודה והשומרון,3560,אלקנה,32,17,15,19,13,1,32,0,2%
2017-11,אזור יהודה והשומרון,3650,אפרת,112,74,38,52,60,4,112,1,3%
2017-11,אזור יהודה והשומרון,3570,אריאל,262,109,153,49,213,22,258,9,2%
2017-11,אזור יהודה והשומרון,3574,בית אל,41,26,15,11,30,9,41,1,2%
2017-11,אזור יהודה והשומרון,3652,בית אריה,48,18,30,13,35,0,48,1,2%
2017-11,אזור יהודה והשומרון,3780,ביתר עילית,502,233,269,17,485,157,493,1,4%
2017-11,אזור יהודה והשומרון,3730,גבעת זאב,164,85,79,31,133,30,162,2,2%
2017-11,אזור יהודה והשומרון,3769,הר אדר,42,20,22,17,25,1,42,0,2%
2017-11,אזור יהודה והשומרון,3797,מודיעין עילית,437,144,293,30,407,38,428,3,3%
2017-11,אזור יהודה והשומרון,3616,מעלה אדומים,559,259,300,89,470,138,547,8,3%
2017-11,אזור יהודה והשומרון,3660,עמנואל,45,26,19,2,43,21,42,1,4%
2017-11,אזור יהודה והשומרון,3557,קדומים,36,16,20,17,19,2,36,0,2%
2017-11,אזור יהודה והשומרון,3611,קריית ארבע,76,41,35,12,64,38,74,5,2%
2017-11,אזור יהודה והשומרון,3640,קרני שומרון,65,34,31,22,43,2,65,1,2%
2017-11,הדרום,31,אופקים,785,356,429,43,742,382,759,35,6%
2017-11,הדרום,2600,אילת,939,498,441,46,893,297,868,38,3%
2017-11,הדרום,70,אשדוד,4826,2055,2771,638,4188,2055,4602,97,4%
2017-11,הדרום,7100,אשקלון,3401,1447,1954,391,3010,1426,3051,54,4%
2017-11,הדרום,9000,באר שבע,5454,2543,2911,775,4679,2656,5140,98,5%
2017-11,הדרום,2200,דימונה,1689,782,907,84,1605,1061,1597,40,9%
2017-11,הדרום,1303,חורה,504,196,308,4,500,433,482,4,13%
2017-11,הדרום,831,ירוחם,400,201,199,19,381,207,373,16,8%
2017-11,הדרום,1059,כסיפה,974,371,603,3,971,876,958,4,21%
2017-11,הדרום,1271,להבים,37,15,22,16,21,1,37,0,1%
2017-11,הדרום,1060,לקיה,564,253,311,7,557,492,542,9,14%
2017-11,הדרום,1268,מיתר,62,27,35,21,41,6,58,0,1%
2017-11,הדרום,99,מצפה רמון,218,78,140,17,201,133,206,13,9%
2017-11,הדרום,246,נתיבות,908,412,496,63,845,399,843,36,6%
2017-11,הדרום,666,עומר,54,21,33,18,36,4,52,0,1%
2017-11,הדרום,2560,ערד,653,276,377,74,579,314,615,26,5%
2017-11,הדרום,1192,ערערה-בנגב,1037,443,594,6,1031,936,1016,17,24%
2017-11,הדרום,2630,קריית גת,1519,680,839,106,1413,613,1460,44,5%
2017-11,הדרום,1034,קריית מלאכי,730,324,406,15,715,277,700,49,6%
2017-11,הדרום,1161,רהט,2139,897,1242,10,2129,1609,2111,42,12%
2017-11,הדרום,1286,שגב-שלום,338,131,207,1,337,265,328,6,13%
2017-11,הדרום,1031,שדרות,908,423,485,60,848,455,834,33,7%
2017-11,הדרום,1054,תל שבע,715,323,392,2,713,614,678,7,15%
2017-11,המרכז,182,אבן יהודה,139,56,83,43,96,20,137,1,2%
2017-11,המרכז,41,אליכין,56,24,32,10,46,12,54,0,3%
2017-11,המרכז,1309,אלעד,346,138,208,23,323,31,337,2,3%
2017-11,המרכז,2530,באר יעקב,280,118,162,69,211,28,276,4,3%
2017-11,המרכז,466,בית דגן,87,39,48,12,75,24,84,1,2%
2017-11,המרכז,1066,"בני עי""ש",142,62,80,23,119,38,137,3,4%
2017-11,המרכז,681,גבעת שמואל,236,118,118,89,147,32,231,2,2%
2017-11,המרכז,2550,גדרה,318,133,185,73,245,61,312,4,3%
2017-11,המרכז,627,ג'לג'וליה,81,39,42,3,78,38,77,1,2%
2017-11,המרכז,166,גן יבנה,279,111,168,45,234,58,272,2,2%
2017-11,המרכז,229,גני תקווה,185,88,97,78,107,28,184,0,2%
2017-11,המרכז,9700,הוד השרון,669,293,376,308,361,25,664,10,2%
2017-11,המרכז,1290,זמר,125,47,78,5,120,77,121,5,4%
2017-11,המרכז,2730,טייבה,884,410,474,20,864,629,738,15,4%
2017-11,המרכז,2720,טירה,179,84,95,17,162,50,169,12,2%
2017-11,המרכז,2660,יבנה,706,334,372,145,561,135,696,29,3%
2017-11,המרכז,9400,יהוד,355,159,196,98,257,36,346,9,2%
2017-11,המרכז,1224,כוכב יאיר,64,24,40,44,20,0,64,0,1%
2017-11,המרכז,633,כפר ברא,17,9,8,2,15,4,16,2,1%
2017-11,המרכז,168,כפר יונה,308,132,176,61,247,41,303,4,3%
2017-11,המרכז,6900,כפר סבא,1073,470,603,411,662,87,1055,22,2%
2017-11,המרכז,634,כפר קאסם,184,92,92,3,181,95,179,6,2%
2017-11,המרכז,7000,לוד,1596,792,804,119,1477,784,1558,35,4%
2017-11,המרכז,1200,מודיעין-מכבים-רעות*,862,371,491,387,475,38,850,13,2%
2017-11,המרכז,28,מזכרת בתיה,147,65,82,52,95,21,143,2,2%
2017-11,המרכז,7200,נס ציונה,611,290,321,173,438,124,600,8,3%
2017-11,המרכז,7400,נתניה,3800,1814,1986,468,3332,1071,3711,84,4%
2017-11,המרכז,587,סביון*,26,9,17,16,10,0,26,0,1%
2017-11,המרכז,171,פרדסייה,79,33,46,22,57,5,78,1,2%
2017-11,המרכז,7900,פתח תקווה,3556,1640,1916,694,2862,779,3461,50,3%
2017-11,המרכז,195,קדימה-צורן,244,125,119,77,167,25,240,2,2%
2017-11,המרכז,638,קלנסווה,323,169,154,7,316,211,282,12,3%
2017-11,המרכז,469,קריית עקרון,200,97,103,25,175,79,192,6,3%
2017-11,המרכז,2640,ראש העין,796,363,433,176,620,112,778,11,3%
2017-11,המרכז,8300,ראשון לציון,3667,1610,2057,769,2898,835,3621,42,3%
2017-11,המרכז,8400,רחובות,2058,910,1148,539,1519,580,1989,53,3%
2017-11,המרכז,8500,רמלה,1407,667,740,93,1314,511,1353,61,4%
2017-11,המרכז,8700,רעננה,667,301,366,314,353,42,661,5,2%
2017-11,המרכז,1304,שוהם,169,72,97,80,89,7,168,1,2%
2017-11,המרכז,154,תל מונד,153,64,89,46,107,18,153,0,2%
2017-11,הצפון,473,אבו סנאן,501,216,285,5,496,375,494,8,9%
2017-11,הצפון,478,אכסאל,409,185,224,14,395,344,405,2,7%
2017-11,הצפון,529,אעבלין,394,184,210,10,384,299,388,4,7%
2017-11,הצפון,482,בועיינה-נוג'ידאת,216,112,104,7,209,163,212,3,6%
2017-11,הצפון,4001,בוקעאתא,347,117,230,6,341,287,330,0,12%
2017-11,הצפון,998,ביר אל-מכסור,246,107,139,1,245,191,241,2,7%
2017-11,הצפון,480,בית ג'ן,374,102,272,10,364,237,360,0,7%
2017-11,הצפון,9200,בית שאן,670,306,364,21,649,281,645,41,7%
2017-11,הצפון,944,בסמת טבעון,138,60,78,2,136,96,129,3,4%
2017-11,הצפון,483,בענה,299,132,167,5,294,251,285,2,9%
2017-11,הצפון,1292,ג'דיידה-מכר,1009,449,560,3,1006,763,990,16,11%
2017-11,הצפון,485,ג'ולס,161,46,115,4,157,97,161,2,6%
2017-11,הצפון,487,ג'ש (גוש חלב),48,19,29,8,40,24,47,2,3%
2017-11,הצפון,489,דבורייה,250,113,137,16,234,176,244,3,6%
2017-11,הצפון,490,דייר אל-אסד,310,143,167,10,300,230,305,2,6%
2017-11,הצפון,492,דייר חנא,483,217,266,15,468,352,481,6,10%
2017-11,הצפון,975,זרזיר,196,78,118,3,193,121,194,6,7%
2017-11,הצפון,496,חורפיש,85,31,54,4,81,46,79,1,3%
2017-11,הצפון,2034,חצור הגלילית,251,100,151,17,234,110,236,3,5%
2017-11,הצפון,6700,טבריה,1378,652,726,84,1294,616,1203,66,6%
2017-11,הצפון,962,טובא-זנגרייה,302,133,169,5,297,211,291,4,10%
2017-11,הצפון,498,טורעאן,305,145,160,8,297,250,294,7,5%
2017-11,הצפון,8900,טמרה,1168,555,613,14,1154,932,1147,12,9%
2017-11,הצפון,1295,יאנוח-ג'ת,106,36,70,1,105,64,103,2,4%
2017-11,הצפון,46,יבנאל,83,47,36,5,78,52,69,0,5%
2017-11,הצפון,499,יפיע,478,201,277,19,459,347,470,5,6%
2017-11,הצפון,240,יקנעם עילית,403,174,229,91,312,93,393,18,3%
2017-11,הצפון,502,ירכא,352,139,213,0,352,242,347,1,6%
2017-11,הצפון,504,כאבול,399,198,201,6,393,324,387,3,8%
2017-11,הצפון,505,כאוכב אבו אל-היג'א,176,68,108,7,169,138,176,0,11%
2017-11,הצפון,1296,כסרא-סמיע,171,50,121,5,166,105,163,6,5%
2017-11,הצפון,978,כעביה-טבאש-חג'אג'רה,156,69,87,6,150,108,153,3,7%
2017-11,הצפון,1263,כפר ורדים,54,19,35,25,29,5,53,3,2%
2017-11,הצפון,507,כפר יאסיף,337,153,184,3,334,236,325,3,6%
2017-11,הצפון,508,כפר כמא,40,14,26,3,37,17,40,0,3%
2017-11,הצפון,509,כפר כנא,647,317,330,14,633,524,621,13,7%
2017-11,הצפון,510,כפר מנדא,564,318,246,9,555,413,554,3,8%
2017-11,הצפון,47,כפר תבור,51,20,31,17,34,3,51,1,2%
2017-11,הצפון,1139,כרמיאל,1385,564,821,280,1105,636,1269,35,5%
2017-11,הצפון,481,מגאר,1082,456,626,17,1065,864,1048,4,12%
2017-11,הצפון,516,מג'ד אל-כרום,412,191,221,11,401,282,402,8,6%
2017-11,הצפון,874,מגדל העמק,790,344,446,86,704,281,731,59,6%
2017-11,הצפון,4201,מג'דל שמס,378,144,234,12,366,289,359,3,8%
2017-11,הצפון,517,מזרעה,152,71,81,3,149,101,147,2,8%
2017-11,הצפון,4203,מסעדה,200,71,129,6,194,160,189,2,11%
2017-11,הצפון,518,מעיליא,46,25,21,6,40,19,44,4,3%
2017-11,הצפון,1063,מעלות-תרשיחא,696,335,361,81,615,331,653,38,6%
2017-11,הצפון,520,משהד,169,84,85,11,158,127,161,2,5%
2017-11,הצפון,9100,נהרייה,1659,776,883,200,1459,821,1568,43,5%
2017-11,הצפון,522,נחף,325,153,172,12,313,249,317,2,7%
2017-11,הצפון,7300,נצרת,2433,1095,1338,96,2337,1810,2407,21,7%
2017-11,הצפון,1061,נצרת עילית,1287,609,678,125,1162,596,1134,93,5%
2017-11,הצפון,525,סאג'ור,98,37,61,7,91,67,95,1,5%
2017-11,הצפון,7500,סח'נין,1497,651,846,30,1467,1223,1483,12,11%
2017-11,הצפון,4501,ע'ג'ר,75,33,42,1,74,52,73,0,7%
2017-11,הצפון,530,עיילבון,130,67,63,3,127,71,125,0,5%
2017-11,הצפון,511,עילוט,238,101,137,4,234,189,235,0,9%
2017-11,הצפון,532,עין מאהל,334,171,163,7,327,266,324,3,6%
2017-11,הצפון,7600,עכו,2507,1139,1368,134,2373,1825,2406,38,9%
2017-11,הצפון,7700,עפולה,1411,576,835,167,1244,505,1329,68,5%
2017-11,הצפון,531,עראבה,1078,460,618,24,1054,894,1066,4,11%
2017-11,הצפון,535,פסוטה,82,39,43,9,73,38,79,2,5%
2017-11,הצפון,536,פקיעין (בוקייעה),117,57,60,7,110,69,111,0,4%
2017-11,הצפון,8000,צפת,955,489,466,95,860,578,892,21,7%
2017-11,הצפון,4100,קצרין,173,76,97,28,145,71,164,5,4%
2017-11,הצפון,2800,קריית שמונה,661,327,334,78,583,258,641,29,5%
2017-11,הצפון,543,ראמה,223,95,128,10,213,156,216,2,6%
2017-11,הצפון,26,ראש פינה,52,17,35,9,43,20,51,0,3%
2017-11,הצפון,542,ריינה,387,187,200,6,381,305,376,6,6%
2017-11,הצפון,122,רמת ישי,101,43,58,36,65,12,100,1,2%
2017-11,הצפון,913,שבלי - אום אל-גנם,167,74,93,4,163,99,165,2,7%
2017-11,הצפון,812,שלומי,207,81,126,21,186,99,199,3,6%
2017-11,הצפון,538,שעב,353,161,192,1,352,285,350,4,12%
2017-11,הצפון,8800,שפרעם,1198,509,689,37,1161,896,1175,21,7%
2017-11,חיפה,2710,אום אל-פחם,2454,999,1455,27,2427,2006,2404,28,12%
2017-11,חיפה,1020,אור עקיבא,443,180,263,37,406,119,422,14,4%
2017-11,חיפה,6000,באקה אל-גרביה,533,254,279,15,518,320,523,22,5%
2017-11,חיפה,9800,בנימינה-גבעת עדה*,166,79,87,68,98,29,163,5,2%
2017-11,חיפה,1326,"בסמ""ה",328,150,178,4,324,251,321,6,8%
2017-11,חיפה,541,ג'סר א-זרקא,233,133,100,1,232,100,230,12,4%
2017-11,חיפה,628,ג'ת,196,103,93,14,182,111,193,6,4%
2017-11,חיפה,494,דאלית אל-כרמל,392,151,241,15,377,209,369,4,5%
2017-11,חיפה,9300,זכרון יעקב,258,120,138,110,148,30,255,3,2%
2017-11,חיפה,6500,חדרה,1973,905,1068,237,1736,607,1867,41,4%
2017-11,חיפה,4000,חיפה,5099,2473,2626,1074,4025,2338,4782,107,3%
2017-11,חיפה,1247,חריש,234,92,142,66,168,34,230,3,14%
2017-11,חיפה,2100,טירת כרמל,659,312,347,44,615,314,634,12,6%
2017-11,חיפה,654,כפר קרע,367,168,199,27,340,221,359,4,4%
2017-11,חיפה,1327,מעלה עירון,608,250,358,9,599,473,595,2,11%
2017-11,חיפה,2500,נשר,384,201,183,69,315,129,371,7,3%
2017-11,חיפה,534,עספיא,340,150,190,14,326,163,317,9,6%
2017-11,חיפה,637,ערערה,482,204,278,16,466,308,472,13,6%
2017-11,חיפה,537,פוריידיס,217,129,88,7,210,67,216,3,4%
2017-11,חיפה,7800,פרדס חנה-כרכור,712,317,395,174,538,118,697,18,4%
2017-11,חיפה,6800,קריית אתא,1300,608,692,105,1195,576,1262,31,4%
2017-11,חיפה,9500,קריית ביאליק,836,355,481,100,736,322,811,19,4%
2017-11,חיפה,2300,קריית טבעון,180,84,96,81,99,21,175,0,2%
2017-11,חיפה,9600,קריית ים,1221,565,656,101,1120,615,1176,31,6%
2017-11,חיפה,8200,קריית מוצקין,811,370,441,124,687,309,788,19,3%
2017-11,חיפה,922,רכסים,147,62,85,10,137,60,127,1,4%
2017-11,ירושלים,472,אבו גוש,209,105,104,7,202,155,207,1,7%
2017-11,ירושלים,2610,בית שמש,1149,505,644,91,1058,366,1095,34,3%
2017-11,ירושלים,3000,ירושלים,10760,4792,5968,1311,9449,6191,10456,112,4%
2017-11,ירושלים,1015,מבשרת ציון,293,149,144,61,232,87,287,2,2%
2017-11,ירושלים,1137,קריית יערים,42,16,26,11,31,13,42,0,3%
2017-11,תל אביב,2400,אור יהודה,634,292,342,46,588,125,607,30,3%
2017-11,תל אביב,565,אזור,181,88,93,29,152,23,177,0,3%
2017-11,תל אביב,6100,בני ברק,1663,802,861,99,1564,558,1554,19,3%
2017-11,תל אביב,6200,בת ים,2527,1228,1299,362,2165,818,2387,85,3%
2017-11,תל אביב,6300,גבעתיים,758,329,429,352,406,74,750,6,2%
2017-11,תל אביב,6400,הרצלייה,1008,472,536,343,665,54,1001,13,2%
2017-11,תל אביב,6600,חולון,2826,1252,1574,503,2323,543,2749,64,3%
2017-11,תל אביב,2620,קריית אונו,403,173,230,188,215,31,400,7,2%
2017-11,תל אביב,8600,רמת גן,1931,869,1062,678,1253,282,1892,25,2%
2017-11,תל אביב,2650,רמת השרון,383,150,233,185,198,15,380,3,2%
2017-11,תל אביב,5000,תל אביב -יפו,6842,3433,3409,2661,4181,1292,6731,66,3%
2017-12,אזור יהודה והשומרון,3760,אורנית,94,43,51,36,58,1,93,0,2%
2017-12,אזור יהודה והשומרון,3750,אלפי מנשה,64,26,38,21,43,0,64,1,2%
2017-12,אזור יהודה והשומרון,3560,אלקנה,29,16,13,15,14,2,28,0,1%
2017-12,אזור יהודה והשומרון,3650,אפרת,112,74,38,54,58,6,112,0,3%
2017-12,אזור יהודה והשומרון,3570,אריאל,259,121,138,50,209,27,254,7,2%
2017-12,אזור יהודה והשומרון,3574,בית אל,42,28,14,11,31,10,42,1,2%
2017-12,אזור יהודה והשומרון,3652,בית אריה,55,21,34,15,40,1,55,0,2%
2017-12,אזור יהודה והשומרון,3780,ביתר עילית,465,208,257,15,450,139,457,2,4%
2017-12,אזור יהודה והשומרון,3730,גבעת זאב,161,84,77,36,125,26,160,3,2%
2017-12,אזור יהודה והשומרון,3769,הר אדר,37,16,21,17,20,2,37,0,2%
2017-12,אזור יהודה והשומרון,3797,מודיעין עילית,415,133,282,31,384,33,407,4,3%
2017-12,אזור יהודה והשומרון,3616,מעלה אדומים,528,254,274,88,440,129,517,14,3%
2017-12,אזור יהודה והשומרון,3660,עמנואל,48,26,22,3,45,24,45,2,4%
2017-12,אזור יהודה והשומרון,3557,קדומים,34,18,16,15,19,2,34,1,2%
2017-12,אזור יהודה והשומרון,3611,קריית ארבע,72,38,34,12,60,34,70,5,2%
2017-12,אזור יהודה והשומרון,3640,קרני שומרון,69,35,34,27,42,3,68,2,2%
2017-12,הדרום,31,אופקים,758,344,414,51,707,370,733,34,6%
2017-12,הדרום,2600,אילת,922,494,428,47,875,281,864,49,3%
2017-12,הדרום,70,אשדוד,4802,2071,2731,650,4152,2048,4560,99,4%
2017-12,הדרום,7100,אשקלון,3220,1425,1795,369,2851,1371,2909,66,4%
2017-12,הדרום,9000,באר שבע,5318,2492,2826,768,4550,2585,5004,86,5%
2017-12,הדרום,2200,דימונה,1613,761,852,82,1531,1029,1525,27,9%
2017-12,הדרום,1303,חורה,478,191,287,2,476,410,463,3,12%
2017-12,הדרום,831,ירוחם,357,181,176,13,344,199,326,18,7%
2017-12,הדרום,1059,כסיפה,968,371,597,3,965,878,951,6,21%
2017-12,הדרום,1271,להבים,36,15,21,20,16,3,36,0,1%
2017-12,הדרום,1060,לקיה,567,264,303,5,562,487,537,4,14%
2017-12,הדרום,1268,מיתר,59,31,28,26,33,5,56,0,1%
2017-12,הדרום,99,מצפה רמון,213,77,136,15,198,138,206,12,9%
2017-12,הדרום,246,נתיבות,880,419,461,53,827,377,818,50,6%
2017-12,הדרום,666,עומר,54,26,28,21,33,3,53,0,1%
2017-12,הדרום,2560,ערד,632,282,350,73,559,309,600,20,5%
2017-12,הדרום,1192,ערערה-בנגב,1022,445,577,6,1016,926,998,14,24%
2017-12,הדרום,2630,קריית גת,1487,673,814,101,1386,591,1424,40,5%
2017-12,הדרום,1034,קריית מלאכי,682,293,389,13,669,269,652,52,6%
2017-12,הדרום,1161,רהט,2081,886,1195,10,2071,1563,2058,59,12%
2017-12,הדרום,1286,שגב-שלום,332,136,196,2,330,262,320,2,13%
2017-12,הדרום,1031,שדרות,886,417,469,46,840,451,810,32,6%
2017-12,הדרום,1054,תל שבע,712,320,392,4,708,611,672,8,15%
2017-12,המרכז,182,אבן יהודה,138,56,82,48,90,20,136,2,2%
2017-12,המרכז,41,אליכין,56,25,31,9,47,12,54,0,3%
2017-12,המרכז,1309,אלעד,317,124,193,24,293,25,307,5,2%
2017-12,המרכז,2530,באר יעקב,286,121,165,66,220,31,281,4,3%
2017-12,המרכז,466,בית דגן,90,44,46,8,82,24,87,1,2%
2017-12,המרכז,1066,"בני עי""ש",138,61,77,21,117,39,133,5,3%
2017-12,המרכז,681,גבעת שמואל,231,119,112,89,142,32,226,2,2%
2017-12,המרכז,2550,גדרה,305,126,179,80,225,59,298,6,3%
2017-12,המרכז,627,ג'לג'וליה,81,37,44,3,78,38,79,1,2%
2017-12,המרכז,166,גן יבנה,274,112,162,37,237,58,268,1,2%
2017-12,המרכז,229,גני תקווה,189,90,99,74,115,25,187,1,2%
2017-12,המרכז,9700,הוד השרון,658,278,380,309,349,21,655,9,2%
2017-12,המרכז,1290,זמר,129,46,83,4,125,83,124,2,4%
2017-12,המרכז,2730,טייבה,875,405,470,23,852,601,729,34,4%
2017-12,המרכז,2720,טירה,178,94,84,19,159,48,172,14,2%
2017-12,המרכז,2660,יבנה,700,320,380,138,562,130,685,33,3%
2017-12,המרכז,9400,יהוד,363,161,202,95,268,37,353,6,2%
2017-12,המרכז,1224,כוכב יאיר,56,18,38,37,19,0,56,1,1%
2017-12,המרכז,633,כפר ברא,20,11,9,2,18,5,20,1,1%
2017-12,המרכז,168,כפר יונה,310,135,175,59,251,39,306,3,3%
2017-12,המרכז,6900,כפר סבא,1058,479,579,402,656,68,1038,19,2%
2017-12,המרכז,634,כפר קאסם,180,91,89,2,178,94,176,1,2%
2017-12,המרכז,7000,לוד,1587,800,787,131,1456,772,1543,28,4%
2017-12,המרכז,1200,מודיעין-מכבים-רעות*,846,376,470,383,463,38,834,12,2%
2017-12,המרכז,28,מזכרת בתיה,151,62,89,51,100,24,146,2,2%
2017-12,המרכז,7200,נס ציונה,617,298,319,173,444,126,604,6,3%
2017-12,המרכז,7400,נתניה,3768,1807,1961,469,3299,1015,3674,102,4%
2017-12,המרכז,587,סביון*,26,8,18,15,11,0,26,0,1%
2017-12,המרכז,171,פרדסייה,80,38,42,18,62,5,79,2,2%
2017-12,המרכז,7900,פתח תקווה,3449,1577,1872,717,2732,784,3354,60,3%
2017-12,המרכז,195,קדימה-צורן,250,126,124,85,165,26,246,4,2%
2017-12,המרכז,638,קלנסווה,316,164,152,12,304,212,276,5,3%
2017-12,המרכז,469,קריית עקרון,206,98,108,29,177,84,198,8,3%
2017-12,המרכז,2640,ראש העין,766,354,412,171,595,110,752,4,3%
2017-12,המרכז,8300,ראשון לציון,3602,1603,1999,775,2827,823,3552,49,3%
2017-12,המרכז,8400,רחובות,2019,902,1117,553,1466,587,1952,40,3%
2017-12,המרכז,8500,רמלה,1341,637,704,92,1249,504,1287,45,4%
2017-12,המרכז,8700,רעננה,646,302,344,307,339,29,643,4,2%
2017-12,המרכז,1304,שוהם,183,77,106,83,100,6,182,2,2%
2017-12,המרכז,154,תל מונד,148,66,82,42,106,14,148,1,2%
2017-12,הצפון,473,אבו סנאן,532,233,299,4,528,385,523,4,9%
2017-12,הצפון,478,אכסאל,402,184,218,15,387,330,398,1,7%
2017-12,הצפון,529,אעבלין,399,183,216,12,387,294,391,3,7%
2017-12,הצפון,482,בועיינה-נוג'ידאת,208,108,100,7,201,156,206,2,6%
2017-12,הצפון,4001,בוקעאתא,348,119,229,4,344,287,333,0,12%
2017-12,הצפון,998,ביר אל-מכסור,250,107,143,1,249,186,246,4,7%
2017-12,הצפון,480,בית ג'ן,372,106,266,8,364,231,361,1,7%
2017-12,הצפון,9200,בית שאן,641,291,350,24,617,278,615,36,6%
2017-12,הצפון,944,בסמת טבעון,149,72,77,2,147,101,138,2,4%
2017-12,הצפון,483,בענה,296,135,161,6,290,250,284,1,9%
2017-12,הצפון,1292,ג'דיידה-מכר,1007,444,563,4,1003,764,984,5,11%
2017-12,הצפון,485,ג'ולס,155,42,113,3,152,90,155,2,5%
2017-12,הצפון,487,ג'ש (גוש חלב),47,21,26,5,42,25,46,3,3%
2017-12,הצפון,489,דבורייה,251,115,136,16,235,178,246,4,6%
2017-12,הצפון,490,דייר אל-אסד,310,143,167,11,299,226,304,3,6%
2017-12,הצפון,492,דייר חנא,482,219,263,14,468,347,480,3,10%
2017-12,הצפון,975,זרזיר,189,77,112,2,187,121,187,1,6%
2017-12,הצפון,496,חורפיש,83,31,52,4,79,46,75,1,3%
2017-12,הצפון,2034,חצור הגלילית,237,100,137,16,221,112,221,1,5%
2017-12,הצפון,6700,טבריה,1306,640,666,80,1226,614,1141,60,5%
2017-12,הצפון,962,טובא-זנגרייה,297,134,163,3,294,209,284,3,10%
2017-12,הצפון,498,טורעאן,293,142,151,9,284,233,283,6,5%
2017-12,הצפון,8900,טמרה,1163,552,611,12,1151,931,1141,16,9%
2017-12,הצפון,1295,יאנוח-ג'ת,106,34,72,1,105,61,102,3,4%
2017-12,הצפון,46,יבנאל,80,45,35,6,74,49,65,3,4%
2017-12,הצפון,499,יפיע,466,199,267,24,442,334,462,5,6%
2017-12,הצפון,240,יקנעם עילית,385,178,207,90,295,88,375,25,3%
2017-12,הצפון,502,ירכא,348,138,210,0,348,224,342,3,6%
2017-12,הצפון,504,כאבול,396,202,194,7,389,320,385,3,8%
2017-12,הצפון,505,כאוכב אבו אל-היג'א,186,75,111,6,180,140,186,2,11%
2017-12,הצפון,1296,כסרא-סמיע,171,56,115,4,167,104,163,7,5%
2017-12,הצפון,978,כעביה-טבאש-חג'אג'רה,165,61,104,5,160,100,160,5,7%
2017-12,הצפון,1263,כפר ורדים,53,18,35,18,35,5,51,0,2%
2017-12,הצפון,507,כפר יאסיף,324,151,173,1,323,225,317,4,6%
2017-12,הצפון,508,כפר כמא,39,13,26,3,36,16,39,0,2%
2017-12,הצפון,509,כפר כנא,638,318,320,18,620,516,612,14,7%
2017-12,הצפון,510,כפר מנדא,555,308,247,11,544,403,547,1,8%
2017-12,הצפון,47,כפר תבור,49,23,26,17,32,2,49,0,2%
2017-12,הצפון,1139,כרמיאל,1351,567,784,267,1084,625,1238,36,5%
2017-12,הצפון,481,מגאר,1059,459,600,14,1045,833,1025,9,11%
2017-12,הצפון,516,מג'ד אל-כרום,402,191,211,12,390,276,389,6,6%
2017-12,הצפון,874,מגדל העמק,766,332,434,80,686,250,711,56,5%
2017-12,הצפון,4201,מג'דל שמס,380,141,239,12,368,287,361,1,8%
2017-12,הצפון,517,מזרעה,149,70,79,2,147,100,142,1,7%
2017-12,הצפון,4203,מסעדה,204,79,125,6,198,158,193,1,12%
2017-12,הצפון,518,מעיליא,36,20,16,6,30,15,36,4,2%
2017-12,הצפון,1063,מעלות-תרשיחא,654,327,327,78,576,332,617,31,5%
2017-12,הצפון,520,משהד,162,79,83,9,153,124,156,3,5%
2017-12,הצפון,9100,נהרייה,1622,768,854,189,1433,769,1532,49,5%
2017-12,הצפון,522,נחף,340,159,181,15,325,252,333,6,7%
2017-12,הצפון,7300,נצרת,2393,1090,1303,95,2298,1771,2364,10,7%
2017-12,הצפון,1061,נצרת עילית,1204,576,628,125,1079,552,1079,64,5%
2017-12,הצפון,525,סאג'ור,111,45,66,6,105,74,108,1,6%
2017-12,הצפון,7500,סח'נין,1481,654,827,33,1448,1204,1468,17,11%
2017-12,הצפון,4501,ע'ג'ר,74,33,41,2,72,49,73,0,7%
2017-12,הצפון,530,עיילבון,130,65,65,3,127,71,126,1,5%
2017-12,הצפון,511,עילוט,234,101,133,4,230,186,233,0,9%
2017-12,הצפון,532,עין מאהל,338,174,164,4,334,264,326,2,6%
2017-12,הצפון,7600,עכו,2476,1135,1341,135,2341,1767,2373,31,9%
2017-12,הצפון,7700,עפולה,1396,566,830,163,1233,503,1312,66,5%
2017-12,הצפון,531,עראבה,1054,449,605,22,1032,871,1045,9,11%
2017-12,הצפון,535,פסוטה,77,36,41,8,69,39,73,2,4%
2017-12,הצפון,536,פקיעין (בוקייעה),112,50,62,7,105,67,107,2,4%
2017-12,הצפון,8000,צפת,918,486,432,96,822,550,860,25,7%
2017-12,הצפון,4100,קצרין,172,74,98,28,144,68,164,4,4%
2017-12,הצפון,2800,קריית שמונה,640,319,321,72,568,261,616,22,5%
2017-12,הצפון,543,ראמה,208,89,119,12,196,147,201,3,5%
2017-12,הצפון,26,ראש פינה,54,16,38,13,41,18,53,0,3%
2017-12,הצפון,542,ריינה,368,176,192,8,360,289,353,3,5%
2017-12,הצפון,122,רמת ישי,96,36,60,34,62,10,95,0,2%
2017-12,הצפון,913,שבלי - אום אל-גנם,159,70,89,6,153,102,157,5,6%
2017-12,הצפון,812,שלומי,197,76,121,19,178,89,189,9,5%
2017-12,הצפון,538,שעב,351,159,192,1,350,286,349,5,12%
2017-12,הצפון,8800,שפרעם,1167,501,666,26,1141,884,1140,11,7%
2017-12,חיפה,2710,אום אל-פחם,2401,991,1410,24,2377,1953,2351,18,12%
2017-12,חיפה,1020,אור עקיבא,410,169,241,36,374,109,395,19,4%
2017-12,חיפה,6000,באקה אל-גרביה,539,268,271,14,525,311,531,26,5%
2017-12,חיפה,9800,בנימינה-גבעת עדה*,168,80,88,71,97,26,165,2,2%
2017-12,חיפה,1326,"בסמ""ה",309,134,175,3,306,236,306,8,8%
2017-12,חיפה,541,ג'סר א-זרקא,205,119,86,0,205,78,201,17,4%
2017-12,חיפה,628,ג'ת,187,94,93,14,173,105,186,6,4%
2017-12,חיפה,494,דאלית אל-כרמל,381,149,232,13,368,207,357,5,5%
2017-12,חיפה,9300,זכרון יעקב,247,112,135,108,139,22,245,4,2%
2017-12,חיפה,6500,חדרה,1932,880,1052,248,1684,580,1821,36,4%
2017-12,חיפה,4000,חיפה,5024,2436,2588,1080,3944,2297,4730,115,3%
2017-12,חיפה,1247,חריש,238,94,144,70,168,30,232,0,14%
2017-12,חיפה,2100,טירת כרמל,658,320,338,54,604,309,637,14,6%
2017-12,חיפה,654,כפר קרע,359,169,190,23,336,214,353,4,4%
2017-12,חיפה,1327,מעלה עירון,598,250,348,9,589,466,588,3,11%
2017-12,חיפה,2500,נשר,356,188,168,73,283,125,344,7,3%
2017-12,חיפה,534,עספיא,326,145,181,13,313,155,302,2,6%
2017-12,חיפה,637,ערערה,462,199,263,12,450,301,450,7,6%
2017-12,חיפה,537,פוריידיס,194,121,73,7,187,49,192,4,4%
2017-12,חיפה,7800,פרדס חנה-כרכור,698,304,394,179,519,106,682,16,3%
2017-12,חיפה,6800,קריית אתא,1293,586,707,115,1178,559,1248,19,4%
2017-12,חיפה,9500,קריית ביאליק,811,367,444,95,716,306,790,19,4%
2017-12,חיפה,2300,קריית טבעון,179,82,97,74,105,26,176,0,2%
2017-12,חיפה,9600,קריית ים,1164,545,619,89,1075,597,1110,29,5%
2017-12,חיפה,8200,קריית מוצקין,771,340,431,125,646,288,746,18,3%
2017-12,חיפה,922,רכסים,126,53,73,12,114,52,115,1,3%
2017-12,ירושלים,472,אבו גוש,201,102,99,5,196,152,199,3,7%
2017-12,ירושלים,2610,בית שמש,1080,489,591,93,987,328,1032,23,3%
2017-12,ירושלים,3000,ירושלים,10757,4865,5892,1323,9434,6184,10465,147,4%
2017-12,ירושלים,1015,מבשרת ציון,293,150,143,60,233,88,287,2,2%
2017-12,ירושלים,1137,קריית יערים,48,15,33,12,36,12,48,0,4%
2017-12,תל אביב,2400,אור יהודה,597,288,309,45,552,122,567,20,3%
2017-12,תל אביב,565,אזור,175,85,90,32,143,25,172,5,3%
2017-12,תל אביב,6100,בני ברק,1588,805,783,96,1492,551,1494,20,3%
2017-12,תל אביב,6200,בת ים,2440,1204,1236,378,2062,795,2292,56,3%
2017-12,תל אביב,6300,גבעתיים,765,342,423,376,389,63,760,4,3%
2017-12,תל אביב,6400,הרצלייה,969,447,522,334,635,44,955,14,2%
2017-12,תל אביב,6600,חולון,2712,1202,1510,496,2216,545,2644,45,3%
2017-12,תל אביב,2620,קריית אונו,418,182,236,206,212,31,413,4,2%
2017-12,תל אביב,8600,רמת גן,1900,853,1047,711,1189,263,1869,13,2%
2017-12,תל אביב,2650,רמת השרון,387,156,231,186,201,16,384,2,2%
2017-12,תל אביב,5000,תל אביב -יפו,6844,3447,3397,2787,4057,1292,6711,57,3%
2018-01,אזור יהודה והשומרון,3760,אורנית,98,41,57,38,60,0,98,1,2%
2018-01,אזור יהודה והשומרון,3750,אלפי מנשה,72,26,46,28,44,0,71,1,2%
2018-01,אזור יהודה והשומרון,3560,אלקנה,27,15,12,13,14,0,27,0,1%
2018-01,אזור יהודה והשומרון,3650,אפרת,124,76,48,62,62,4,124,1,3%
2018-01,אזור יהודה והשומרון,3570,אריאל,272,120,152,56,216,25,267,8,3%
2018-01,אזור יהודה והשומרון,3574,בית אל,44,28,16,8,36,10,44,0,2%
2018-01,אזור יהודה והשומרון,3652,בית אריה,55,22,33,15,40,0,55,0,2%
2018-01,אזור יהודה והשומרון,3780,ביתר עילית,457,225,232,11,446,143,447,7,4%
2018-01,אזור יהודה והשומרון,3730,גבעת זאב,166,87,79,43,123,32,166,1,2%
2018-01,אזור יהודה והשומרון,3769,הר אדר,38,17,21,18,20,1,38,0,2%
2018-01,אזור יהודה והשומרון,3797,מודיעין עילית,446,139,307,32,414,35,440,2,3%
2018-01,אזור יהודה והשומרון,3616,מעלה אדומים,560,273,287,92,468,128,548,24,3%
2018-01,אזור יהודה והשומרון,3660,עמנואל,41,23,18,3,38,16,40,1,4%
2018-01,אזור יהודה והשומרון,3557,קדומים,42,21,21,22,20,2,41,1,2%
2018-01,אזור יהודה והשומרון,3611,קריית ארבע,73,40,33,12,61,35,69,7,2%
2018-01,אזור יהודה והשומרון,3640,קרני שומרון,69,33,36,23,46,1,67,3,2%
2018-01,הדרום,31,אופקים,843,395,448,55,788,381,810,41,7%
2018-01,הדרום,2600,אילת,1131,575,556,56,1075,290,1065,52,3%
2018-01,הדרום,70,אשדוד,4828,2086,2742,655,4173,2004,4579,150,4%
2018-01,הדרום,7100,אשקלון,3266,1478,1788,369,2897,1365,2964,50,4%
2018-01,הדרום,9000,באר שבע,5432,2553,2879,763,4669,2602,5104,118,5%
2018-01,הדרום,2200,דימונה,1644,782,862,92,1552,1042,1550,45,9%
2018-01,הדרום,1303,חורה,507,207,300,1,506,427,483,8,13%
2018-01,הדרום,831,ירוחם,372,192,180,11,361,204,344,35,8%
2018-01,הדרום,1059,כסיפה,954,370,584,3,951,854,940,9,21%
2018-01,הדרום,1271,להבים,33,15,18,19,14,3,32,0,1%
2018-01,הדרום,1060,לקיה,588,267,321,4,584,508,550,6,14%
2018-01,הדרום,1268,מיתר,59,31,28,27,32,4,59,1,1%
2018-01,הדרום,99,מצפה רמון,227,83,144,14,213,142,217,16,9%
2018-01,הדרום,246,נתיבות,903,438,465,60,843,379,838,48,6%
2018-01,הדרום,666,עומר,56,27,29,22,34,4,54,1,1%
2018-01,הדרום,2560,ערד,654,284,370,66,588,312,616,31,5%
2018-01,הדרום,1192,ערערה-בנגב,1014,432,582,4,1010,915,993,40,24%
2018-01,הדרום,2630,קריית גת,1587,708,879,113,1474,600,1516,54,5%
2018-01,הדרום,1034,קריית מלאכי,719,317,402,24,695,255,687,37,6%
2018-01,הדרום,1161,רהט,2115,906,1209,11,2104,1561,2087,50,12%
2018-01,הדרום,1286,שגב-שלום,336,138,198,2,334,264,320,2,13%
2018-01,הדרום,1031,שדרות,915,441,474,52,863,445,834,36,7%
2018-01,הדרום,1054,תל שבע,722,326,396,4,718,611,670,10,15%
2018-01,המרכז,182,אבן יהודה,143,59,84,50,93,15,142,1,2%
2018-01,המרכז,41,אליכין,61,31,30,14,47,12,60,1,3%
2018-01,המרכז,1309,אלעד,320,130,190,23,297,33,306,6,2%
2018-01,המרכז,2530,באר יעקב,287,118,169,68,219,28,277,3,3%
2018-01,המרכז,466,בית דגן,95,48,47,10,85,24,93,2,3%
2018-01,המרכז,1066,"בני עי""ש",148,59,89,24,124,42,140,4,4%
2018-01,המרכז,681,גבעת שמואל,242,127,115,89,153,34,239,1,2%
2018-01,המרכז,2550,גדרה,291,119,172,75,216,55,284,6,2%
2018-01,המרכז,627,ג'לג'וליה,76,38,38,3,73,33,73,2,2%
2018-01,המרכז,166,גן יבנה,302,121,181,51,251,62,294,5,3%
2018-01,המרכז,229,גני תקווה,195,91,104,75,120,25,192,0,2%
2018-01,המרכז,9700,הוד השרון,696,294,402,318,378,28,687,12,2%
2018-01,המרכז,1290,זמר,133,49,84,2,131,81,127,8,4%
2018-01,המרכז,2730,טייבה,878,407,471,24,854,590,731,21,4%
2018-01,המרכז,2720,טירה,185,107,78,18,167,42,175,13,2%
2018-01,המרכז,2660,יבנה,725,340,385,151,574,140,713,32,3%
2018-01,המרכז,9400,יהוד,381,173,208,101,280,37,370,9,2%
2018-01,המרכז,1224,כוכב יאיר,65,23,42,46,19,0,65,0,1%
2018-01,המרכז,633,כפר ברא,11,4,7,1,10,4,11,1,1%
2018-01,המרכז,168,כפר יונה,304,133,171,56,248,45,302,2,3%
2018-01,המרכז,6900,כפר סבא,1148,527,621,430,718,80,1122,21,2%
2018-01,המרכז,634,כפר קאסם,184,92,92,4,180,98,178,5,2%
2018-01,המרכז,7000,לוד,1620,809,811,149,1471,759,1564,36,5%
2018-01,המרכז,1200,מודיעין-מכבים-רעות*,884,382,502,411,473,41,874,9,2%
2018-01,המרכז,28,מזכרת בתיה,166,68,98,52,114,26,163,3,2%
2018-01,המרכז,7200,נס ציונה,625,289,336,178,447,125,613,3,3%
2018-01,המרכז,7400,נתניה,3803,1844,1959,462,3341,1004,3705,92,4%
2018-01,המרכז,587,סביון*,25,9,16,13,12,0,25,1,1%
2018-01,המרכז,171,פרדסייה,75,35,40,17,58,4,74,0,2%
2018-01,המרכז,7900,פתח תקווה,3531,1606,1925,738,2793,759,3437,58,3%
2018-01,המרכז,195,קדימה-צורן,261,122,139,88,173,28,257,4,2%
2018-01,המרכז,638,קלנסווה,322,165,157,12,310,204,281,15,3%
2018-01,המרכז,469,קריית עקרון,220,101,119,28,192,82,214,7,4%
2018-01,המרכז,2640,ראש העין,797,379,418,170,627,109,783,8,3%
2018-01,המרכז,8300,ראשון לציון,3757,1686,2071,792,2965,817,3702,69,3%
2018-01,המרכז,8400,רחובות,2042,931,1111,554,1488,576,1970,45,3%
2018-01,המרכז,8500,רמלה,1401,674,727,88,1313,495,1347,41,4%
2018-01,המרכז,8700,רעננה,689,323,366,319,370,31,684,8,2%
2018-01,המרכז,1304,שוהם,194,86,108,93,101,7,193,2,2%
2018-01,המרכז,154,תל מונד,147,67,80,49,98,14,145,2,2%
2018-01,הצפון,473,אבו סנאן,534,240,294,4,530,384,521,3,9%
2018-01,הצפון,478,אכסאל,415,191,224,15,400,324,413,6,7%
2018-01,הצפון,529,אעבלין,402,182,220,11,391,293,396,7,7%
2018-01,הצפון,482,בועיינה-נוג'ידאת,222,110,112,7,215,156,218,2,6%
2018-01,הצפון,4001,בוקעאתא,356,126,230,4,352,272,343,1,13%
2018-01,הצפון,998,ביר אל-מכסור,253,111,142,1,252,188,247,1,7%
2018-01,הצפון,480,בית ג'ן,373,101,272,7,366,236,365,3,7%
2018-01,הצפון,9200,בית שאן,668,306,362,24,644,279,641,42,7%
2018-01,הצפון,944,בסמת טבעון,163,79,84,2,161,102,151,4,5%
2018-01,הצפון,483,בענה,305,133,172,7,298,252,293,5,9%
2018-01,הצפון,1292,ג'דיידה-מכר,1010,450,560,4,1006,759,989,13,11%
2018-01,הצפון,485,ג'ולס,163,46,117,4,159,91,163,0,6%
2018-01,הצפון,487,ג'ש (גוש חלב),46,20,26,5,41,19,45,5,3%
2018-01,הצפון,489,דבורייה,246,107,139,13,233,184,240,5,6%
2018-01,הצפון,490,דייר אל-אסד,315,138,177,8,307,226,305,7,6%
2018-01,הצפון,492,דייר חנא,502,230,272,14,488,347,501,5,11%
2018-01,הצפון,975,זרזיר,191,85,106,1,190,110,187,6,6%
2018-01,הצפון,496,חורפיש,92,40,52,6,86,47,83,2,3%
2018-01,הצפון,2034,חצור הגלילית,248,112,136,18,230,115,229,2,5%
2018-01,הצפון,6700,טבריה,1381,693,688,87,1294,612,1213,51,6%
2018-01,הצפון,962,טובא-זנגרייה,302,142,160,2,300,202,290,3,10%
2018-01,הצפון,498,טורעאן,313,154,159,12,301,228,305,5,6%
2018-01,הצפון,8900,טמרה,1176,568,608,15,1161,931,1145,15,9%
2018-01,הצפון,1295,יאנוח-ג'ת,113,37,76,1,112,62,108,4,4%
2018-01,הצפון,46,יבנאל,83,47,36,8,75,48,67,1,4%
2018-01,הצפון,499,יפיע,485,214,271,30,455,334,477,8,6%
2018-01,הצפון,240,יקנעם עילית,430,200,230,102,328,94,417,26,4%
2018-01,הצפון,502,ירכא,353,141,212,1,352,230,350,4,6%
2018-01,הצפון,504,כאבול,395,202,193,6,389,317,386,4,8%
2018-01,הצפון,505,כאוכב אבו אל-היג'א,176,69,107,6,170,134,176,3,11%
2018-01,הצפון,1296,כסרא-סמיע,169,49,120,1,168,104,167,4,5%
2018-01,הצפון,978,כעביה-טבאש-חג'אג'רה,169,62,107,6,163,103,164,1,7%
2018-01,הצפון,1263,כפר ורדים,64,26,38,25,39,5,61,1,2%
2018-01,הצפון,507,כפר יאסיף,352,168,184,3,349,236,342,2,7%
2018-01,הצפון,508,כפר כמא,37,13,24,3,34,15,36,0,2%
2018-01,הצפון,509,כפר כנא,660,326,334,22,638,516,630,13,8%
2018-01,הצפון,510,כפר מנדא,572,318,254,13,559,402,563,1,8%
2018-01,הצפון,47,כפר תבור,49,23,26,16,33,2,49,1,2%
2018-01,הצפון,1139,כרמיאל,1378,574,804,259,1119,633,1265,32,5%
2018-01,הצפון,481,מגאר,1051,458,593,12,1039,811,1022,13,11%
2018-01,הצפון,516,מג'ד אל-כרום,417,198,219,12,405,278,402,12,6%
2018-01,הצפון,874,מגדל העמק,827,388,439,78,749,258,771,56,6%
2018-01,הצפון,4201,מג'דל שמס,395,149,246,15,380,281,377,5,8%
2018-01,הצפון,517,מזרעה,142,65,77,3,139,95,134,3,7%
2018-01,הצפון,4203,מסעדה,206,85,121,6,200,150,198,4,12%
2018-01,הצפון,518,מעיליא,47,23,24,7,40,16,45,2,3%
2018-01,הצפון,1063,מעלות-תרשיחא,671,335,336,75,596,323,629,31,5%
2018-01,הצפון,520,משהד,155,75,80,8,147,113,151,4,5%
2018-01,הצפון,9100,נהרייה,1715,824,891,193,1522,793,1606,53,5%
2018-01,הצפון,522,נחף,338,160,178,16,322,247,327,6,7%
2018-01,הצפון,7300,נצרת,2422,1117,1305,100,2322,1764,2390,29,7%
2018-01,הצפון,1061,נצרת עילית,1316,630,686,141,1175,558,1171,84,5%
2018-01,הצפון,525,סאג'ור,106,38,68,6,100,69,103,0,6%
2018-01,הצפון,7500,סח'נין,1532,691,841,31,1501,1219,1518,24,11%
2018-01,הצפון,4501,ע'ג'ר,81,37,44,3,78,51,77,0,8%
2018-01,הצפון,530,עיילבון,136,70,66,4,132,74,133,4,5%
2018-01,הצפון,511,עילוט,234,103,131,3,231,182,232,0,9%
2018-01,הצפון,532,עין מאהל,343,179,164,5,338,258,332,5,7%
2018-01,הצפון,7600,עכו,2537,1185,1352,131,2406,1750,2428,36,9%
2018-01,הצפון,7700,עפולה,1403,579,824,165,1238,502,1314,73,5%
2018-01,הצפון,531,עראבה,1066,463,603,25,1041,877,1054,15,11%
2018-01,הצפון,535,פסוטה,84,42,42,6,78,40,78,4,5%
2018-01,הצפון,536,פקיעין (בוקייעה),105,47,58,5,100,65,101,2,4%
2018-01,הצפון,8000,צפת,909,484,425,94,815,539,855,27,7%
2018-01,הצפון,4100,קצרין,173,75,98,31,142,69,165,7,4%
2018-01,הצפון,2800,קריית שמונה,654,329,325,66,588,273,629,27,5%
2018-01,הצפון,543,ראמה,227,95,132,13,214,144,221,3,6%
2018-01,הצפון,26,ראש פינה,53,15,38,14,39,20,52,0,3%
2018-01,הצפון,542,ריינה,390,187,203,9,381,288,379,6,6%
2018-01,הצפון,122,רמת ישי,93,36,57,32,61,16,89,0,2%
2018-01,הצפון,913,שבלי - אום אל-גנם,168,60,108,8,160,101,164,5,7%
2018-01,הצפון,812,שלומי,209,87,122,20,189,90,201,7,6%
2018-01,הצפון,538,שעב,359,163,196,2,357,293,356,2,12%
2018-01,הצפון,8800,שפרעם,1185,512,673,29,1156,890,1161,17,7%
2018-01,חיפה,2710,אום אל-פחם,2428,1018,1410,29,2399,1950,2371,35,12%
2018-01,חיפה,1020,אור עקיבא,425,184,241,41,384,105,403,20,4%
2018-01,חיפה,6000,באקה אל-גרביה,529,257,272,13,516,299,518,21,5%
2018-01,חיפה,9800,בנימינה-גבעת עדה*,160,81,79,72,88,26,157,3,2%
2018-01,חיפה,1326,"בסמ""ה",304,141,163,2,302,220,301,2,8%
2018-01,חיפה,541,ג'סר א-זרקא,202,121,81,0,202,75,197,12,4%
2018-01,חיפה,628,ג'ת,200,102,98,13,187,105,198,5,4%
2018-01,חיפה,494,דאלית אל-כרמל,407,164,243,14,393,205,382,8,5%
2018-01,חיפה,9300,זכרון יעקב,231,94,137,101,130,24,229,4,2%
2018-01,חיפה,6500,חדרה,2011,920,1091,254,1757,577,1906,47,4%
2018-01,חיפה,4000,חיפה,5200,2518,2682,1124,4076,2323,4870,138,3%
2018-01,חיפה,1247,חריש,244,92,152,76,168,24,234,0,14%
2018-01,חיפה,2100,טירת כרמל,673,339,334,51,622,322,648,21,6%
2018-01,חיפה,654,כפר קרע,378,177,201,19,359,218,370,13,4%
2018-01,חיפה,1327,מעלה עירון,588,252,336,12,576,452,580,10,10%
2018-01,חיפה,2500,נשר,390,210,180,83,307,124,376,8,3%
2018-01,חיפה,534,עספיא,339,153,186,12,327,150,317,4,6%
2018-01,חיפה,637,ערערה,466,200,266,13,453,285,450,11,6%
2018-01,חיפה,537,פוריידיס,204,130,74,8,196,44,201,2,4%
2018-01,חיפה,7800,פרדס חנה-כרכור,725,315,410,181,544,111,710,29,4%
2018-01,חיפה,6800,קריית אתא,1320,595,725,126,1194,554,1273,44,4%
2018-01,חיפה,9500,קריית ביאליק,854,389,465,110,744,298,828,17,4%
2018-01,חיפה,2300,קריית טבעון,178,86,92,83,95,18,178,2,2%
2018-01,חיפה,9600,קריית ים,1156,547,609,91,1065,583,1106,42,5%
2018-01,חיפה,8200,קריית מוצקין,802,366,436,127,675,288,775,19,3%
2018-01,חיפה,922,רכסים,121,52,69,8,113,48,112,1,3%
2018-01,ירושלים,472,אבו גוש,202,103,99,6,196,145,200,2,7%
2018-01,ירושלים,2610,בית שמש,1118,514,604,88,1030,337,1064,67,3%
2018-01,ירושלים,3000,ירושלים,10889,4936,5953,1393,9496,6112,10588,126,4%
2018-01,ירושלים,1015,מבשרת ציון,303,161,142,68,235,89,300,6,2%
2018-01,ירושלים,1137,קריית יערים,39,12,27,9,30,10,39,0,3%
2018-01,תל אביב,2400,אור יהודה,621,307,314,43,578,125,588,21,3%
2018-01,תל אביב,565,אזור,167,84,83,33,134,21,166,4,3%
2018-01,תל אביב,6100,בני ברק,1598,799,799,98,1500,551,1499,20,3%
2018-01,תל אביב,6200,בת ים,2584,1293,1291,403,2181,795,2429,73,3%
2018-01,תל אביב,6300,גבעתיים,788,352,436,380,408,69,780,8,3%
2018-01,תל אביב,6400,הרצלייה,1050,472,578,358,692,43,1039,9,2%
2018-01,תל אביב,6600,חולון,2841,1276,1565,525,2316,521,2756,47,3%
2018-01,תל אביב,2620,קריית אונו,406,173,233,198,208,34,402,5,2%
2018-01,תל אביב,8600,רמת גן,1978,917,1061,749,1229,263,1943,13,2%
2018-01,תל אביב,2650,רמת השרון,406,175,231,193,213,15,401,2,2%
2018-01,תל אביב,5000,תל אביב -יפו,7144,3627,3517,2949,4195,1314,6991,75,3%
2018-02,אזור יהודה והשומרון,3760,אורנית,103,45,58,41,62,1,103,0,2%
2018-02,אזור יהודה והשומרון,3750,אלפי מנשה,85,32,53,34,51,0,85,1,2%
2018-02,אזור יהודה והשומרון,3560,אלקנה,24,13,11,13,11,0,24,0,1%
2018-02,אזור יהודה והשומרון,3650,אפרת,112,66,46,64,48,4,112,3,3%
2018-02,אזור יהודה והשומרון,3570,אריאל,244,97,147,50,194,19,239,14,2%
2018-02,אזור יהודה והשומרון,3574,בית אל,41,27,14,9,32,11,40,0,2%
2018-02,אזור יהודה והשומרון,3652,בית אריה,57,21,36,16,41,0,57,0,2%
2018-02,אזור יהודה והשומרון,3780,ביתר עילית,432,207,225,9,423,137,425,7,4%
2018-02,אזור יהודה והשומרון,3730,גבעת זאב,159,75,84,41,118,30,158,1,2%
2018-02,אזור יהודה והשומרון,3769,הר אדר,35,16,19,12,23,4,35,1,2%
2018-02,אזור יהודה והשומרון,3797,מודיעין עילית,402,136,266,23,379,31,399,5,3%
2018-02,אזור יהודה והשומרון,3616,מעלה אדומים,545,268,277,90,455,124,531,17,3%
2018-02,אזור יהודה והשומרון,3660,עמנואל,40,24,16,3,37,14,40,2,4%
2018-02,אזור יהודה והשומרון,3557,קדומים,32,19,13,14,18,1,32,0,2%
2018-02,אזור יהודה והשומרון,3611,קריית ארבע,73,40,33,11,62,37,70,1,2%
2018-02,אזור יהודה והשומרון,3640,קרני שומרון,71,33,38,24,47,1,70,2,2%
2018-02,הדרום,31,אופקים,773,360,413,47,726,353,749,40,6%
2018-02,הדרום,2600,אילת,1113,566,547,51,1062,296,1052,48,3%
2018-02,הדרום,70,אשדוד,4742,2063,2679,641,4101,1974,4507,106,4%
2018-02,הדרום,7100,אשקלון,3249,1447,1802,365,2884,1329,2967,61,4%
2018-02,הדרום,9000,באר שבע,5299,2504,2795,722,4577,2533,5002,94,5%
2018-02,הדרום,2200,דימונה,1600,771,829,88,1512,998,1514,31,8%
2018-02,הדרום,1303,חורה,472,192,280,4,468,405,456,6,12%
2018-02,הדרום,831,ירוחם,355,182,173,11,344,195,333,22,7%
2018-02,הדרום,1059,כסיפה,976,379,597,3,973,861,961,18,21%
2018-02,הדרום,1271,להבים,40,18,22,21,19,1,40,0,1%
2018-02,הדרום,1060,לקיה,561,244,317,7,554,490,535,1,14%
2018-02,הדרום,1268,מיתר,63,34,29,29,34,2,63,0,1%
2018-02,הדרום,99,מצפה רמון,224,85,139,17,207,140,212,8,9%
2018-02,הדרום,246,נתיבות,890,433,457,62,828,373,819,66,6%
2018-02,הדרום,666,עומר,52,24,28,21,31,3,52,0,1%
2018-02,הדרום,2560,ערד,615,270,345,66,549,300,581,27,5%
2018-02,הדרום,1192,ערערה-בנגב,1008,435,573,4,1004,905,981,12,24%
2018-02,הדרום,2630,קריית גת,1646,714,932,114,1532,588,1581,37,6%
2018-02,הדרום,1034,קריית מלאכי,726,308,418,23,703,273,695,31,6%
2018-02,הדרום,1161,רהט,2020,857,1163,14,2006,1515,1993,53,11%
2018-02,הדרום,1286,שגב-שלום,320,128,192,1,319,255,309,5,13%
2018-02,הדרום,1031,שדרות,919,439,480,52,867,436,837,38,7%
2018-02,הדרום,1054,תל שבע,701,312,389,2,699,601,657,12,15%
2018-02,המרכז,182,אבן יהודה,139,53,86,51,88,16,138,3,2%
2018-02,המרכז,41,אליכין,61,31,30,13,48,12,60,0,3%
2018-02,המרכז,1309,אלעד,308,129,179,21,287,28,298,3,2%
2018-02,המרכז,2530,באר יעקב,281,115,166,63,218,30,272,3,3%
2018-02,המרכז,466,בית דגן,101,56,45,14,87,24,98,0,3%
2018-02,המרכז,1066,"בני עי""ש",142,65,77,21,121,40,136,4,3%
2018-02,המרכז,681,גבעת שמואל,231,117,114,91,140,34,229,2,2%
2018-02,המרכז,2550,גדרה,283,123,160,70,213,51,280,7,2%
2018-02,המרכז,627,ג'לג'וליה,78,37,41,2,76,33,77,1,2%
2018-02,המרכז,166,גן יבנה,291,118,173,46,245,59,284,2,3%
2018-02,המרכז,229,גני תקווה,191,87,104,66,125,24,190,1,2%
2018-02,המרכז,9700,הוד השרון,667,278,389,319,348,27,657,6,2%
2018-02,המרכז,1290,זמר,132,49,83,4,128,78,125,2,4%
2018-02,המרכז,2730,טייבה,862,408,454,25,837,566,732,32,4%
2018-02,המרכז,2720,טירה,168,96,72,10,158,34,162,10,1%
2018-02,המרכז,2660,יבנה,696,320,376,141,555,138,683,28,3%
2018-02,המרכז,9400,יהוד,358,160,198,103,255,42,348,5,2%
2018-02,המרכז,1224,כוכב יאיר,70,27,43,48,22,1,70,1,1%
2018-02,המרכז,633,כפר ברא,14,9,5,1,13,4,13,1,1%
2018-02,המרכז,168,כפר יונה,304,130,174,56,248,37,303,3,3%
2018-02,המרכז,6900,כפר סבא,1119,524,595,420,699,68,1098,18,2%
2018-02,המרכז,634,כפר קאסם,168,81,87,3,165,89,166,1,2%
2018-02,המרכז,7000,לוד,1548,770,778,140,1408,720,1512,30,4%
2018-02,המרכז,1200,מודיעין-מכבים-רעות*,827,348,479,407,420,37,820,14,2%
2018-02,המרכז,28,מזכרת בתיה,155,66,89,52,103,20,152,2,2%
2018-02,המרכז,7200,נס ציונה,575,261,314,175,400,116,567,7,2%
2018-02,המרכז,7400,נתניה,3732,1783,1949,454,3278,994,3653,79,4%
2018-02,המרכז,587,סביון*,25,7,18,12,13,0,25,0,1%
2018-02,המרכז,171,פרדסייה,79,36,43,17,62,4,79,0,2%
2018-02,המרכז,7900,פתח תקווה,3490,1586,1904,754,2736,743,3396,45,3%
2018-02,המרכז,195,קדימה-צורן,272,126,146,92,180,29,268,1,3%
2018-02,המרכז,638,קלנסווה,322,167,155,15,307,199,285,14,3%
2018-02,המרכז,469,קריית עקרון,214,107,107,26,188,83,208,7,4%
2018-02,המרכז,2640,ראש העין,786,356,430,168,618,108,768,11,3%
2018-02,המרכז,8300,ראשון לציון,3666,1643,2023,767,2899,789,3624,43,3%
2018-02,המרכז,8400,רחובות,2015,919,1096,540,1475,555,1950,49,3%
2018-02,המרכז,8500,רמלה,1377,646,731,88,1289,476,1323,38,4%
2018-02,המרכז,8700,רעננה,695,326,369,334,361,29,688,11,2%
2018-02,המרכז,1304,שוהם,186,88,98,97,89,4,185,0,2%
2018-02,המרכז,154,תל מונד,149,70,79,48,101,16,149,0,2%
2018-02,הצפון,473,אבו סנאן,529,239,290,6,523,381,518,6,9%
2018-02,הצפון,478,אכסאל,399,177,222,12,387,319,395,3,7%
2018-02,הצפון,529,אעבלין,387,171,216,10,377,290,379,7,7%
2018-02,הצפון,482,בועיינה-נוג'ידאת,241,121,120,12,229,160,237,4,6%
2018-02,הצפון,4001,בוקעאתא,346,133,213,4,342,265,332,1,12%
2018-02,הצפון,998,ביר אל-מכסור,264,119,145,2,262,185,263,2,7%
2018-02,הצפון,480,בית ג'ן,377,103,274,3,374,236,361,1,7%
2018-02,הצפון,9200,בית שאן,637,301,336,24,613,268,616,38,6%
2018-02,הצפון,944,בסמת טבעון,159,77,82,6,153,95,144,5,5%
2018-02,הצפון,483,בענה,309,136,173,7,302,253,295,3,9%
2018-02,הצפון,1292,ג'דיידה-מכר,1005,455,550,7,998,759,988,10,11%
2018-02,הצפון,485,ג'ולס,167,42,125,3,164,85,167,1,6%
2018-02,הצפון,487,ג'ש (גוש חלב),41,19,22,5,36,20,40,1,2%
2018-02,הצפון,489,דבורייה,242,106,136,13,229,175,237,4,6%
2018-02,הצפון,490,דייר אל-אסד,312,143,169,9,303,219,306,5,6%
2018-02,הצפון,492,דייר חנא,495,234,261,13,482,338,494,4,11%
2018-02,הצפון,975,זרזיר,178,82,96,3,175,106,177,8,6%
2018-02,הצפון,496,חורפיש,97,40,57,5,92,46,87,4,3%
2018-02,הצפון,2034,חצור הגלילית,223,105,118,15,208,105,203,7,4%
2018-02,הצפון,6700,טבריה,1293,648,645,78,1215,585,1146,48,5%
2018-02,הצפון,962,טובא-זנגרייה,289,126,163,2,287,193,274,1,9%
2018-02,הצפון,498,טורעאן,315,152,163,12,303,228,305,5,6%
2018-02,הצפון,8900,טמרה,1164,559,605,20,1144,916,1141,10,9%
2018-02,הצפון,1295,יאנוח-ג'ת,124,45,79,1,123,67,119,6,4%
2018-02,הצפון,46,יבנאל,80,45,35,10,70,39,67,0,4%
2018-02,הצפון,499,יפיע,469,207,262,29,440,334,464,4,6%
2018-02,הצפון,240,יקנעם עילית,413,192,221,93,320,95,398,27,3%
2018-02,הצפון,502,ירכא,340,140,200,2,338,221,339,1,6%
2018-02,הצפון,504,כאבול,391,205,186,9,382,310,381,2,8%
2018-02,הצפון,505,כאוכב אבו אל-היג'א,177,71,106,4,173,139,177,1,11%
2018-02,הצפון,1296,כסרא-סמיע,180,62,118,1,179,112,172,4,5%
2018-02,הצפון,978,כעביה-טבאש-חג'אג'רה,161,54,107,4,157,102,157,1,7%
2018-02,הצפון,1263,כפר ורדים,56,23,33,20,36,5,53,0,2%
2018-02,הצפון,507,כפר יאסיף,348,167,181,3,345,233,338,5,7%
2018-02,הצפון,508,כפר כמא,33,13,20,3,30,14,30,0,2%
2018-02,הצפון,509,כפר כנא,656,329,327,25,631,508,630,8,8%
2018-02,הצפון,510,כפר מנדא,589,320,269,11,578,406,585,2,8%
2018-02,הצפון,47,כפר תבור,47,23,24,16,31,3,46,0,2%
2018-02,הצפון,1139,כרמיאל,1349,571,778,262,1087,631,1242,39,5%
2018-02,הצפון,481,מגאר,1012,439,573,16,996,777,982,5,11%
2018-02,הצפון,516,מג'ד אל-כרום,411,200,211,13,398,269,400,6,6%
2018-02,הצפון,874,מגדל העמק,758,341,417,83,675,247,709,48,5%
2018-02,הצפון,4201,מג'דל שמס,384,142,242,15,369,265,367,4,8%
2018-02,הצפון,517,מזרעה,128,60,68,0,128,85,123,4,6%
2018-02,הצפון,4203,מסעדה,207,89,118,7,200,145,198,3,12%
2018-02,הצפון,518,מעיליא,50,25,25,6,44,19,47,0,3%
2018-02,הצפון,1063,מעלות-תרשיחא,632,305,327,68,564,313,586,32,5%
2018-02,הצפון,520,משהד,162,71,91,5,157,117,159,1,5%
2018-02,הצפון,9100,נהרייה,1656,807,849,171,1485,769,1549,51,5%
2018-02,הצפון,522,נחף,327,151,176,11,316,241,319,1,7%
2018-02,הצפון,7300,נצרת,2436,1139,1297,109,2327,1756,2414,18,7%
2018-02,הצפון,1061,נצרת עילית,1278,612,666,143,1135,527,1134,89,5%
2018-02,הצפון,525,סאג'ור,107,40,67,7,100,67,105,1,6%
2018-02,הצפון,7500,סח'נין,1565,723,842,34,1531,1215,1549,14,12%
2018-02,הצפון,4501,ע'ג'ר,86,39,47,4,82,48,84,0,8%
2018-02,הצפון,530,עיילבון,144,74,70,5,139,79,140,1,5%
2018-02,הצפון,511,עילוט,227,96,131,2,225,183,225,0,8%
2018-02,הצפון,532,עין מאהל,321,173,148,6,315,226,311,3,6%
2018-02,הצפון,7600,עכו,2506,1153,1353,137,2369,1729,2393,39,9%
2018-02,הצפון,7700,עפולה,1369,569,800,173,1196,482,1291,51,5%
2018-02,הצפון,531,עראבה,1059,458,601,30,1029,868,1048,11,11%
2018-02,הצפון,535,פסוטה,77,42,35,6,71,38,73,1,4%
2018-02,הצפון,536,פקיעין (בוקייעה),102,46,56,3,99,64,99,3,4%
2018-02,הצפון,8000,צפת,895,486,409,91,804,512,842,18,7%
2018-02,הצפון,4100,קצרין,172,78,94,37,135,65,165,5,4%
2018-02,הצפון,2800,קריית שמונה,608,307,301,68,540,245,587,27,5%
2018-02,הצפון,543,ראמה,223,100,123,11,212,148,218,2,6%
2018-02,הצפון,26,ראש פינה,48,14,34,15,33,18,47,0,3%
2018-02,הצפון,542,ריינה,397,200,197,11,386,288,387,9,6%
2018-02,הצפון,122,רמת ישי,82,31,51,31,51,11,82,0,2%
2018-02,הצפון,913,שבלי - אום אל-גנם,155,59,96,6,149,89,153,1,6%
2018-02,הצפון,812,שלומי,198,88,110,16,182,82,189,3,5%
2018-02,הצפון,538,שעב,342,153,189,1,341,278,339,4,12%
2018-02,הצפון,8800,שפרעם,1193,528,665,32,1161,884,1166,21,7%
2018-02,חיפה,2710,אום אל-פחם,2349,999,1350,28,2321,1884,2303,36,12%
2018-02,חיפה,1020,אור עקיבא,396,183,213,38,358,96,378,19,4%
2018-02,חיפה,6000,באקה אל-גרביה,530,260,270,16,514,299,519,21,5%
2018-02,חיפה,9800,בנימינה-גבעת עדה*,155,74,81,62,93,19,153,3,2%
2018-02,חיפה,1326,"בסמ""ה",295,139,156,2,293,218,288,9,7%
2018-02,חיפה,541,ג'סר א-זרקא,187,106,81,0,187,66,180,8,3%
2018-02,חיפה,628,ג'ת,198,95,103,12,186,99,197,3,4%
2018-02,חיפה,494,דאלית אל-כרמל,406,161,245,16,390,201,383,5,5%
2018-02,חיפה,9300,זכרון יעקב,224,91,133,88,136,22,223,1,2%
2018-02,חיפה,6500,חדרה,2004,923,1081,263,1741,561,1898,39,4%
2018-02,חיפה,4000,חיפה,5101,2496,2605,1093,4008,2177,4781,132,3%
2018-02,חיפה,1247,חריש,240,88,152,74,166,18,232,0,14%
2018-02,חיפה,2100,טירת כרמל,643,334,309,56,587,321,611,16,6%
2018-02,חיפה,654,כפר קרע,382,175,207,22,360,207,372,7,5%
2018-02,חיפה,1327,מעלה עירון,590,257,333,10,580,452,578,6,10%
2018-02,חיפה,2500,נשר,388,211,177,84,304,125,372,14,3%
2018-02,חיפה,534,עספיא,323,141,182,16,307,143,304,6,6%
2018-02,חיפה,637,ערערה,453,207,246,14,439,270,431,16,5%
2018-02,חיפה,537,פוריידיס,212,130,82,9,203,48,210,2,4%
2018-02,חיפה,7800,פרדס חנה-כרכור,704,311,393,184,520,108,686,17,3%
2018-02,חיפה,6800,קריית אתא,1307,594,713,128,1179,528,1264,39,4%
2018-02,חיפה,9500,קריית ביאליק,854,389,465,101,753,293,827,17,4%
2018-02,חיפה,2300,קריית טבעון,173,82,91,77,96,16,173,1,2%
2018-02,חיפה,9600,קריית ים,1101,523,578,85,1016,563,1057,31,5%
2018-02,חיפה,8200,קריית מוצקין,804,365,439,128,676,282,766,18,3%
2018-02,חיפה,922,רכסים,119,54,65,8,111,51,109,1,3%
2018-02,ירושלים,472,אבו גוש,195,100,95,6,189,150,193,0,6%
2018-02,ירושלים,2610,בית שמש,1057,492,565,94,963,320,1023,37,3%
2018-02,ירושלים,3000,ירושלים,10616,4808,5808,1367,9249,6028,10335,125,4%
2018-02,ירושלים,1015,מבשרת ציון,293,154,139,68,225,82,287,4,2%
2018-02,ירושלים,1137,קריית יערים,41,12,29,8,33,11,41,0,3%
2018-02,תל אביב,2400,אור יהודה,592,281,311,50,542,110,569,35,3%
2018-02,תל אביב,565,אזור,163,81,82,32,131,21,161,3,3%
2018-02,תל אביב,6100,בני ברק,1520,764,756,89,1431,524,1427,21,3%
2018-02,תל אביב,6200,בת ים,2516,1254,1262,378,2138,771,2385,94,3%
2018-02,תל אביב,6300,גבעתיים,760,337,423,366,394,63,749,6,2%
2018-02,תל אביב,6400,הרצלייה,1025,461,564,369,656,40,1011,8,2%
2018-02,תל אביב,6600,חולון,2805,1271,1534,513,2292,498,2729,42,3%
2018-02,תל אביב,2620,קריית אונו,398,172,226,188,210,29,393,3,2%
2018-02,תל אביב,8600,רמת גן,1934,912,1022,723,1211,265,1899,18,2%
2018-02,תל אביב,2650,רמת השרון,392,162,230,182,210,15,390,5,2%
2018-02,תל אביב,5000,תל אביב -יפו,6940,3469,3471,2918,4022,1237,6801,78,3%
2018-03,אזור יהודה והשומרון,3760,אורנית,105,45,60,41,64,1,105,1,2%
2018-03,אזור יהודה והשומרון,3750,אלפי מנשה,86,34,52,35,51,0,86,0,2%
2018-03,אזור יהודה והשומרון,3560,אלקנה,32,19,13,16,16,0,32,0,2%
2018-03,אזור יהודה והשומרון,3650,אפרת,128,68,60,70,58,6,126,1,3%
2018-03,אזור יהודה והשומרון,3570,אריאל,249,102,147,54,195,19,246,7,2%
2018-03,אזור יהודה והשומרון,3574,בית אל,40,21,19,8,32,10,39,1,2%
2018-03,אזור יהודה והשומרון,3652,בית אריה,56,23,33,12,44,0,56,0,2%
2018-03,אזור יהודה והשומרון,3780,ביתר עילית,403,192,211,10,393,124,397,5,3%
2018-03,אזור יהודה והשומרון,3730,גבעת זאב,172,88,84,42,130,31,172,1,2%
2018-03,אזור יהודה והשומרון,3769,הר אדר,35,17,18,13,22,4,35,0,2%
2018-03,אזור יהודה והשומרון,3797,מודיעין עילית,385,131,254,25,360,22,383,1,3%
2018-03,אזור יהודה והשומרון,3616,מעלה אדומים,538,260,278,87,451,117,529,16,3%
2018-03,אזור יהודה והשומרון,3660,עמנואל,40,22,18,3,37,15,40,0,4%
2018-03,אזור יהודה והשומרון,3557,קדומים,32,19,13,13,19,1,32,1,2%
2018-03,אזור יהודה והשומרון,3611,קריית ארבע,78,43,35,10,68,34,75,5,2%
2018-03,אזור יהודה והשומרון,3640,קרני שומרון,66,32,34,24,42,1,64,1,2%
2018-03,הדרום,31,אופקים,742,339,403,39,703,350,716,42,6%
2018-03,הדרום,2600,אילת,1012,529,483,49,963,284,955,49,3%
2018-03,הדרום,70,אשדוד,4657,2058,2599,655,4002,1907,4444,89,4%
2018-03,הדרום,7100,אשקלון,3184,1408,1776,360,2824,1315,2907,64,4%
2018-03,הדרום,9000,באר שבע,5194,2457,2737,746,4448,2493,4914,99,5%
2018-03,הדרום,2200,דימונה,1594,778,816,84,1510,995,1503,22,8%
2018-03,הדרום,1303,חורה,475,193,282,4,471,400,461,3,12%
2018-03,הדרום,831,ירוחם,360,186,174,10,350,194,336,27,8%
2018-03,הדרום,1059,כסיפה,986,382,604,2,984,882,968,26,21%
2018-03,הדרום,1271,להבים,39,17,22,20,19,1,39,0,1%
2018-03,הדרום,1060,לקיה,560,247,313,8,552,483,537,2,14%
2018-03,הדרום,1268,מיתר,65,30,35,31,34,5,64,1,2%
2018-03,הדרום,99,מצפה רמון,208,78,130,15,193,138,200,18,8%
2018-03,הדרום,246,נתיבות,837,420,417,56,781,362,781,54,6%
2018-03,הדרום,666,עומר,48,21,27,21,27,3,48,0,1%
2018-03,הדרום,2560,ערד,613,277,336,59,554,299,579,27,5%
2018-03,הדרום,1192,ערערה-בנגב,995,441,554,7,988,883,976,10,24%
2018-03,הדרום,2630,קריית גת,1657,708,949,119,1538,592,1589,43,6%
2018-03,הדרום,1034,קריית מלאכי,686,294,392,24,662,272,658,35,6%
2018-03,הדרום,1161,רהט,1973,830,1143,10,1963,1480,1948,57,11%
2018-03,הדרום,1286,שגב-שלום,316,130,186,2,314,253,305,5,13%
2018-03,הדרום,1031,שדרות,871,418,453,60,811,420,800,29,6%
2018-03,הדרום,1054,תל שבע,686,307,379,5,681,593,645,9,15%
2018-03,המרכז,182,אבן יהודה,142,62,80,49,93,16,142,0,2%
2018-03,המרכז,41,אליכין,53,29,24,13,40,10,51,0,3%
2018-03,המרכז,1309,אלעד,313,137,176,16,297,31,300,2,2%
2018-03,המרכז,2530,באר יעקב,273,110,163,67,206,31,263,2,3%
2018-03,המרכז,466,בית דגן,98,52,46,15,83,23,96,0,3%
2018-03,המרכז,1066,"בני עי""ש",133,60,73,20,113,35,130,5,3%
2018-03,המרכז,681,גבעת שמואל,226,112,114,87,139,30,224,1,2%
2018-03,המרכז,2550,גדרה,298,129,169,70,228,57,292,7,3%
2018-03,המרכז,627,ג'לג'וליה,69,33,36,0,69,28,66,1,2%
2018-03,המרכז,166,גן יבנה,273,113,160,50,223,49,268,4,2%
2018-03,המרכז,229,גני תקווה,190,83,107,66,124,21,190,0,2%
2018-03,המרכז,9700,הוד השרון,706,289,417,341,365,24,697,4,2%
2018-03,המרכז,1290,זמר,131,49,82,4,127,74,126,2,4%
2018-03,המרכז,2730,טייבה,864,416,448,22,842,555,730,23,4%
2018-03,המרכז,2720,טירה,166,91,75,15,151,34,158,10,1%
2018-03,המרכז,2660,יבנה,683,317,366,150,533,126,674,18,3%
2018-03,המרכז,9400,יהוד,369,165,204,112,257,38,360,10,2%
2018-03,המרכז,1224,כוכב יאיר,73,24,49,49,24,0,73,1,1%
2018-03,המרכז,633,כפר ברא,19,11,8,2,17,5,17,1,1%
2018-03,המרכז,168,כפר יונה,305,131,174,60,245,39,304,5,3%
2018-03,המרכז,6900,כפר סבא,1133,520,613,446,687,68,1118,17,2%
2018-03,המרכז,634,כפר קאסם,169,82,87,3,166,81,164,1,2%
2018-03,המרכז,7000,לוד,1552,771,781,144,1408,732,1507,34,4%
2018-03,המרכז,1200,מודיעין-מכבים-רעות*,796,329,467,398,398,29,792,11,2%
2018-03,המרכז,28,מזכרת בתיה,155,70,85,53,102,20,153,0,2%
2018-03,המרכז,7200,נס ציונה,576,258,318,175,401,121,567,4,2%
2018-03,המרכז,7400,נתניה,3684,1764,1920,471,3213,952,3602,83,3%
2018-03,המרכז,587,סביון*,23,5,18,12,11,0,23,0,1%
2018-03,המרכז,171,פרדסייה,84,37,47,20,64,4,82,0,2%
2018-03,המרכז,7900,פתח תקווה,3504,1617,1887,777,2727,720,3407,33,3%
2018-03,המרכז,195,קדימה-צורן,257,110,147,94,163,23,251,0,2%
2018-03,המרכז,638,קלנסווה,321,164,157,13,308,191,283,19,3%
2018-03,המרכז,469,קריית עקרון,205,103,102,27,178,82,200,7,3%
2018-03,המרכז,2640,ראש העין,778,348,430,171,607,112,771,14,3%
2018-03,המרכז,8300,ראשון לציון,3708,1653,2055,815,2893,799,3665,30,3%
2018-03,המרכז,8400,רחובות,1976,917,1059,532,1444,549,1923,39,3%
2018-03,המרכז,8500,רמלה,1336,628,708,93,1243,472,1279,44,4%
2018-03,המרכז,8700,רעננה,689,319,370,345,344,25,682,4,2%
2018-03,המרכז,1304,שוהם,185,88,97,102,83,6,183,2,2%
2018-03,המרכז,154,תל מונד,146,68,78,52,94,15,145,0,2%
2018-03,הצפון,473,אבו סנאן,524,234,290,8,516,375,509,5,9%
2018-03,הצפון,478,אכסאל,393,174,219,11,382,311,390,5,7%
2018-03,הצפון,529,אעבלין,375,166,209,12,363,280,369,4,7%
2018-03,הצפון,482,בועיינה-נוג'ידאת,236,113,123,13,223,158,231,3,6%
2018-03,הצפון,4001,בוקעאתא,334,131,203,6,328,250,325,2,12%
2018-03,הצפון,998,ביר אל-מכסור,255,116,139,4,251,178,252,1,7%
2018-03,הצפון,480,בית ג'ן,371,101,270,6,365,234,361,2,7%
2018-03,הצפון,9200,בית שאן,597,276,321,24,573,270,577,30,6%
2018-03,הצפון,944,בסמת טבעון,152,75,77,5,147,89,140,5,4%
2018-03,הצפון,483,בענה,318,133,185,10,308,261,299,1,9%
2018-03,הצפון,1292,ג'דיידה-מכר,1017,469,548,8,1009,755,995,15,11%
2018-03,הצפון,485,ג'ולס,158,39,119,2,156,83,156,2,6%
2018-03,הצפון,487,ג'ש (גוש חלב),38,17,21,4,34,20,38,1,2%
2018-03,הצפון,489,דבורייה,230,99,131,14,216,165,225,4,6%
2018-03,הצפון,490,דייר אל-אסד,320,135,185,11,309,224,306,5,6%
2018-03,הצפון,492,דייר חנא,480,223,257,13,467,335,478,5,10%
2018-03,הצפון,975,זרזיר,180,78,102,3,177,109,177,4,6%
2018-03,הצפון,496,חורפיש,99,45,54,8,91,45,90,5,3%
2018-03,הצפון,2034,חצור הגלילית,220,100,120,20,200,99,206,3,4%
2018-03,הצפון,6700,טבריה,1270,629,641,83,1187,591,1126,50,5%
2018-03,הצפון,962,טובא-זנגרייה,284,127,157,3,281,187,269,1,9%
2018-03,הצפון,498,טורעאן,304,141,163,13,291,219,300,12,6%
2018-03,הצפון,8900,טמרה,1169,562,607,22,1147,913,1143,12,9%
2018-03,הצפון,1295,יאנוח-ג'ת,120,43,77,1,119,65,113,5,4%
2018-03,הצפון,46,יבנאל,72,40,32,7,65,34,60,3,4%
2018-03,הצפון,499,יפיע,454,202,252,26,428,329,451,6,6%
2018-03,הצפון,240,יקנעם עילית,402,188,214,98,304,88,392,27,3%
2018-03,הצפון,502,ירכא,350,151,199,2,348,238,347,1,6%
2018-03,הצפון,504,כאבול,387,210,177,9,378,302,376,4,8%
2018-03,הצפון,505,כאוכב אבו אל-היג'א,172,67,105,7,165,137,172,2,10%
2018-03,הצפון,1296,כסרא-סמיע,181,64,117,1,180,106,170,4,5%
2018-03,הצפון,978,כעביה-טבאש-חג'אג'רה,168,58,110,5,163,105,161,3,7%
2018-03,הצפון,1263,כפר ורדים,60,20,40,20,40,6,57,0,2%
2018-03,הצפון,507,כפר יאסיף,353,166,187,4,349,240,339,1,7%
2018-03,הצפון,508,כפר כמא,34,14,20,7,27,13,33,1,2%
2018-03,הצפון,509,כפר כנא,661,335,326,28,633,509,633,10,8%
2018-03,הצפון,510,כפר מנדא,587,314,273,13,574,414,582,3,8%
2018-03,הצפון,47,כפר תבור,42,20,22,16,26,3,42,0,2%
2018-03,הצפון,1139,כרמיאל,1328,560,768,258,1070,619,1219,28,5%
2018-03,הצפון,481,מגאר,1004,433,571,15,989,768,976,7,11%
2018-03,הצפון,516,מג'ד אל-כרום,425,200,225,13,412,288,410,13,6%
2018-03,הצפון,874,מגדל העמק,708,319,389,71,637,223,667,59,5%
2018-03,הצפון,4201,מג'דל שמס,372,135,237,13,359,261,359,2,8%
2018-03,הצפון,517,מזרעה,123,56,67,0,123,83,116,0,6%
2018-03,הצפון,4203,מסעדה,203,84,119,7,196,137,194,1,12%
2018-03,הצפון,518,מעיליא,49,26,23,6,43,18,48,2,3%
2018-03,הצפון,1063,מעלות-תרשיחא,634,306,328,70,564,307,596,29,5%
2018-03,הצפון,520,משהד,162,69,93,3,159,118,158,4,5%
2018-03,הצפון,9100,נהרייה,1592,777,815,163,1429,763,1490,58,5%
2018-03,הצפון,522,נחף,334,153,181,10,324,250,327,4,7%
2018-03,הצפון,7300,נצרת,2415,1134,1281,110,2305,1743,2388,31,7%
2018-03,הצפון,1061,נצרת עילית,1238,592,646,131,1107,529,1112,86,5%
2018-03,הצפון,525,סאג'ור,107,41,66,7,100,62,106,1,6%
2018-03,הצפון,7500,סח'נין,1561,717,844,36,1525,1195,1545,8,12%
2018-03,הצפון,4501,ע'ג'ר,78,33,45,2,76,45,76,1,8%
2018-03,הצפון,530,עיילבון,151,72,79,5,146,81,146,1,5%
2018-03,הצפון,511,עילוט,230,94,136,2,228,181,230,1,8%
2018-03,הצפון,532,עין מאהל,312,174,138,5,307,216,304,2,6%
2018-03,הצפון,7600,עכו,2476,1114,1362,137,2339,1685,2372,36,9%
2018-03,הצפון,7700,עפולה,1353,570,783,170,1183,467,1284,61,5%
2018-03,הצפון,531,עראבה,1049,453,596,27,1022,861,1040,7,11%
2018-03,הצפון,535,פסוטה,82,43,39,9,73,38,77,4,5%
2018-03,הצפון,536,פקיעין (בוקייעה),109,53,56,6,103,67,105,5,4%
2018-03,הצפון,8000,צפת,865,456,409,89,776,512,816,19,6%
2018-03,הצפון,4100,קצרין,162,73,89,32,130,61,156,6,4%
2018-03,הצפון,2800,קריית שמונה,612,301,311,66,546,242,588,29,5%
2018-03,הצפון,543,ראמה,224,103,121,10,214,151,215,1,6%
2018-03,הצפון,26,ראש פינה,46,15,31,15,31,18,45,0,3%
2018-03,הצפון,542,ריינה,400,196,204,11,389,293,388,5,6%
2018-03,הצפון,122,רמת ישי,81,25,56,30,51,15,80,1,2%
2018-03,הצפון,913,שבלי - אום אל-גנם,148,56,92,5,143,93,145,8,6%
2018-03,הצפון,812,שלומי,184,77,107,15,169,78,175,4,5%
2018-03,הצפון,538,שעב,341,156,185,1,340,279,338,1,12%
2018-03,הצפון,8800,שפרעם,1186,531,655,36,1150,874,1153,18,7%
2018-03,חיפה,2710,אום אל-פחם,2314,998,1316,29,2285,1856,2258,38,12%
2018-03,חיפה,1020,אור עקיבא,431,197,234,48,383,95,414,11,4%
2018-03,חיפה,6000,באקה אל-גרביה,524,259,265,17,507,301,512,20,4%
2018-03,חיפה,9800,בנימינה-גבעת עדה*,156,73,83,67,89,16,153,1,2%
2018-03,חיפה,1326,"בסמ""ה",301,138,163,4,297,225,297,4,8%
2018-03,חיפה,541,ג'סר א-זרקא,180,103,77,0,180,70,173,11,3%
2018-03,חיפה,628,ג'ת,192,93,99,10,182,94,191,2,4%
2018-03,חיפה,494,דאלית אל-כרמל,399,161,238,16,383,201,375,6,5%
2018-03,חיפה,9300,זכרון יעקב,210,80,130,86,124,17,209,0,2%
2018-03,חיפה,6500,חדרה,1976,926,1050,276,1700,547,1879,31,4%
2018-03,חיפה,4000,חיפה,5070,2448,2622,1122,3948,2160,4756,122,3%
2018-03,חיפה,1247,חריש,230,74,156,68,162,16,224,1,13%
2018-03,חיפה,2100,טירת כרמל,625,304,321,56,569,314,601,17,6%
2018-03,חיפה,654,כפר קרע,366,171,195,20,346,202,359,11,4%
2018-03,חיפה,1327,מעלה עירון,577,247,330,10,567,442,567,3,10%
2018-03,חיפה,2500,נשר,360,184,176,80,280,122,345,8,3%
2018-03,חיפה,534,עספיא,321,139,182,16,305,139,303,2,6%
2018-03,חיפה,637,ערערה,459,213,246,14,445,267,435,14,5%
2018-03,חיפה,537,פוריידיס,197,120,77,10,187,46,194,2,4%
2018-03,חיפה,7800,פרדס חנה-כרכור,679,294,385,197,482,96,666,15,3%
2018-03,חיפה,6800,קריית אתא,1278,577,701,127,1151,520,1227,36,4%
2018-03,חיפה,9500,קריית ביאליק,845,376,469,106,739,299,825,23,4%
2018-03,חיפה,2300,קריית טבעון,182,86,96,73,109,19,180,1,2%
2018-03,חיפה,9600,קריית ים,1100,522,578,103,997,564,1047,34,5%
2018-03,חיפה,8200,קריית מוצקין,797,361,436,139,658,259,770,12,3%
2018-03,חיפה,922,רכסים,118,56,62,10,108,50,110,1,3%
2018-03,ירושלים,472,אבו גוש,189,93,96,8,181,142,187,1,6%
2018-03,ירושלים,2610,בית שמש,1023,490,533,90,933,311,982,35,3%
2018-03,ירושלים,3000,ירושלים,10523,4816,5707,1395,9128,5974,10235,106,3%
2018-03,ירושלים,1015,מבשרת ציון,296,145,151,70,226,85,293,2,2%
2018-03,ירושלים,1137,קריית יערים,43,15,28,7,36,10,42,0,3%
2018-03,תל אביב,2400,אור יהודה,598,314,284,54,544,108,572,22,3%
2018-03,תל אביב,565,אזור,160,71,89,31,129,19,156,5,2%
2018-03,תל אביב,6100,בני ברק,1519,767,752,84,1435,538,1429,14,3%
2018-03,תל אביב,6200,בת ים,2391,1199,1192,362,2029,754,2277,58,3%
2018-03,תל אביב,6300,גבעתיים,755,336,419,384,371,69,745,3,2%
2018-03,תל אביב,6400,הרצלייה,1025,475,550,384,641,39,1016,13,2%
2018-03,תל אביב,6600,חולון,2757,1258,1499,498,2259,502,2691,43,3%
2018-03,תל אביב,2620,קריית אונו,396,173,223,181,215,27,391,2,2%
2018-03,תל אביב,8600,רמת גן,1961,881,1080,741,1220,252,1923,21,2%
2018-03,תל אביב,2650,רמת השרון,406,174,232,196,210,17,398,2,2%
2018-03,תל אביב,5000,תל אביב -יפו,7049,3495,3554,3027,4022,1257,6903,78,3%
2018-04,אזור יהודה והשומרון,3760,אורנית,108,44,64,41,67,1,108,1,2%
2018-04,אזור יהודה והשומרון,3750,אלפי מנשה,86,31,55,32,54,0,86,0,2%
2018-04,אזור יהודה והשומרון,3560,אלקנה,34,19,15,17,17,0,34,0,2%
2018-04,אזור יהודה והשומרון,3650,אפרת,132,76,56,74,58,4,132,2,3%
2018-04,אזור יהודה והשומרון,3570,אריאל,234,103,131,49,185,17,228,6,2%
2018-04,אזור יהודה והשומרון,3574,בית אל,43,22,21,12,31,8,42,3,2%
2018-04,אזור יהודה והשומרון,3652,בית אריה,51,21,30,10,41,0,51,0,2%
2018-04,אזור יהודה והשומרון,3780,ביתר עילית,388,188,200,16,372,118,380,3,3%
2018-04,אזור יהודה והשומרון,3730,גבעת זאב,167,74,93,33,134,32,167,1,2%
2018-04,אזור יהודה והשומרון,3769,הר אדר,36,17,19,14,22,3,36,0,2%
2018-04,אזור יהודה והשומרון,3797,מודיעין עילית,379,125,254,25,354,28,375,3,3%
2018-04,אזור יהודה והשומרון,3616,מעלה אדומים,507,229,278,88,419,112,499,11,2%
2018-04,אזור יהודה והשומרון,3660,עמנואל,44,23,21,3,41,14,44,1,4%
2018-04,אזור יהודה והשומרון,3557,קדומים,32,15,17,15,17,0,32,0,2%
2018-04,אזור יהודה והשומרון,3611,קריית ארבע,79,45,34,12,67,32,75,4,2%
2018-04,אזור יהודה והשומרון,3640,קרני שומרון,64,28,36,22,42,1,63,1,2%
2018-04,הדרום,31,אופקים,747,343,404,43,704,334,728,19,6%
2018-04,הדרום,2600,אילת,820,427,393,42,778,254,778,32,2%
2018-04,הדרום,70,אשדוד,4539,1993,2546,643,3896,1853,4340,73,4%
2018-04,הדרום,7100,אשקלון,3180,1367,1813,379,2801,1261,2927,49,4%
2018-04,הדרום,9000,באר שבע,5081,2377,2704,736,4345,2418,4803,76,5%
2018-04,הדרום,2200,דימונה,1517,759,758,76,1441,953,1437,13,8%
2018-04,הדרום,1303,חורה,459,193,266,5,454,394,442,4,12%
2018-04,הדרום,831,ירוחם,364,192,172,10,354,194,332,9,7%
2018-04,הדרום,1059,כסיפה,944,359,585,1,943,852,932,3,20%
2018-04,הדרום,1271,להבים,44,20,24,24,20,0,43,0,1%
2018-04,הדרום,1060,לקיה,546,237,309,7,539,473,524,3,14%
2018-04,הדרום,1268,מיתר,65,33,32,33,32,4,64,0,2%
2018-04,הדרום,99,מצפה רמון,203,83,120,12,191,139,193,10,8%
2018-04,הדרום,246,נתיבות,876,407,469,66,810,359,823,32,6%
2018-04,הדרום,666,עומר,38,16,22,14,24,3,38,0,1%
2018-04,הדרום,2560,ערד,589,271,318,53,536,286,561,31,5%
2018-04,הדרום,1192,ערערה-בנגב,943,411,532,6,937,845,930,12,23%
2018-04,הדרום,2630,קריית גת,1670,688,982,130,1540,582,1595,31,6%
2018-04,הדרום,1034,קריית מלאכי,723,324,399,23,700,276,691,24,6%
2018-04,הדרום,1161,רהט,1912,770,1142,7,1905,1427,1883,42,11%
2018-04,הדרום,1286,שגב-שלום,307,122,185,3,304,261,296,3,12%
2018-04,הדרום,1031,שדרות,864,408,456,57,807,406,783,27,6%
2018-04,הדרום,1054,תל שבע,647,285,362,4,643,571,608,3,14%
2018-04,המרכז,182,אבן יהודה,135,60,75,57,78,14,134,3,2%
2018-04,המרכז,41,אליכין,53,29,24,14,39,9,51,0,3%
2018-04,המרכז,1309,אלעד,302,133,169,17,285,21,288,2,2%
2018-04,המרכז,2530,באר יעקב,279,112,167,70,209,26,270,2,3%
2018-04,המרכז,466,בית דגן,97,51,46,17,80,22,93,0,3%
2018-04,המרכז,1066,"בני עי""ש",120,55,65,16,104,29,117,2,3%
2018-04,המרכז,681,גבעת שמואל,234,119,115,91,143,27,230,2,2%
2018-04,המרכז,2550,גדרה,298,133,165,65,233,59,291,8,3%
2018-04,המרכז,627,ג'לג'וליה,61,28,33,0,61,29,59,0,2%
2018-04,המרכז,166,גן יבנה,268,112,156,50,218,50,263,1,2%
2018-04,המרכז,229,גני תקווה,194,79,115,69,125,21,193,1,2%
2018-04,המרכז,9700,הוד השרון,674,269,405,333,341,27,667,7,2%
2018-04,המרכז,1290,זמר,132,46,86,4,128,77,127,0,4%
2018-04,המרכז,2730,טייבה,835,405,430,20,815,533,701,21,4%
2018-04,המרכז,2720,טירה,130,73,57,16,114,22,125,10,1%
2018-04,המרכז,2660,יבנה,663,300,363,141,522,128,652,28,3%
2018-04,המרכז,9400,יהוד,352,155,197,110,242,39,342,8,2%
2018-04,המרכז,1224,כוכב יאיר,73,26,47,52,21,0,73,0,1%
2018-04,המרכז,633,כפר ברא,17,9,8,2,15,5,16,1,1%
2018-04,המרכז,168,כפר יונה,276,117,159,57,219,40,274,4,3%
2018-04,המרכז,6900,כפר סבא,1131,493,638,468,663,66,1119,14,2%
2018-04,המרכז,634,כפר קאסם,170,84,86,3,167,86,164,1,2%
2018-04,המרכז,7000,לוד,1484,739,745,138,1346,702,1445,26,4%
2018-04,המרכז,1200,מודיעין-מכבים-רעות*,812,341,471,407,405,25,804,5,2%
2018-04,המרכז,28,מזכרת בתיה,157,72,85,53,104,21,154,0,2%
2018-04,המרכז,7200,נס ציונה,562,244,318,181,381,119,550,3,2%
2018-04,המרכז,7400,נתניה,3610,1703,1907,508,3102,926,3533,61,3%
2018-04,המרכז,587,סביון*,22,6,16,12,10,0,22,0,1%
2018-04,המרכז,171,פרדסייה,85,36,49,20,65,3,84,1,2%
2018-04,המרכז,7900,פתח תקווה,3483,1602,1881,778,2705,709,3408,35,3%
2018-04,המרכז,195,קדימה-צורן,254,111,143,99,155,24,251,0,2%
2018-04,המרכז,638,קלנסווה,297,145,152,12,285,178,255,8,3%
2018-04,המרכז,469,קריית עקרון,214,109,105,26,188,86,209,7,4%
2018-04,המרכז,2640,ראש העין,759,336,423,175,584,92,742,7,3%
2018-04,המרכז,8300,ראשון לציון,3647,1633,2014,813,2834,773,3608,28,3%
2018-04,המרכז,8400,רחובות,2013,921,1092,554,1459,546,1956,32,3%
2018-04,המרכז,8500,רמלה,1276,610,666,95,1181,432,1214,45,3%
2018-04,המרכז,8700,רעננה,675,306,369,356,319,23,669,7,2%
2018-04,המרכז,1304,שוהם,181,88,93,97,84,5,180,1,2%
2018-04,המרכז,154,תל מונד,136,59,77,50,86,13,135,2,2%
2018-04,הצפון,473,אבו סנאן,520,227,293,7,513,366,510,5,9%
2018-04,הצפון,478,אכסאל,386,174,212,10,376,303,381,0,7%
2018-04,הצפון,529,אעבלין,348,153,195,11,337,261,342,7,6%
2018-04,הצפון,482,בועיינה-נוג'ידאת,219,107,112,7,212,154,217,6,6%
2018-04,הצפון,4001,בוקעאתא,317,120,197,7,310,237,309,4,12%
2018-04,הצפון,998,ביר אל-מכסור,245,118,127,4,241,166,243,4,7%
2018-04,הצפון,480,בית ג'ן,377,96,281,8,369,227,366,1,7%
2018-04,הצפון,9200,בית שאן,604,286,318,16,588,264,576,23,6%
2018-04,הצפון,944,בסמת טבעון,137,67,70,5,132,87,125,3,4%
2018-04,הצפון,483,בענה,294,128,166,8,286,239,281,4,9%
2018-04,הצפון,1292,ג'דיידה-מכר,989,453,536,7,982,725,976,9,11%
2018-04,הצפון,485,ג'ולס,141,33,108,1,140,77,141,0,5%
2018-04,הצפון,487,ג'ש (גוש חלב),44,18,26,6,38,18,43,2,3%
2018-04,הצפון,489,דבורייה,227,92,135,12,215,161,221,1,5%
2018-04,הצפון,490,דייר אל-אסד,307,137,170,8,299,216,297,6,6%
2018-04,הצפון,492,דייר חנא,466,210,256,9,457,338,465,4,10%
2018-04,הצפון,975,זרזיר,171,71,100,4,167,112,168,1,6%
2018-04,הצפון,496,חורפיש,104,51,53,9,95,50,93,2,4%
2018-04,הצפון,2034,חצור הגלילית,225,101,124,21,204,94,208,4,4%
2018-04,הצפון,6700,טבריה,1228,585,643,83,1145,550,1096,55,5%
2018-04,הצפון,962,טובא-זנגרייה,288,121,167,5,283,181,277,6,9%
2018-04,הצפון,498,טורעאן,290,132,158,13,277,214,283,2,5%
2018-04,הצפון,8900,טמרה,1130,539,591,18,1112,886,1107,11,8%
2018-04,הצפון,1295,יאנוח-ג'ת,117,43,74,1,116,65,110,5,4%
2018-04,הצפון,46,יבנאל,67,41,26,6,61,31,59,1,4%
2018-04,הצפון,499,יפיע,423,187,236,25,398,310,419,7,6%
2018-04,הצפון,240,יקנעם עילית,392,181,211,101,291,81,380,17,3%
2018-04,הצפון,502,ירכא,310,127,183,2,308,219,308,2,6%
2018-04,הצפון,504,כאבול,371,204,167,8,363,288,365,2,8%
2018-04,הצפון,505,כאוכב אבו אל-היג'א,170,65,105,6,164,141,169,1,10%
2018-04,הצפון,1296,כסרא-סמיע,165,56,109,1,164,100,155,3,5%
2018-04,הצפון,978,כעביה-טבאש-חג'אג'רה,146,52,94,5,141,100,140,2,6%
2018-04,הצפון,1263,כפר ורדים,53,19,34,23,30,7,49,1,2%
2018-04,הצפון,507,כפר יאסיף,335,155,180,4,331,229,323,3,6%
2018-04,הצפון,508,כפר כמא,31,13,18,5,26,14,30,0,2%
2018-04,הצפון,509,כפר כנא,644,321,323,25,619,495,617,4,7%
2018-04,הצפון,510,כפר מנדא,563,305,258,11,552,398,558,4,8%
2018-04,הצפון,47,כפר תבור,38,16,22,17,21,2,38,0,2%
2018-04,הצפון,1139,כרמיאל,1280,536,744,259,1021,611,1177,21,5%
2018-04,הצפון,481,מגאר,958,403,555,16,942,710,937,7,11%
2018-04,הצפון,516,מג'ד אל-כרום,398,180,218,10,388,283,387,8,6%
2018-04,הצפון,874,מגדל העמק,707,327,380,75,632,213,660,44,5%
2018-04,הצפון,4201,מג'דל שמס,358,128,230,12,346,246,346,4,7%
2018-04,הצפון,517,מזרעה,119,51,68,0,119,84,111,1,6%
2018-04,הצפון,4203,מסעדה,184,74,110,9,175,123,177,2,11%
2018-04,הצפון,518,מעיליא,45,24,21,5,40,17,43,0,3%
2018-04,הצפון,1063,מעלות-תרשיחא,616,299,317,71,545,312,573,34,5%
2018-04,הצפון,520,משהד,155,65,90,2,153,113,150,3,5%
2018-04,הצפון,9100,נהרייה,1589,770,819,166,1423,737,1481,38,5%
2018-04,הצפון,522,נחף,334,145,189,7,327,246,325,2,7%
2018-04,הצפון,7300,נצרת,2345,1103,1242,106,2239,1680,2322,17,7%
2018-04,הצפון,1061,נצרת עילית,1151,557,594,125,1026,494,1027,55,4%
2018-04,הצפון,525,סאג'ור,108,37,71,5,103,61,107,1,6%
2018-04,הצפון,7500,סח'נין,1503,694,809,27,1476,1165,1487,5,11%
2018-04,הצפון,4501,ע'ג'ר,74,34,40,2,72,42,73,0,7%
2018-04,הצפון,530,עיילבון,132,63,69,5,127,73,127,2,5%
2018-04,הצפון,511,עילוט,227,92,135,5,222,175,225,0,8%
2018-04,הצפון,532,עין מאהל,299,167,132,5,294,213,286,1,6%
2018-04,הצפון,7600,עכו,2380,1063,1317,134,2246,1631,2275,16,9%
2018-04,הצפון,7700,עפולה,1343,569,774,168,1175,456,1267,55,5%
2018-04,הצפון,531,עראבה,1025,437,588,26,999,851,1013,5,11%
2018-04,הצפון,535,פסוטה,80,41,39,8,72,39,75,0,5%
2018-04,הצפון,536,פקיעין (בוקייעה),97,50,47,5,92,64,92,2,3%
2018-04,הצפון,8000,צפת,870,463,407,85,785,511,820,18,6%
2018-04,הצפון,4100,קצרין,158,80,78,31,127,64,152,4,4%
2018-04,הצפון,2800,קריית שמונה,600,296,304,61,539,227,574,27,4%
2018-04,הצפון,543,ראמה,213,98,115,10,203,147,204,2,5%
2018-04,הצפון,26,ראש פינה,47,14,33,11,36,18,46,0,3%
2018-04,הצפון,542,ריינה,405,199,206,10,395,293,394,5,6%
2018-04,הצפון,122,רמת ישי,78,22,56,29,49,14,77,0,2%
2018-04,הצפון,913,שבלי - אום אל-גנם,150,54,96,5,145,86,147,3,6%
2018-04,הצפון,812,שלומי,191,84,107,13,178,86,183,1,5%
2018-04,הצפון,538,שעב,329,148,181,2,327,265,327,1,11%
2018-04,הצפון,8800,שפרעם,1126,504,622,29,1097,818,1101,16,7%
2018-04,חיפה,2710,אום אל-פחם,2177,925,1252,23,2154,1765,2126,28,11%
2018-04,חיפה,1020,אור עקיבא,408,187,221,47,361,88,391,13,4%
2018-04,חיפה,6000,באקה אל-גרביה,522,262,260,17,505,296,513,15,5%
2018-04,חיפה,9800,בנימינה-גבעת עדה*,149,66,83,67,82,14,149,3,2%
2018-04,חיפה,1326,"בסמ""ה",277,122,155,6,271,212,274,2,7%
2018-04,חיפה,541,ג'סר א-זרקא,168,88,80,1,167,59,162,5,3%
2018-04,חיפה,628,ג'ת,186,90,96,8,178,93,185,6,4%
2018-04,חיפה,494,דאלית אל-כרמל,382,152,230,16,366,190,361,2,5%
2018-04,חיפה,9300,זכרון יעקב,207,84,123,91,116,12,206,0,2%
2018-04,חיפה,6500,חדרה,1893,862,1031,275,1618,513,1783,46,4%
2018-04,חיפה,4000,חיפה,4855,2352,2503,1118,3737,1993,4570,74,3%
2018-04,חיפה,1247,חריש,238,86,152,74,164,18,234,1,14%
2018-04,חיפה,2100,טירת כרמל,600,307,293,49,551,296,572,11,5%
2018-04,חיפה,654,כפר קרע,340,153,187,20,320,184,334,4,4%
2018-04,חיפה,1327,מעלה עירון,571,243,328,8,563,428,562,3,10%
2018-04,חיפה,2500,נשר,334,174,160,73,261,105,323,4,3%
2018-04,חיפה,534,עספיא,308,131,177,18,290,136,287,4,5%
2018-04,חיפה,637,ערערה,470,212,258,15,455,278,451,13,6%
2018-04,חיפה,537,פוריידיס,180,105,75,9,171,42,177,3,3%
2018-04,חיפה,7800,פרדס חנה-כרכור,686,293,393,198,488,87,667,9,3%
2018-04,חיפה,6800,קריית אתא,1220,561,659,120,1100,499,1171,25,4%
2018-04,חיפה,9500,קריית ביאליק,797,347,450,103,694,277,774,10,4%
2018-04,חיפה,2300,קריית טבעון,168,83,85,70,98,19,166,0,2%
2018-04,חיפה,9600,קריית ים,1017,505,512,91,926,511,978,26,5%
2018-04,חיפה,8200,קריית מוצקין,749,324,425,141,608,256,727,11,3%
2018-04,חיפה,922,רכסים,116,51,65,8,108,47,107,0,3%
2018-04,ירושלים,472,אבו גוש,186,96,90,7,179,140,185,2,6%
2018-04,ירושלים,2610,בית שמש,1047,493,554,95,952,304,1005,26,3%
2018-04,ירושלים,3000,ירושלים,10276,4686,5590,1362,8914,5787,10013,95,3%
2018-04,ירושלים,1015,מבשרת ציון,276,139,137,65,211,80,272,2,2%
2018-04,ירושלים,1137,קריית יערים,44,19,25,9,35,9,44,0,3%
2018-04,תל אביב,2400,אור יהודה,599,305,294,54,545,113,575,19,3%
2018-04,תל אביב,565,אזור,157,66,91,30,127,13,156,2,2%
2018-04,תל אביב,6100,בני ברק,1504,764,740,86,1418,512,1418,14,3%
2018-04,תל אביב,6200,בת ים,2331,1147,1184,356,1975,726,2204,62,3%
2018-04,תל אביב,6300,גבעתיים,739,327,412,385,354,59,733,2,2%
2018-04,תל אביב,6400,הרצלייה,1015,474,541,375,640,44,998,10,2%
2018-04,תל אביב,6600,חולון,2697,1211,1486,495,2202,481,2634,37,3%
2018-04,תל אביב,2620,קריית אונו,397,177,220,191,206,29,393,1,2%
2018-04,תל אביב,8600,רמת גן,1897,851,1046,710,1187,250,1866,16,2%
2018-04,תל אביב,2650,רמת השרון,396,171,225,207,189,8,395,1,2%
2018-04,תל אביב,5000,תל אביב -יפו,6849,3366,3483,2960,3889,1210,6722,56,3%
2018-05,אזור יהודה והשומרון,3760,אורנית,103,41,62,38,65,1,103,0,2%
2018-05,אזור יהודה והשומרון,3750,אלפי מנשה,84,32,52,31,53,0,84,3,2%
2018-05,אזור יהודה והשומרון,3560,אלקנה,29,17,12,15,14,1,29,0,2%
2018-05,אזור יהודה והשומרון,3650,אפרת,130,74,56,66,64,4,130,1,3%
2018-05,אזור יהודה והשומרון,3570,אריאל,239,109,130,52,187,14,237,11,2%
2018-05,אזור יהודה והשומרון,3574,בית אל,41,19,22,10,31,10,40,2,2%
2018-05,אזור יהודה והשומרון,3652,בית אריה,53,24,29,10,43,0,53,1,2%
2018-05,אזור יהודה והשומרון,3780,ביתר עילית,402,194,208,14,388,127,394,3,3%
2018-05,אזור יהודה והשומרון,3730,גבעת זאב,167,80,87,27,140,34,166,2,2%
2018-05,אזור יהודה והשומרון,3769,הר אדר,36,18,18,16,20,6,36,1,2%
2018-05,אזור יהודה והשומרון,3797,מודיעין עילית,357,124,233,25,332,29,352,2,3%
2018-05,אזור יהודה והשומרון,3616,מעלה אדומים,490,220,270,74,416,115,483,20,2%
2018-05,אזור יהודה והשומרון,3660,עמנואל,47,23,24,4,43,21,46,1,4%
2018-05,אזור יהודה והשומרון,3557,קדומים,28,13,15,15,13,1,27,0,1%
2018-05,אזור יהודה והשומרון,3611,קריית ארבע,75,42,33,11,64,31,73,6,2%
2018-05,אזור יהודה והשומרון,3640,קרני שומרון,68,29,39,26,42,2,65,3,2%
2018-05,הדרום,31,אופקים,741,335,406,46,695,329,716,39,6%
2018-05,הדרום,2600,אילת,820,422,398,41,779,202,774,52,2%
2018-05,הדרום,70,אשדוד,4699,2100,2599,630,4069,1844,4496,141,4%
2018-05,הדרום,7100,אשקלון,3350,1468,1882,372,2978,1295,3071,66,5%
2018-05,הדרום,9000,באר שבע,5240,2461,2779,726,4514,2452,4932,119,5%
2018-05,הדרום,2200,דימונה,1526,754,772,76,1450,964,1446,29,8%
2018-05,הדרום,1303,חורה,455,187,268,2,453,390,438,4,12%
2018-05,הדרום,831,ירוחם,354,190,164,11,343,190,328,27,7%
2018-05,הדרום,1059,כסיפה,972,360,612,2,970,858,960,19,21%
2018-05,הדרום,1271,להבים,45,25,20,22,23,0,45,0,1%
2018-05,הדרום,1060,לקיה,547,233,314,6,541,473,522,5,14%
2018-05,הדרום,1268,מיתר,61,29,32,34,27,4,61,1,1%
2018-05,הדרום,99,מצפה רמון,225,96,129,13,212,153,212,15,9%
2018-05,הדרום,246,נתיבות,876,396,480,66,810,356,817,54,6%
2018-05,הדרום,666,עומר,36,18,18,13,23,2,36,1,1%
2018-05,הדרום,2560,ערד,629,301,328,54,575,291,595,42,5%
2018-05,הדרום,1192,ערערה-בנגב,979,426,553,6,973,872,954,14,23%
2018-05,הדרום,2630,קריית גת,1708,726,982,125,1583,606,1629,53,6%
2018-05,הדרום,1034,קריית מלאכי,742,350,392,24,718,280,707,45,6%
2018-05,הדרום,1161,רהט,1936,781,1155,8,1928,1415,1913,53,11%
2018-05,הדרום,1286,שגב-שלום,322,127,195,3,319,252,310,8,13%
2018-05,הדרום,1031,שדרות,879,404,475,61,818,423,788,32,6%
2018-05,הדרום,1054,תל שבע,692,314,378,4,688,581,639,7,15%
2018-05,המרכז,182,אבן יהודה,130,59,71,54,76,13,129,1,2%
2018-05,המרכז,41,אליכין,55,30,25,14,41,9,54,1,3%
2018-05,המרכז,1309,אלעד,311,141,170,20,291,25,296,3,2%
2018-05,המרכז,2530,באר יעקב,306,125,181,67,239,29,297,3,3%
2018-05,המרכז,466,בית דגן,97,54,43,14,83,20,93,3,3%
2018-05,המרכז,1066,"בני עי""ש",118,56,62,13,105,33,114,3,3%
2018-05,המרכז,681,גבעת שמואל,230,118,112,88,142,25,226,2,2%
2018-05,המרכז,2550,גדרה,286,136,150,66,220,54,281,12,2%
2018-05,המרכז,627,ג'לג'וליה,70,26,44,3,67,35,60,1,2%
2018-05,המרכז,166,גן יבנה,294,122,172,49,245,56,288,3,3%
2018-05,המרכז,229,גני תקווה,205,89,116,73,132,22,205,1,2%
2018-05,המרכז,9700,הוד השרון,676,282,394,328,348,24,670,12,2%
2018-05,המרכז,1290,זמר,127,42,85,3,124,74,121,5,4%
2018-05,המרכז,2730,טייבה,862,417,445,26,836,541,722,23,4%
2018-05,המרכז,2720,טירה,134,69,65,21,113,26,128,13,1%
2018-05,המרכז,2660,יבנה,691,318,373,135,556,140,678,36,3%
2018-05,המרכז,9400,יהוד,364,164,200,102,262,37,356,10,2%
2018-05,המרכז,1224,כוכב יאיר,81,29,52,57,24,0,80,0,1%
2018-05,המרכז,633,כפר ברא,12,6,6,2,10,4,12,0,1%
2018-05,המרכז,168,כפר יונה,281,123,158,62,219,40,278,2,3%
2018-05,המרכז,6900,כפר סבא,1138,487,651,466,672,67,1124,16,2%
2018-05,המרכז,634,כפר קאסם,169,82,87,5,164,81,165,4,2%
2018-05,המרכז,7000,לוד,1506,750,756,135,1371,692,1472,27,4%
2018-05,המרכז,1200,מודיעין-מכבים-רעות*,833,347,486,419,414,28,824,15,2%
2018-05,המרכז,28,מזכרת בתיה,167,77,90,55,112,21,164,6,2%
2018-05,המרכז,7200,נס ציונה,570,255,315,168,402,122,560,12,2%
2018-05,המרכז,7400,נתניה,3734,1765,1969,538,3196,953,3645,62,4%
2018-05,המרכז,587,סביון*,19,5,14,10,9,0,19,0,1%
2018-05,המרכז,171,פרדסייה,81,40,41,20,61,3,80,1,2%
2018-05,המרכז,7900,פתח תקווה,3505,1631,1874,739,2766,702,3423,56,3%
2018-05,המרכז,195,קדימה-צורן,254,110,144,96,158,24,251,4,2%
2018-05,המרכז,638,קלנסווה,297,148,149,11,286,179,256,9,3%
2018-05,המרכז,469,קריית עקרון,213,110,103,24,189,86,209,5,4%
2018-05,המרכז,2640,ראש העין,778,347,431,180,598,82,768,17,3%
2018-05,המרכז,8300,ראשון לציון,3784,1710,2074,812,2972,786,3737,41,3%
2018-05,המרכז,8400,רחובות,2099,966,1133,565,1534,538,2031,65,3%
2018-05,המרכז,8500,רמלה,1343,659,684,97,1246,445,1279,44,4%
2018-05,המרכז,8700,רעננה,679,306,373,335,344,27,674,9,2%
2018-05,המרכז,1304,שוהם,174,80,94,90,84,5,173,1,2%
2018-05,המרכז,154,תל מונד,136,68,68,47,89,17,136,0,2%
2018-05,הצפון,473,אבו סנאן,508,215,293,7,501,358,498,8,9%
2018-05,הצפון,478,אכסאל,393,184,209,10,383,315,390,6,7%
2018-05,הצפון,529,אעבלין,352,156,196,12,340,263,346,5,6%
2018-05,הצפון,482,בועיינה-נוג'ידאת,208,103,105,6,202,154,203,3,6%
2018-05,הצפון,4001,בוקעאתא,324,115,209,8,316,246,317,3,12%
2018-05,הצפון,998,ביר אל-מכסור,252,122,130,4,248,169,249,1,7%
2018-05,הצפון,480,בית ג'ן,369,96,273,10,359,238,357,3,7%
2018-05,הצפון,9200,בית שאן,600,299,301,22,578,260,576,25,6%
2018-05,הצפון,944,בסמת טבעון,149,71,78,2,147,92,136,1,4%
2018-05,הצפון,483,בענה,315,139,176,7,308,258,297,3,9%
2018-05,הצפון,1292,ג'דיידה-מכר,980,446,534,6,974,712,967,15,11%
2018-05,הצפון,485,ג'ולס,142,41,101,0,142,74,142,3,5%
2018-05,הצפון,487,ג'ש (גוש חלב),47,18,29,8,39,19,44,0,3%
2018-05,הצפון,489,דבורייה,242,104,138,15,227,164,234,3,6%
2018-05,הצפון,490,דייר אל-אסד,324,146,178,14,310,234,313,3,6%
2018-05,הצפון,492,דייר חנא,478,216,262,9,469,341,476,8,10%
2018-05,הצפון,975,זרזיר,173,67,106,5,168,111,171,5,6%
2018-05,הצפון,496,חורפיש,109,49,60,9,100,50,97,2,4%
2018-05,הצפון,2034,חצור הגלילית,217,89,128,16,201,91,202,7,4%
2018-05,הצפון,6700,טבריה,1261,611,650,81,1180,544,1110,77,5%
2018-05,הצפון,962,טובא-זנגרייה,298,118,180,4,294,159,290,6,10%
2018-05,הצפון,498,טורעאן,284,129,155,12,272,210,277,5,5%
2018-05,הצפון,8900,טמרה,1133,544,589,16,1117,887,1109,9,8%
2018-05,הצפון,1295,יאנוח-ג'ת,121,36,85,2,119,64,112,5,4%
2018-05,הצפון,46,יבנאל,70,42,28,9,61,30,58,2,4%
2018-05,הצפון,499,יפיע,434,196,238,22,412,315,431,8,6%
2018-05,הצפון,240,יקנעם עילית,404,188,216,104,300,83,396,25,3%
2018-05,הצפון,502,ירכא,328,137,191,1,327,224,327,1,6%
2018-05,הצפון,504,כאבול,365,196,169,9,356,288,358,7,8%
2018-05,הצפון,505,כאוכב אבו אל-היג'א,165,66,99,3,162,137,165,1,10%
2018-05,הצפון,1296,כסרא-סמיע,170,59,111,1,169,110,158,8,5%
2018-05,הצפון,978,כעביה-טבאש-חג'אג'רה,136,48,88,4,132,92,133,5,6%
2018-05,הצפון,1263,כפר ורדים,54,21,33,27,27,6,51,1,2%
2018-05,הצפון,507,כפר יאסיף,345,155,190,4,341,232,336,5,7%
2018-05,הצפון,508,כפר כמא,30,14,16,4,26,13,28,0,2%
2018-05,הצפון,509,כפר כנא,641,327,314,24,617,486,621,17,7%
2018-05,הצפון,510,כפר מנדא,570,310,260,10,560,408,564,5,8%
2018-05,הצפון,47,כפר תבור,40,17,23,16,24,3,40,1,2%
2018-05,הצפון,1139,כרמיאל,1309,567,742,262,1047,610,1200,33,5%
2018-05,הצפון,481,מגאר,933,388,545,15,918,673,912,6,10%
2018-05,הצפון,516,מג'ד אל-כרום,415,194,221,13,402,280,405,8,6%
2018-05,הצפון,874,מגדל העמק,729,354,375,73,656,213,673,54,5%
2018-05,הצפון,4201,מג'דל שמס,364,130,234,11,353,249,346,3,7%
2018-05,הצפון,517,מזרעה,114,49,65,1,113,83,107,1,6%
2018-05,הצפון,4203,מסעדה,183,73,110,8,175,119,175,1,11%
2018-05,הצפון,518,מעיליא,56,27,29,7,49,21,53,1,3%
2018-05,הצפון,1063,מעלות-תרשיחא,637,305,332,69,568,305,595,37,5%
2018-05,הצפון,520,משהד,151,63,88,3,148,107,146,3,5%
2018-05,הצפון,9100,נהרייה,1574,760,814,172,1402,739,1472,64,5%
2018-05,הצפון,522,נחף,328,140,188,6,322,241,319,3,7%
2018-05,הצפון,7300,נצרת,2375,1101,1274,102,2273,1686,2346,30,7%
2018-05,הצפון,1061,נצרת עילית,1260,616,644,127,1133,507,1118,94,5%
2018-05,הצפון,525,סאג'ור,114,46,68,5,109,62,112,0,6%
2018-05,הצפון,7500,סח'נין,1507,688,819,27,1480,1162,1487,16,11%
2018-05,הצפון,4501,ע'ג'ר,70,31,39,2,68,42,69,0,7%
2018-05,הצפון,530,עיילבון,127,53,74,5,122,74,122,3,5%
2018-05,הצפון,511,עילוט,234,98,136,4,230,178,233,2,9%
2018-05,הצפון,532,עין מאהל,310,175,135,5,305,216,300,4,6%
2018-05,הצפון,7600,עכו,2439,1097,1342,132,2307,1653,2328,39,9%
2018-05,הצפון,7700,עפולה,1411,598,813,163,1248,464,1331,73,5%
2018-05,הצפון,531,עראבה,1050,444,606,24,1026,872,1038,9,11%
2018-05,הצפון,535,פסוטה,84,42,42,8,76,39,81,1,5%
2018-05,הצפון,536,פקיעין (בוקייעה),102,54,48,4,98,61,96,1,4%
2018-05,הצפון,8000,צפת,840,448,392,79,761,492,796,30,6%
2018-05,הצפון,4100,קצרין,155,72,83,31,124,63,148,6,4%
2018-05,הצפון,2800,קריית שמונה,634,304,330,66,568,231,607,32,5%
2018-05,הצפון,543,ראמה,216,90,126,13,203,142,207,0,5%
2018-05,הצפון,26,ראש פינה,41,14,27,7,34,16,40,2,3%
2018-05,הצפון,542,ריינה,421,204,217,13,408,296,405,6,6%
2018-05,הצפון,122,רמת ישי,82,27,55,28,54,17,79,2,2%
2018-05,הצפון,913,שבלי - אום אל-גנם,142,54,88,5,137,85,137,3,6%
2018-05,הצפון,812,שלומי,194,81,113,16,178,84,188,3,5%
2018-05,הצפון,538,שעב,349,158,191,3,346,280,347,1,12%
2018-05,הצפון,8800,שפרעם,1147,519,628,29,1118,819,1125,17,7%
2018-05,חיפה,2710,אום אל-פחם,2236,952,1284,25,2211,1768,2187,39,11%
2018-05,חיפה,1020,אור עקיבא,422,201,221,47,375,92,406,12,4%
2018-05,חיפה,6000,באקה אל-גרביה,541,275,266,18,523,299,527,21,5%
2018-05,חיפה,9800,בנימינה-גבעת עדה*,154,71,83,65,89,18,152,1,2%
2018-05,חיפה,1326,"בסמ""ה",282,130,152,5,277,219,278,3,7%
2018-05,חיפה,541,ג'סר א-זרקא,216,102,114,1,215,62,208,6,4%
2018-05,חיפה,628,ג'ת,183,84,99,7,176,94,182,8,4%
2018-05,חיפה,494,דאלית אל-כרמל,394,153,241,17,377,191,370,8,5%
2018-05,חיפה,9300,זכרון יעקב,202,82,120,86,116,12,199,2,2%
2018-05,חיפה,6500,חדרה,1990,903,1087,279,1711,535,1881,50,4%
2018-05,חיפה,4000,חיפה,4897,2362,2535,1077,3820,2048,4600,141,3%
2018-05,חיפה,1247,חריש,262,90,172,72,190,28,256,2,15%
2018-05,חיפה,2100,טירת כרמל,616,310,306,36,580,300,586,17,6%
2018-05,חיפה,654,כפר קרע,347,146,201,20,327,184,342,9,4%
2018-05,חיפה,1327,מעלה עירון,591,249,342,7,584,435,577,8,10%
2018-05,חיפה,2500,נשר,334,165,169,65,269,111,315,6,3%
2018-05,חיפה,534,עספיא,309,131,178,18,291,139,287,2,5%
2018-05,חיפה,637,ערערה,486,215,271,14,472,282,472,15,6%
2018-05,חיפה,537,פוריידיס,185,113,72,8,177,43,183,0,3%
2018-05,חיפה,7800,פרדס חנה-כרכור,694,282,412,208,486,87,679,13,3%
2018-05,חיפה,6800,קריית אתא,1209,554,655,121,1088,499,1170,25,4%
2018-05,חיפה,9500,קריית ביאליק,831,363,468,111,720,287,804,31,4%
2018-05,חיפה,2300,קריית טבעון,165,82,83,68,97,17,163,1,2%
2018-05,חיפה,9600,קריית ים,1054,532,522,89,965,520,1015,27,5%
2018-05,חיפה,8200,קריית מוצקין,783,346,437,150,633,261,761,19,3%
2018-05,חיפה,922,רכסים,123,54,69,7,116,48,114,2,3%
2018-05,ירושלים,472,אבו גוש,191,90,101,4,187,149,187,5,6%
2018-05,ירושלים,2610,בית שמש,1065,500,565,75,990,294,1024,52,3%
2018-05,ירושלים,3000,ירושלים,10330,4767,5563,1273,9057,5836,10049,155,3%
2018-05,ירושלים,1015,מבשרת ציון,265,136,129,57,208,79,263,5,2%
2018-05,ירושלים,1137,קריית יערים,44,20,24,8,36,8,44,0,3%
2018-05,תל אביב,2400,אור יהודה,613,313,300,58,555,121,576,36,3%
2018-05,תל אביב,565,אזור,157,74,83,30,127,14,152,7,2%
2018-05,תל אביב,6100,בני ברק,1495,747,748,88,1407,506,1391,17,3%
2018-05,תל אביב,6200,בת ים,2489,1232,1257,368,2121,755,2355,81,3%
2018-05,תל אביב,6300,גבעתיים,708,311,397,355,353,64,704,6,2%
2018-05,תל אביב,6400,הרצלייה,995,489,506,363,632,38,977,13,2%
2018-05,תל אביב,6600,חולון,2784,1265,1519,466,2318,473,2710,44,3%
2018-05,תל אביב,2620,קריית אונו,399,175,224,188,211,30,394,4,2%
2018-05,תל אביב,8600,רמת גן,1937,872,1065,721,1216,249,1901,19,2%
2018-05,תל אביב,2650,רמת השרון,364,168,196,189,175,13,361,2,2%
2018-05,תל אביב,5000,תל אביב -יפו,6809,3363,3446,2834,3975,1223,6649,86,3%
2018-06,אזור יהודה והשומרון,3760,אורנית,100,42,58,39,61,0,100,0,2%
2018-06,אזור יהודה והשומרון,3750,אלפי מנשה,80,32,48,30,50,0,80,0,2%
2018-06,אזור יהודה והשומרון,3560,אלקנה,26,17,9,12,14,1,26,0,1%
2018-06,אזור יהודה והשומרון,3650,אפרת,138,74,64,56,82,4,138,0,3%
2018-06,אזור יהודה והשומרון,3570,אריאל,225,97,128,59,166,12,223,9,2%
2018-06,אזור יהודה והשומרון,3574,בית אל,41,19,22,10,31,10,40,0,2%
2018-06,אזור יהודה והשומרון,3652,בית אריה,45,19,26,7,38,1,45,2,2%
2018-06,אזור יהודה והשומרון,3780,ביתר עילית,391,174,217,17,374,127,384,8,3%
2018-06,אזור יהודה והשומרון,3730,גבעת זאב,167,73,94,30,137,27,165,6,2%
2018-06,אזור יהודה והשומרון,3769,הר אדר,34,17,17,16,18,4,34,0,2%
2018-06,אזור יהודה והשומרון,3797,מודיעין עילית,388,122,266,24,364,32,385,1,3%
2018-06,אזור יהודה והשומרון,3616,מעלה אדומים,485,234,251,68,417,110,479,15,2%
2018-06,אזור יהודה והשומרון,3660,עמנואל,35,17,18,3,32,18,35,0,3%
2018-06,אזור יהודה והשומרון,3557,קדומים,26,15,11,12,14,0,26,2,1%
2018-06,אזור יהודה והשומרון,3611,קריית ארבע,85,49,36,13,72,31,82,7,3%
2018-06,אזור יהודה והשומרון,3640,קרני שומרון,71,32,39,23,48,3,67,1,2%
2018-06,הדרום,31,אופקים,787,339,448,50,737,339,763,42,6%
2018-06,הדרום,2600,אילת,836,421,415,43,793,199,787,47,2%
2018-06,הדרום,70,אשדוד,4743,2077,2666,615,4128,1819,4545,119,4%
2018-06,הדרום,7100,אשקלון,3289,1449,1840,375,2914,1248,3011,56,4%
2018-06,הדרום,9000,באר שבע,5112,2395,2717,706,4406,2412,4810,109,5%
2018-06,הדרום,2200,דימונה,1518,737,781,69,1449,926,1444,29,8%
2018-06,הדרום,1303,חורה,439,181,258,1,438,378,418,0,11%
2018-06,הדרום,831,ירוחם,365,199,166,9,356,188,337,23,8%
2018-06,הדרום,1059,כסיפה,951,355,596,1,950,845,941,3,21%
2018-06,הדרום,1271,להבים,43,25,18,23,20,0,43,1,1%
2018-06,הדרום,1060,לקיה,541,230,311,5,536,460,517,2,14%
2018-06,הדרום,1268,מיתר,57,29,28,28,29,5,55,2,1%
2018-06,הדרום,99,מצפה רמון,206,84,122,12,194,140,194,15,8%
2018-06,הדרום,246,נתיבות,921,424,497,67,854,339,868,55,6%
2018-06,הדרום,666,עומר,44,24,20,20,24,3,44,0,1%
2018-06,הדרום,2560,ערד,649,302,347,61,588,281,615,48,5%
2018-06,הדרום,1192,ערערה-בנגב,953,419,534,5,948,849,932,5,23%
2018-06,הדרום,2630,קריית גת,1648,706,942,123,1525,609,1577,52,6%
2018-06,הדרום,1034,קריית מלאכי,756,338,418,25,731,309,725,37,6%
2018-06,הדרום,1161,רהט,1949,759,1190,11,1938,1377,1932,27,11%
2018-06,הדרום,1286,שגב-שלום,329,130,199,2,327,251,316,2,13%
2018-06,הדרום,1031,שדרות,902,419,483,67,835,416,816,44,7%
2018-06,הדרום,1054,תל שבע,669,302,367,5,664,570,612,4,14%
2018-06,המרכז,182,אבן יהודה,131,57,74,57,74,13,131,1,2%
2018-06,המרכז,41,אליכין,58,33,25,15,43,12,56,2,3%
2018-06,המרכז,1309,אלעד,313,136,177,18,295,25,300,2,2%
2018-06,המרכז,2530,באר יעקב,311,121,190,75,236,27,305,2,3%
2018-06,המרכז,466,בית דגן,104,50,54,18,86,28,99,0,3%
2018-06,המרכז,1066,"בני עי""ש",109,52,57,15,94,31,105,2,3%
2018-06,המרכז,681,גבעת שמואל,240,125,115,93,147,25,235,1,2%
2018-06,המרכז,2550,גדרה,276,120,156,60,216,54,267,12,2%
2018-06,המרכז,627,ג'לג'וליה,63,27,36,3,60,32,58,2,2%
2018-06,המרכז,166,גן יבנה,286,119,167,48,238,55,278,3,2%
2018-06,המרכז,229,גני תקווה,187,80,107,69,118,21,187,0,2%
2018-06,המרכז,9700,הוד השרון,651,264,387,321,330,17,645,10,2%
2018-06,המרכז,1290,זמר,121,41,80,3,118,71,118,4,4%
2018-06,המרכז,2730,טייבה,829,395,434,22,807,534,693,27,4%
2018-06,המרכז,2720,טירה,125,69,56,20,105,22,122,9,1%
2018-06,המרכז,2660,יבנה,661,309,352,135,526,138,650,28,3%
2018-06,המרכז,9400,יהוד,344,153,191,90,254,36,338,8,2%
2018-06,המרכז,1224,כוכב יאיר,83,29,54,59,24,0,83,0,1%
2018-06,המרכז,633,כפר ברא,10,6,4,1,9,4,10,1,1%
2018-06,המרכז,168,כפר יונה,278,131,147,58,220,41,277,4,3%
2018-06,המרכז,6900,כפר סבא,1113,469,644,452,661,63,1102,26,2%
2018-06,המרכז,634,כפר קאסם,163,77,86,4,159,83,160,3,2%
2018-06,המרכז,7000,לוד,1499,721,778,137,1362,661,1463,36,4%
2018-06,המרכז,1200,מודיעין-מכבים-רעות*,799,342,457,409,390,29,792,11,2%
2018-06,המרכז,28,מזכרת בתיה,161,75,86,61,100,18,161,6,2%
2018-06,המרכז,7200,נס ציונה,580,271,309,171,409,115,572,7,2%
2018-06,המרכז,7400,נתניה,3720,1768,1952,532,3188,933,3626,79,3%
2018-06,המרכז,587,סביון*,19,5,14,7,12,1,18,0,1%
2018-06,המרכז,171,פרדסייה,84,40,44,26,58,2,83,0,2%
2018-06,המרכז,7900,פתח תקווה,3471,1615,1856,735,2736,684,3384,33,3%
2018-06,המרכז,195,קדימה-צורן,248,108,140,96,152,21,246,6,2%
2018-06,המרכז,638,קלנסווה,295,140,155,5,290,188,254,10,3%
2018-06,המרכז,469,קריית עקרון,219,112,107,21,198,88,207,5,4%
2018-06,המרכז,2640,ראש העין,749,328,421,160,589,88,740,9,3%
2018-06,המרכז,8300,ראשון לציון,3739,1695,2044,820,2919,732,3692,37,3%
2018-06,המרכז,8400,רחובות,2072,938,1134,545,1527,534,2015,53,3%
2018-06,המרכז,8500,רמלה,1376,691,685,94,1282,434,1319,49,4%
2018-06,המרכז,8700,רעננה,666,300,366,336,330,25,661,11,2%
2018-06,המרכז,1304,שוהם,163,74,89,90,73,6,162,0,1%
2018-06,המרכז,154,תל מונד,114,58,56,37,77,17,114,1,2%
2018-06,הצפון,473,אבו סנאן,499,219,280,6,493,346,488,3,9%
2018-06,הצפון,478,אכסאל,385,180,205,11,374,305,385,2,7%
2018-06,הצפון,529,אעבלין,368,172,196,11,357,258,363,4,7%
2018-06,הצפון,482,בועיינה-נוג'ידאת,193,97,96,6,187,145,190,4,5%
2018-06,הצפון,4001,בוקעאתא,296,112,184,7,289,224,291,3,11%
2018-06,הצפון,998,ביר אל-מכסור,248,118,130,4,244,169,245,2,7%
2018-06,הצפון,480,בית ג'ן,349,92,257,14,335,228,339,1,7%
2018-06,הצפון,9200,בית שאן,603,298,305,23,580,254,575,33,6%
2018-06,הצפון,944,בסמת טבעון,146,68,78,2,144,91,133,2,4%
2018-06,הצפון,483,בענה,289,132,157,6,283,231,277,4,9%
2018-06,הצפון,1292,ג'דיידה-מכר,957,435,522,6,951,694,944,15,11%
2018-06,הצפון,485,ג'ולס,143,37,106,0,143,81,142,3,5%
2018-06,הצפון,487,ג'ש (גוש חלב),45,19,26,5,40,17,43,0,3%
2018-06,הצפון,489,דבורייה,212,85,127,12,200,156,206,0,5%
2018-06,הצפון,490,דייר אל-אסד,319,145,174,14,305,233,310,3,6%
2018-06,הצפון,492,דייר חנא,459,208,251,10,449,321,457,7,10%
2018-06,הצפון,975,זרזיר,167,63,104,6,161,98,164,6,6%
2018-06,הצפון,496,חורפיש,110,53,57,11,99,45,102,3,4%
2018-06,הצפון,2034,חצור הגלילית,193,80,113,13,180,84,180,4,4%
2018-06,הצפון,6700,טבריה,1200,573,627,81,1119,513,1071,58,5%
2018-06,הצפון,962,טובא-זנגרייה,289,113,176,3,286,151,283,3,10%
2018-06,הצפון,498,טורעאן,273,122,151,8,265,206,267,8,5%
2018-06,הצפון,8900,טמרה,1093,531,562,19,1074,851,1078,4,8%
2018-06,הצפון,1295,יאנוח-ג'ת,109,31,78,2,107,62,104,4,4%
2018-06,הצפון,46,יבנאל,69,45,24,10,59,33,59,1,4%
2018-06,הצפון,499,יפיע,429,199,230,24,405,312,428,1,6%
2018-06,הצפון,240,יקנעם עילית,400,184,216,106,294,76,389,25,3%
2018-06,הצפון,502,ירכא,326,130,196,2,324,220,323,3,6%
2018-06,הצפון,504,כאבול,358,193,165,9,349,279,347,5,8%
2018-06,הצפון,505,כאוכב אבו אל-היג'א,168,66,102,5,163,138,167,1,10%
2018-06,הצפון,1296,כסרא-סמיע,153,47,106,1,152,93,141,8,4%
2018-06,הצפון,978,כעביה-טבאש-חג'אג'רה,116,35,81,2,114,82,114,1,5%
2018-06,הצפון,1263,כפר ורדים,56,21,35,29,27,5,55,1,2%
2018-06,הצפון,507,כפר יאסיף,327,144,183,5,322,221,317,1,6%
2018-06,הצפון,508,כפר כמא,25,12,13,4,21,11,24,0,2%
2018-06,הצפון,509,כפר כנא,622,319,303,24,598,470,606,6,7%
2018-06,הצפון,510,כפר מנדא,554,303,251,10,544,391,552,6,8%
2018-06,הצפון,47,כפר תבור,42,20,22,18,24,4,39,1,2%
2018-06,הצפון,1139,כרמיאל,1290,533,757,266,1024,588,1185,34,5%
2018-06,הצפון,481,מגאר,924,379,545,16,908,670,901,10,10%
2018-06,הצפון,516,מג'ד אל-כרום,411,202,209,11,400,269,404,6,6%
2018-06,הצפון,874,מגדל העמק,769,365,404,77,692,226,725,49,6%
2018-06,הצפון,4201,מג'דל שמס,346,121,225,9,337,243,328,3,7%
2018-06,הצפון,517,מזרעה,112,51,61,1,111,77,108,2,6%
2018-06,הצפון,4203,מסעדה,172,69,103,5,167,120,164,2,10%
2018-06,הצפון,518,מעיליא,49,25,24,4,45,18,48,2,3%
2018-06,הצפון,1063,מעלות-תרשיחא,635,315,320,75,560,299,600,28,5%
2018-06,הצפון,520,משהד,144,65,79,1,143,107,138,0,5%
2018-06,הצפון,9100,נהרייה,1537,744,793,178,1359,728,1452,49,5%
2018-06,הצפון,522,נחף,328,138,190,9,319,240,323,8,7%
2018-06,הצפון,7300,נצרת,2299,1062,1237,101,2198,1638,2281,18,7%
2018-06,הצפון,1061,נצרת עילית,1186,591,595,113,1073,470,1069,96,5%
2018-06,הצפון,525,סאג'ור,105,39,66,3,102,60,102,1,6%
2018-06,הצפון,7500,סח'נין,1445,659,786,24,1421,1138,1427,15,11%
2018-06,הצפון,4501,ע'ג'ר,66,25,41,0,66,38,65,1,6%
2018-06,הצפון,530,עיילבון,126,55,71,6,120,72,122,1,5%
2018-06,הצפון,511,עילוט,228,92,136,4,224,181,228,0,8%
2018-06,הצפון,532,עין מאהל,288,161,127,5,283,217,278,1,6%
2018-06,הצפון,7600,עכו,2395,1074,1321,135,2260,1631,2298,29,9%
2018-06,הצפון,7700,עפולה,1342,565,777,147,1195,427,1280,70,5%
2018-06,הצפון,531,עראבה,1016,430,586,23,993,843,1008,3,11%
2018-06,הצפון,535,פסוטה,86,39,47,11,75,40,79,1,5%
2018-06,הצפון,536,פקיעין (בוקייעה),96,54,42,5,91,58,94,4,3%
2018-06,הצפון,8000,צפת,843,450,393,81,762,507,799,18,6%
2018-06,הצפון,4100,קצרין,150,72,78,31,119,59,143,5,4%
2018-06,הצפון,2800,קריית שמונה,606,303,303,59,547,222,581,22,5%
2018-06,הצפון,543,ראמה,214,94,120,12,202,148,208,2,5%
2018-06,הצפון,26,ראש פינה,39,12,27,5,34,16,38,1,2%
2018-06,הצפון,542,ריינה,400,204,196,12,388,280,391,7,6%
2018-06,הצפון,122,רמת ישי,81,28,53,29,52,15,80,0,2%
2018-06,הצפון,913,שבלי - אום אל-גנם,146,55,91,5,141,86,143,4,6%
2018-06,הצפון,812,שלומי,190,79,111,17,173,85,181,8,5%
2018-06,הצפון,538,שעב,346,155,191,4,342,279,345,3,12%
2018-06,הצפון,8800,שפרעם,1131,509,622,36,1095,807,1104,18,7%
2018-06,חיפה,2710,אום אל-פחם,2210,953,1257,23,2187,1770,2158,27,11%
2018-06,חיפה,1020,אור עקיבא,415,182,233,47,368,91,398,13,4%
2018-06,חיפה,6000,באקה אל-גרביה,514,251,263,16,498,288,502,18,4%
2018-06,חיפה,9800,בנימינה-גבעת עדה*,134,62,72,64,70,15,133,0,2%
2018-06,חיפה,1326,"בסמ""ה",279,132,147,3,276,213,273,1,7%
2018-06,חיפה,541,ג'סר א-זרקא,214,102,112,1,213,67,209,6,4%
2018-06,חיפה,628,ג'ת,164,79,85,5,159,87,164,2,3%
2018-06,חיפה,494,דאלית אל-כרמל,380,141,239,15,365,190,358,7,5%
2018-06,חיפה,9300,זכרון יעקב,203,90,113,78,125,17,199,3,2%
2018-06,חיפה,6500,חדרה,1886,838,1048,267,1619,512,1786,41,4%
2018-06,חיפה,4000,חיפה,4806,2347,2459,1060,3746,2029,4506,134,3%
2018-06,חיפה,1247,חריש,252,98,154,58,194,36,244,1,14%
2018-06,חיפה,2100,טירת כרמל,612,312,300,45,567,302,578,17,5%
2018-06,חיפה,654,כפר קרע,345,146,199,19,326,180,338,6,4%
2018-06,חיפה,1327,מעלה עירון,573,248,325,7,566,426,560,4,10%
2018-06,חיפה,2500,נשר,345,165,180,73,272,109,324,12,3%
2018-06,חיפה,534,עספיא,316,129,187,18,298,141,294,6,5%
2018-06,חיפה,637,ערערה,465,213,252,18,447,268,454,16,6%
2018-06,חיפה,537,פוריידיס,170,98,72,9,161,38,168,8,3%
2018-06,חיפה,7800,פרדס חנה-כרכור,678,280,398,204,474,63,666,17,3%
2018-06,חיפה,6800,קריית אתא,1183,551,632,124,1059,492,1138,26,4%
2018-06,חיפה,9500,קריית ביאליק,820,367,453,119,701,276,804,29,4%
2018-06,חיפה,2300,קריית טבעון,173,80,93,68,105,18,171,0,2%
2018-06,חיפה,9600,קריית ים,1070,539,531,87,983,509,1022,37,5%
2018-06,חיפה,8200,קריית מוצקין,777,329,448,146,631,232,753,19,3%
2018-06,חיפה,922,רכסים,135,58,77,9,126,50,125,0,4%
2018-06,ירושלים,472,אבו גוש,191,87,104,6,185,149,187,1,6%
2018-06,ירושלים,2610,בית שמש,1064,487,577,79,985,301,1015,39,3%
2018-06,ירושלים,3000,ירושלים,10202,4699,5503,1312,8890,5726,9915,138,3%
2018-06,ירושלים,1015,מבשרת ציון,275,146,129,63,212,72,272,4,2%
2018-06,ירושלים,1137,קריית יערים,43,17,26,11,32,8,43,0,3%
2018-06,תל אביב,2400,אור יהודה,591,299,292,65,526,113,566,19,3%
2018-06,תל אביב,565,אזור,155,75,80,34,121,20,151,3,2%
2018-06,תל אביב,6100,בני ברק,1495,737,758,88,1407,503,1390,19,3%
2018-06,תל אביב,6200,בת ים,2368,1170,1198,335,2033,702,2248,89,3%
2018-06,תל אביב,6300,גבעתיים,695,308,387,341,354,65,689,4,2%
2018-06,תל אביב,6400,הרצלייה,987,472,515,382,605,36,973,20,2%
2018-06,תל אביב,6600,חולון,2731,1241,1490,453,2278,458,2646,58,3%
2018-06,תל אביב,2620,קריית אונו,371,171,200,170,201,36,361,4,2%
2018-06,תל אביב,8600,רמת גן,1878,842,1036,711,1167,239,1847,21,2%
2018-06,תל אביב,2650,רמת השרון,368,167,201,186,182,10,365,2,2%
2018-06,תל אביב,5000,תל אביב -יפו,6753,3393,3360,2900,3853,1169,6615,68,3%
2018-07,אזור יהודה והשומרון,3760,אורנית,97,41,56,37,60,0,97,0,2.07%
2018-07,אזור יהודה והשומרון,3750,אלפי מנשה,89,36,53,30,59,1,89,2,2.09%
2018-07,אזור יהודה והשומרון,3560,אלקנה,35,20,15,19,16,1,35,0,1.84%
2018-07,אזור יהודה והשומרון,3650,אפרת,148,74,74,68,80,4,146,0,3.50%
2018-07,אזור יהודה והשומרון,3570,אריאל,257,106,151,75,182,13,254,13,2.44%
2018-07,אזור יהודה והשומרון,3574,בית אל,43,17,26,11,32,8,43,0,1.76%
2018-07,אזור יהודה והשומרון,3652,בית אריה,47,18,29,9,38,1,47,0,1.85%
2018-07,אזור יהודה והשומרון,3780,ביתר עילית,857,235,622,24,833,157,844,6,6.75%
2018-07,אזור יהודה והשומרון,3730,גבעת זאב,198,89,109,40,158,28,196,0,2.60%
2018-07,אזור יהודה והשומרון,3769,הר אדר,31,19,12,14,17,4,30,0,1.46%
2018-07,אזור יהודה והשומרון,3797,מודיעין עילית,858,146,712,34,824,24,854,7,6.33%
2018-07,אזור יהודה והשומרון,3616,מעלה אדומים,558,233,325,79,479,112,554,9,2.74%
2018-07,אזור יהודה והשומרון,3660,עמנואל,78,27,51,7,71,17,78,1,6.87%
2018-07,אזור יהודה והשומרון,3557,קדומים,26,14,12,13,13,1,25,0,1.35%
2018-07,אזור יהודה והשומרון,3611,קריית ארבע,98,53,45,18,80,32,93,3,2.94%
2018-07,אזור יהודה והשומרון,3640,קרני שומרון,75,32,43,23,52,1,73,2,2.01%
2018-07,הדרום,31,אופקים,1060,352,708,57,1003,357,1025,39,8.13%
2018-07,הדרום,2600,אילת,931,468,463,53,878,219,877,48,2.67%
2018-07,הדרום,70,אשדוד,5393,2110,3283,685,4708,1814,5187,91,4.84%
2018-07,הדרום,7100,אשקלון,3556,1512,2044,403,3153,1283,3270,59,4.79%
2018-07,הדרום,9000,באר שבע,5494,2499,2995,782,4712,2420,5196,93,5.08%
2018-07,הדרום,2200,דימונה,1676,757,919,81,1595,934,1591,44,8.85%
2018-07,הדרום,1303,חורה,473,198,275,1,472,397,445,1,12.04%
2018-07,הדרום,831,ירוחם,414,212,202,10,404,196,383,21,8.47%
2018-07,הדרום,1059,כסיפה,968,369,599,1,967,843,958,7,20.84%
2018-07,הדרום,1271,להבים,58,34,24,30,28,0,58,0,1.66%
2018-07,הדרום,1060,לקיה,629,259,370,7,622,502,588,3,15.22%
2018-07,הדרום,1268,מיתר,57,27,30,26,31,2,56,0,1.32%
2018-07,הדרום,99,מצפה רמון,235,91,144,16,219,143,225,16,9.24%
2018-07,הדרום,246,נתיבות,1227,454,773,72,1155,345,1184,61,8.39%
2018-07,הדרום,666,עומר,57,25,32,19,38,3,57,2,1.41%
2018-07,הדרום,2560,ערד,690,302,388,73,617,275,657,37,5.40%
2018-07,הדרום,1192,ערערה-בנגב,1009,447,562,8,1001,895,981,7,23.71%
2018-07,הדרום,2630,קריית גת,1753,724,1029,125,1628,604,1676,39,5.99%
2018-07,הדרום,1034,קריית מלאכי,818,347,471,24,794,324,769,42,6.80%
2018-07,הדרום,1161,רהט,2183,867,1316,11,2172,1433,2150,51,11.96%
2018-07,הדרום,1286,שגב-שלום,353,135,218,3,350,243,347,3,14.03%
2018-07,הדרום,1031,שדרות,995,463,532,77,918,408,909,41,7.19%
2018-07,הדרום,1054,תל שבע,722,311,411,6,716,583,665,6,15.07%
2018-07,המרכז,182,אבן יהודה,145,65,80,56,89,14,143,1,2.13%
2018-07,המרכז,41,אליכין,64,34,30,15,49,15,61,0,3.25%
2018-07,המרכז,1309,אלעד,662,177,485,22,640,25,650,5,5.11%
2018-07,המרכז,2530,באר יעקב,357,136,221,84,273,28,351,5,3.83%
2018-07,המרכז,466,בית דגן,117,53,64,20,97,28,114,0,3.19%
2018-07,המרכז,1066,"בני עי""ש",134,62,72,20,114,33,131,5,3.35%
2018-07,המרכז,681,גבעת שמואל,258,132,126,99,159,28,254,1,2.13%
2018-07,המרכז,2550,גדרה,294,123,171,66,228,53,289,8,2.50%
2018-07,המרכז,627,ג'לג'וליה,65,33,32,4,61,28,64,1,1.78%
2018-07,המרכז,166,גן יבנה,317,126,191,63,254,54,309,5,2.72%
2018-07,המרכז,229,גני תקווה,200,82,118,69,131,23,197,0,2.37%
2018-07,המרכז,9700,הוד השרון,740,282,458,342,398,18,734,11,2.48%
2018-07,המרכז,1290,זמר,108,36,72,2,106,70,105,2,3.65%
2018-07,המרכז,2730,טייבה,916,411,505,25,891,547,776,29,4.68%
2018-07,המרכז,2720,טירה,158,85,73,18,140,22,150,6,1.34%
2018-07,המרכז,2660,יבנה,749,341,408,164,585,137,738,22,3.20%
2018-07,המרכז,9400,יהוד,389,164,225,101,288,40,384,3,2.43%
2018-07,המרכז,1224,כוכב יאיר,83,31,52,56,27,0,83,1,1.47%
2018-07,המרכז,633,כפר ברא,17,10,7,3,14,7,15,0,1.11%
2018-07,המרכז,168,כפר יונה,305,135,170,64,241,42,302,5,2.80%
2018-07,המרכז,6900,כפר סבא,1223,520,703,499,724,52,1216,19,2.30%
2018-07,המרכז,634,כפר קאסם,200,92,108,7,193,91,193,5,2.20%
2018-07,המרכז,7000,לוד,1629,752,877,147,1482,674,1584,41,4.57%
2018-07,המרכז,1200,מודיעין-מכבים-רעות*,886,364,522,434,452,28,878,15,2.04%
2018-07,המרכז,28,מזכרת בתיה,164,62,102,59,105,18,161,5,2.30%
2018-07,המרכז,7200,נס ציונה,623,281,342,178,445,106,614,14,2.63%
2018-07,המרכז,7400,נתניה,4071,1863,2208,574,3497,896,3990,81,3.83%
2018-07,המרכז,587,סביון*,23,6,17,9,14,1,22,0,1.13%
2018-07,המרכז,171,פרדסייה,92,41,51,25,67,2,91,0,2.51%
2018-07,המרכז,7900,פתח תקווה,3813,1663,2150,820,2993,693,3727,45,3.01%
2018-07,המרכז,195,קדימה-צורן,272,107,165,98,174,17,270,4,2.55%
2018-07,המרכז,638,קלנסווה,317,140,177,10,307,193,273,9,3.29%
2018-07,המרכז,469,קריית עקרון,235,112,123,21,214,79,229,7,3.93%
2018-07,המרכז,2640,ראש העין,872,366,506,187,685,90,866,4,3.73%
2018-07,המרכז,8300,ראשון לציון,3987,1743,2244,854,3133,744,3942,58,2.87%
2018-07,המרכז,8400,רחובות,2426,1001,1425,587,1839,544,2358,55,3.50%
2018-07,המרכז,8500,רמלה,1479,680,799,104,1375,437,1431,46,3.92%
2018-07,המרכז,8700,רעננה,702,321,381,347,355,27,697,9,1.88%
2018-07,המרכז,1304,שוהם,195,80,115,93,102,9,194,0,1.76%
2018-07,המרכז,154,תל מונד,117,50,67,40,77,11,117,1,1.91%
2018-07,הצפון,473,אבו סנאן,522,223,299,3,519,353,511,7,9.09%
2018-07,הצפון,478,אכסאל,389,183,206,9,380,303,388,1,7.04%
2018-07,הצפון,529,אעבלין,358,159,199,12,346,255,353,9,6.56%
2018-07,הצפון,482,בועיינה-נוג'ידאת,200,94,106,12,188,145,198,2,5.44%
2018-07,הצפון,4001,בוקעאתא,294,109,185,5,289,225,286,0,10.88%
2018-07,הצפון,998,ביר אל-מכסור,258,120,138,4,254,170,255,2,7.27%
2018-07,הצפון,480,בית ג'ן,351,86,265,15,336,224,340,1,6.52%
2018-07,הצפון,9200,בית שאן,670,327,343,25,645,265,647,37,6.57%
2018-07,הצפון,944,בסמת טבעון,142,64,78,3,139,85,132,1,4.23%
2018-07,הצפון,483,בענה,306,129,177,12,294,237,293,8,9.06%
2018-07,הצפון,1292,ג'דיידה-מכר,980,442,538,7,973,685,966,15,11.07%
2018-07,הצפון,485,ג'ולס,147,38,109,0,147,81,145,1,5.14%
2018-07,הצפון,487,ג'ש (גוש חלב),44,19,25,5,39,16,44,0,2.72%
2018-07,הצפון,489,דבורייה,229,91,138,17,212,153,222,0,5.43%
2018-07,הצפון,490,דייר אל-אסד,347,147,200,18,329,231,336,6,6.66%
2018-07,הצפון,492,דייר חנא,473,208,265,14,459,318,471,5,10.11%
2018-07,הצפון,975,זרזיר,193,73,120,7,186,97,191,4,6.41%
2018-07,הצפון,496,חורפיש,127,56,71,13,114,52,117,2,4.41%
2018-07,הצפון,2034,חצור הגלילית,221,89,132,15,206,89,210,1,4.51%
2018-07,הצפון,6700,טבריה,1366,610,756,86,1280,525,1223,51,5.73%
2018-07,הצפון,962,טובא-זנגרייה,287,110,177,5,282,151,280,8,9.49%
2018-07,הצפון,498,טורעאן,287,129,158,13,274,208,280,4,5.15%
2018-07,הצפון,8900,טמרה,1192,543,649,31,1161,854,1171,13,8.82%
2018-07,הצפון,1295,יאנוח-ג'ת,113,36,77,5,108,61,103,1,3.76%
2018-07,הצפון,46,יבנאל,83,46,37,10,73,36,73,0,4.81%
2018-07,הצפון,499,יפיע,415,189,226,24,391,299,414,2,5.47%
2018-07,הצפון,240,יקנעם עילית,480,203,277,110,370,83,473,21,4.10%
2018-07,הצפון,502,ירכא,334,143,191,1,333,224,330,4,5.89%
2018-07,הצפון,504,כאבול,369,190,179,10,359,277,358,0,7.84%
2018-07,הצפון,505,כאוכב אבו אל-היג'א,170,69,101,4,166,136,168,0,10.08%
2018-07,הצפון,1296,כסרא-סמיע,159,53,106,1,158,88,148,5,4.41%
2018-07,הצפון,978,כעביה-טבאש-חג'אג'רה,136,44,92,6,130,82,133,4,6.02%
2018-07,הצפון,1263,כפר ורדים,65,23,42,29,36,4,62,2,1.99%
2018-07,הצפון,507,כפר יאסיף,346,153,193,4,342,221,336,3,6.67%
2018-07,הצפון,508,כפר כמא,34,19,15,6,28,11,33,0,2.07%
2018-07,הצפון,509,כפר כנא,665,341,324,26,639,479,645,16,7.71%
2018-07,הצפון,510,כפר מנדא,621,303,318,12,609,405,620,2,8.86%
2018-07,הצפון,47,כפר תבור,45,19,26,19,26,4,44,0,2.03%
2018-07,הצפון,1139,כרמיאל,1371,573,798,289,1082,604,1275,30,5.00%
2018-07,הצפון,481,מגאר,902,363,539,19,883,643,883,7,10.06%
2018-07,הצפון,516,מג'ד אל-כרום,450,205,245,16,434,272,438,4,6.89%
2018-07,הצפון,874,מגדל העמק,835,372,463,88,747,232,789,57,5.95%
2018-07,הצפון,4201,מג'דל שמס,340,126,214,15,325,227,329,2,7.12%
2018-07,הצפון,517,מזרעה,126,59,67,3,123,81,119,2,6.25%
2018-07,הצפון,4203,מסעדה,170,69,101,6,164,118,162,2,9.94%
2018-07,הצפון,518,מעיליא,51,20,31,7,44,19,49,0,3.00%
2018-07,הצפון,1063,מעלות-תרשיחא,702,330,372,81,621,307,665,34,5.64%
2018-07,הצפון,520,משהד,152,70,82,3,149,108,145,5,4.74%
2018-07,הצפון,9100,נהרייה,1618,774,844,191,1427,724,1531,55,5.01%
2018-07,הצפון,522,נחף,335,146,189,11,324,243,330,8,6.77%
2018-07,הצפון,7300,נצרת,2480,1118,1362,138,2342,1653,2458,13,7.25%
2018-07,הצפון,1061,נצרת עילית,1263,603,659,112,1151,485,1153,74,4.98%
2018-07,הצפון,525,סאג'ור,107,45,62,7,100,61,103,0,5.84%
2018-07,הצפון,7500,סח'נין,1494,660,834,34,1460,1131,1481,20,11.14%
2018-07,הצפון,4501,ע'ג'ר,70,29,41,1,69,36,67,1,6.67%
2018-07,הצפון,530,עיילבון,135,63,72,6,129,74,131,1,4.90%
2018-07,הצפון,511,עילוט,225,91,134,3,222,167,225,0,8.28%
2018-07,הצפון,532,עין מאהל,326,168,158,6,320,230,316,0,6.29%
2018-07,הצפון,7600,עכו,2693,1120,1573,151,2542,1663,2595,38,9.93%
2018-07,הצפון,7700,עפולה,1464,588,876,163,1301,424,1402,55,5.69%
2018-07,הצפון,531,עראבה,1014,446,568,25,989,828,1004,9,10.52%
2018-07,הצפון,535,פסוטה,87,37,50,12,75,37,81,2,4.84%
2018-07,הצפון,536,פקיעין (בוקייעה),103,62,41,5,98,60,100,4,3.70%
2018-07,הצפון,8000,צפת,1010,504,506,99,911,526,957,20,7.36%
2018-07,הצפון,4100,קצרין,172,77,95,37,135,57,167,4,4.27%
2018-07,הצפון,2800,קריית שמונה,661,317,344,63,598,219,636,29,4.94%
2018-07,הצפון,543,ראמה,230,94,136,17,213,145,221,1,5.81%
2018-07,הצפון,26,ראש פינה,44,13,31,6,38,18,42,0,2.67%
2018-07,הצפון,542,ריינה,422,204,218,15,407,281,411,8,6.27%
2018-07,הצפון,122,רמת ישי,90,31,59,31,59,15,88,3,2.13%
2018-07,הצפון,913,שבלי - אום אל-גנם,157,55,102,8,149,93,151,5,6.02%
2018-07,הצפון,812,שלומי,201,87,114,17,184,82,194,1,5.46%
2018-07,הצפון,538,שעב,325,142,183,5,320,263,324,3,11.34%
2018-07,הצפון,8800,שפרעם,1186,513,673,43,1143,796,1169,14,6.94%
2018-07,חיפה,2710,אום אל-פחם,2329,1001,1328,32,2297,1775,2279,46,11.61%
2018-07,חיפה,1020,אור עקיבא,463,193,270,51,412,95,444,14,4.49%
2018-07,חיפה,6000,באקה אל-גרביה,525,272,253,18,507,276,520,23,4.56%
2018-07,חיפה,9800,בנימינה-גבעת עדה*,159,75,84,73,86,19,157,4,2.24%
2018-07,חיפה,1326,"בסמ""ה",290,135,155,4,286,214,287,3,7.46%
2018-07,חיפה,541,ג'סר א-זרקא,219,112,107,2,217,57,211,13,3.76%
2018-07,חיפה,628,ג'ת,185,94,91,7,178,88,185,2,3.59%
2018-07,חיפה,494,דאלית אל-כרמל,413,145,268,14,399,188,387,8,5.01%
2018-07,חיפה,9300,זכרון יעקב,231,99,132,93,138,17,229,2,2.12%
2018-07,חיפה,6500,חדרה,1986,859,1127,269,1717,521,1874,35,3.84%
2018-07,חיפה,4000,חיפה,5084,2461,2623,1143,3941,1983,4799,136,3.42%
2018-07,חיפה,1247,חריש,340,128,212,72,268,48,330,2,18.60%
2018-07,חיפה,2100,טירת כרמל,610,308,302,47,563,296,584,12,5.53%
2018-07,חיפה,654,כפר קרע,371,158,213,20,351,187,366,5,4.43%
2018-07,חיפה,1327,מעלה עירון,610,249,361,12,598,437,596,8,10.75%
2018-07,חיפה,2500,נשר,363,180,183,74,289,108,349,7,2.77%
2018-07,חיפה,534,עספיא,319,129,190,18,301,142,299,4,5.49%
2018-07,חיפה,637,ערערה,478,213,265,16,462,279,464,13,5.84%
2018-07,חיפה,537,פוריידיס,196,105,91,12,184,39,194,9,3.64%
2018-07,חיפה,7800,פרדס חנה-כרכור,708,296,412,214,494,57,695,14,3.50%
2018-07,חיפה,6800,קריית אתא,1347,555,792,134,1213,503,1302,25,4.41%
2018-07,חיפה,9500,קריית ביאליק,843,357,486,119,724,277,819,24,3.87%
2018-07,חיפה,2300,קריית טבעון,179,86,93,79,100,21,176,2,2.07%
2018-07,חיפה,9600,קריית ים,1111,587,524,105,1006,490,1070,34,5.12%
2018-07,חיפה,8200,קריית מוצקין,830,352,478,158,672,239,816,28,3.61%
2018-07,חיפה,922,רכסים,178,56,122,14,164,46,167,0,4.85%
2018-07,ירושלים,472,אבו גוש,197,84,113,9,188,148,192,1,6.42%
2018-07,ירושלים,2610,בית שמש,1605,533,1072,87,1518,307,1570,30,4.91%
2018-07,ירושלים,3000,ירושלים,11931,4891,7040,1502,10429,5888,11633,116,3.92%
2018-07,ירושלים,1015,מבשרת ציון,267,129,138,65,202,80,263,3,1.99%
2018-07,ירושלים,1137,קריית יערים,68,25,43,18,50,6,68,0,5.07%
2018-07,תל אביב,2400,אור יהודה,724,337,387,71,653,117,708,38,3.78%
2018-07,תל אביב,565,אזור,175,81,94,37,138,16,173,5,2.70%
2018-07,תל אביב,6100,בני ברק,2742,798,1944,101,2641,504,2645,20,4.70%
2018-07,תל אביב,6200,בת ים,2521,1245,1276,366,2155,710,2395,83,3.41%
2018-07,תל אביב,6300,גבעתיים,742,330,412,365,377,62,732,2,2.42%
2018-07,תל אביב,6400,הרצלייה,1091,511,580,413,678,37,1078,14,2.23%
2018-07,תל אביב,6600,חולון,2944,1306,1638,508,2436,471,2868,47,2.90%
2018-07,תל אביב,2620,קריית אונו,393,168,225,182,211,24,389,2,2.07%
2018-07,תל אביב,8600,רמת גן,2115,889,1226,783,1332,233,2079,23,2.66%
2018-07,תל אביב,2650,רמת השרון,412,182,230,200,212,7,408,2,1.81%
2018-07,תל אביב,5000,תל אביב -יפו,7152,3506,3646,3076,4076,1155,7022,81,2.79%
2018-08,אזור יהודה והשומרון,3760,אורנית,100,40,60,41,59,0,100,0,2.14%
2018-08,אזור יהודה והשומרון,3750,אלפי מנשה,97,39,58,30,67,2,97,0,2.28%
2018-08,אזור יהודה והשומרון,3560,אלקנה,31,19,12,17,14,0,31,1,1.63%
2018-08,אזור יהודה והשומרון,3650,אפרת,146,66,80,70,76,4,146,0,3.50%
2018-08,אזור יהודה והשומרון,3570,אריאל,267,112,155,75,192,16,263,9,2.52%
2018-08,אזור יהודה והשומרון,3574,בית אל,49,22,27,16,33,8,49,0,2.00%
2018-08,אזור יהודה והשומרון,3652,בית אריה,49,19,30,9,40,0,48,1,1.89%
2018-08,אזור יהודה והשומרון,3780,ביתר עילית,940,234,706,28,912,145,931,5,7.40%
2018-08,אזור יהודה והשומרון,3730,גבעת זאב,209,85,124,46,163,29,203,3,2.69%
2018-08,אזור יהודה והשומרון,3769,הר אדר,30,19,11,14,16,4,29,0,1.41%
2018-08,אזור יהודה והשומרון,3797,מודיעין עילית,981,171,810,44,937,32,976,2,7.16%
2018-08,אזור יהודה והשומרון,3616,מעלה אדומים,546,224,322,81,465,106,542,10,2.68%
2018-08,אזור יהודה והשומרון,3660,עמנואל,93,30,63,7,86,15,93,2,8.09%
2018-08,אזור יהודה והשומרון,3557,קדומים,30,16,14,13,17,2,29,0,1.56%
2018-08,אזור יהודה והשומרון,3611,קריית ארבע,104,51,53,17,87,33,99,3,3.12%
2018-08,אזור יהודה והשומרון,3640,קרני שומרון,65,30,35,16,49,0,64,1,1.77%
2018-08,הדרום,31,אופקים,1022,343,679,59,963,350,996,38,7.91%
2018-08,הדרום,2600,אילת,935,454,481,50,885,200,887,48,2.70%
2018-08,הדרום,70,אשדוד,5458,2065,3393,685,4773,1787,5249,79,4.89%
2018-08,הדרום,7100,אשקלון,3575,1467,2108,409,3166,1296,3296,77,4.83%
2018-08,הדרום,9000,באר שבע,5450,2465,2985,758,4692,2384,5163,94,5.05%
2018-08,הדרום,2200,דימונה,1655,727,928,77,1578,914,1571,20,8.75%
2018-08,הדרום,1303,חורה,476,201,275,4,472,393,452,4,12.21%
2018-08,הדרום,831,ירוחם,447,218,229,10,437,198,421,21,9.23%
2018-08,הדרום,1059,כסיפה,944,353,591,1,943,841,935,1,20.44%
2018-08,הדרום,1271,להבים,65,38,27,36,29,0,65,0,1.86%
2018-08,הדרום,1060,לקיה,616,251,365,7,609,483,585,3,15.15%
2018-08,הדרום,1268,מיתר,67,26,41,29,38,2,66,0,1.55%
2018-08,הדרום,99,מצפה רמון,237,84,153,17,220,146,227,11,9.32%
2018-08,הדרום,246,נתיבות,1199,424,775,87,1112,348,1152,48,8.18%
2018-08,הדרום,666,עומר,57,28,29,20,37,3,57,1,1.41%
2018-08,הדרום,2560,ערד,642,257,385,72,570,268,614,38,5.06%
2018-08,הדרום,1192,ערערה-בנגב,979,433,546,7,972,870,948,4,23.09%
2018-08,הדרום,2630,קריית גת,1697,688,1009,135,1562,580,1626,51,5.82%
2018-08,הדרום,1034,קריית מלאכי,797,326,471,26,771,309,759,44,6.72%
2018-08,הדרום,1161,רהט,2050,845,1205,12,2038,1385,2024,58,11.34%
2018-08,הדרום,1286,שגב-שלום,344,130,214,3,341,235,336,4,13.64%
2018-08,הדרום,1031,שדרות,969,433,536,76,893,416,884,39,7.01%
2018-08,הדרום,1054,תל שבע,728,325,403,6,722,583,682,12,15.40%
2018-08,המרכז,182,אבן יהודה,146,68,78,54,92,17,144,2,2.15%
2018-08,המרכז,41,אליכין,65,29,36,16,49,13,62,2,3.30%
2018-08,המרכז,1309,אלעד,740,196,544,30,710,29,721,1,5.64%
2018-08,המרכז,2530,באר יעקב,332,117,215,87,245,29,327,2,3.58%
2018-08,המרכז,466,בית דגן,115,51,64,21,94,29,111,0,3.11%
2018-08,המרכז,1066,"בני עי""ש",147,65,82,21,126,32,143,6,3.65%
2018-08,המרכז,681,גבעת שמואל,272,132,140,100,172,29,268,1,2.25%
2018-08,המרכז,2550,גדרה,318,132,186,72,246,47,311,5,2.68%
2018-08,המרכז,627,ג'לג'וליה,62,27,35,4,58,29,57,1,1.59%
2018-08,המרכז,166,גן יבנה,308,120,188,62,246,52,303,0,2.67%
2018-08,המרכז,229,גני תקווה,210,84,126,71,139,22,210,0,2.52%
2018-08,המרכז,9700,הוד השרון,758,278,480,349,409,14,750,7,2.53%
2018-08,המרכז,1290,זמר,112,35,77,3,109,77,108,2,3.75%
2018-08,המרכז,2730,טייבה,896,405,491,27,869,527,765,22,4.62%
2018-08,המרכז,2720,טירה,173,74,99,18,155,21,170,10,1.52%
2018-08,המרכז,2660,יבנה,774,340,434,165,609,132,755,16,3.27%
2018-08,המרכז,9400,יהוד,407,164,243,97,310,39,401,9,2.54%
2018-08,המרכז,1224,כוכב יאיר,87,33,54,57,30,0,87,1,1.54%
2018-08,המרכז,633,כפר ברא,20,11,9,3,17,7,19,0,1.40%
2018-08,המרכז,168,כפר יונה,327,131,196,63,264,43,326,6,3.01%
2018-08,המרכז,6900,כפר סבא,1252,533,719,479,773,51,1239,22,2.34%
2018-08,המרכז,634,כפר קאסם,181,78,103,7,174,80,178,3,2.03%
2018-08,המרכז,7000,לוד,1595,713,882,147,1448,618,1562,34,4.51%
2018-08,המרכז,1200,מודיעין-מכבים-רעות*,920,351,569,415,505,34,912,16,2.12%
2018-08,המרכז,28,מזכרת בתיה,185,66,119,56,129,20,184,0,2.62%
2018-08,המרכז,7200,נס ציונה,621,261,360,167,454,106,610,7,2.62%
2018-08,המרכז,7400,נתניה,4208,1773,2435,561,3647,885,4132,66,3.96%
2018-08,המרכז,587,סביון*,25,9,16,12,13,1,25,0,1.29%
2018-08,המרכז,171,פרדסייה,94,34,60,21,73,4,93,1,2.57%
2018-08,המרכז,7900,פתח תקווה,3925,1634,2291,811,3114,681,3840,36,3.10%
2018-08,המרכז,195,קדימה-צורן,276,114,162,91,185,15,275,1,2.60%
2018-08,המרכז,638,קלנסווה,282,134,148,10,272,175,248,9,3.00%
2018-08,המרכז,469,קריית עקרון,259,117,142,24,235,88,252,8,4.31%
2018-08,המרכז,2640,ראש העין,979,380,598,179,800,102,970,5,4.16%
2018-08,המרכז,8300,ראשון לציון,3895,1677,2218,822,3073,691,3860,58,2.81%
2018-08,המרכז,8400,רחובות,2529,995,1534,596,1933,534,2465,40,3.65%
2018-08,המרכז,8500,רמלה,1483,666,817,102,1381,417,1443,39,3.95%
2018-08,המרכז,8700,רעננה,712,322,390,341,371,23,706,10,1.91%
2018-08,המרכז,1304,שוהם,191,81,110,81,110,7,189,1,1.72%
2018-08,המרכז,154,תל מונד,142,55,87,41,101,12,140,0,2.27%
2018-08,הצפון,473,אבו סנאן,513,223,290,1,512,339,504,8,8.98%
2018-08,הצפון,478,אכסאל,406,187,219,13,393,312,406,2,7.35%
2018-08,הצפון,529,אעבלין,359,154,205,17,342,253,352,4,6.55%
2018-08,הצפון,482,בועיינה-נוג'ידאת,197,90,107,13,184,144,195,2,5.36%
2018-08,הצפון,4001,בוקעאתא,288,105,183,8,280,217,280,3,10.68%
2018-08,הצפון,998,ביר אל-מכסור,239,109,130,4,235,159,239,3,6.85%
2018-08,הצפון,480,בית ג'ן,346,85,261,12,334,217,337,2,6.46%
2018-08,הצפון,9200,בית שאן,686,322,364,24,662,270,661,36,6.70%
2018-08,הצפון,944,בסמת טבעון,135,62,73,4,131,82,127,4,4.08%
2018-08,הצפון,483,בענה,301,129,172,13,288,231,292,1,9.03%
2018-08,הצפון,1292,ג'דיידה-מכר,980,426,554,6,974,675,963,11,11.04%
2018-08,הצפון,485,ג'ולס,145,40,105,0,145,79,145,2,5.14%
2018-08,הצפון,487,ג'ש (גוש חלב),49,20,29,6,43,18,49,3,3.02%
2018-08,הצפון,489,דבורייה,222,91,131,12,210,148,218,4,5.34%
2018-08,הצפון,490,דייר אל-אסד,347,136,211,20,327,227,334,4,6.62%
2018-08,הצפון,492,דייר חנא,457,204,253,16,441,301,456,4,9.81%
2018-08,הצפון,975,זרזיר,197,70,127,8,189,91,196,10,6.56%
2018-08,הצפון,496,חורפיש,110,52,58,12,98,49,102,4,3.87%
2018-08,הצפון,2034,חצור הגלילית,236,96,140,23,213,81,222,6,4.76%
2018-08,הצפון,6700,טבריה,1331,581,750,89,1242,519,1198,43,5.62%
2018-08,הצפון,962,טובא-זנגרייה,267,100,167,3,264,149,261,13,8.90%
2018-08,הצפון,498,טורעאן,309,123,186,12,297,213,297,4,5.45%
2018-08,הצפון,8900,טמרה,1189,536,653,37,1152,836,1168,9,8.80%
2018-08,הצפון,1295,יאנוח-ג'ת,117,45,72,5,112,59,106,5,3.86%
2018-08,הצפון,46,יבנאל,85,46,39,9,76,32,76,1,5.00%
2018-08,הצפון,499,יפיע,434,194,240,29,405,296,431,1,5.68%
2018-08,הצפון,240,יקנעם עילית,477,213,264,110,367,81,468,24,4.06%
2018-08,הצפון,502,ירכא,326,140,186,1,325,216,324,6,5.79%
2018-08,הצפון,504,כאבול,362,184,178,7,355,271,354,0,7.76%
2018-08,הצפון,505,כאוכב אבו אל-היג'א,165,64,101,7,158,131,162,3,9.75%
2018-08,הצפון,1296,כסרא-סמיע,156,53,103,1,155,85,148,1,4.41%
2018-08,הצפון,978,כעביה-טבאש-חג'אג'רה,128,45,83,6,122,80,122,1,5.55%
2018-08,הצפון,1263,כפר ורדים,69,25,44,30,39,6,67,2,2.14%
2018-08,הצפון,507,כפר יאסיף,336,152,184,2,334,210,328,6,6.52%
2018-08,הצפון,508,כפר כמא,36,19,17,8,28,8,36,2,2.26%
2018-08,הצפון,509,כפר כנא,625,317,308,28,597,466,607,12,7.29%
2018-08,הצפון,510,כפר מנדא,612,283,329,13,599,400,607,2,8.69%
2018-08,הצפון,47,כפר תבור,48,18,30,19,29,4,47,0,2.16%
2018-08,הצפון,1139,כרמיאל,1376,570,806,280,1096,600,1280,34,5.01%
2018-08,הצפון,481,מגאר,849,354,495,18,831,629,830,13,9.51%
2018-08,הצפון,516,מג'ד אל-כרום,485,201,284,20,465,282,473,7,7.40%
2018-08,הצפון,874,מגדל העמק,807,356,451,90,717,220,767,51,5.80%
2018-08,הצפון,4201,מג'דל שמס,323,117,206,10,313,222,312,6,6.77%
2018-08,הצפון,517,מזרעה,130,66,64,3,127,84,121,2,6.35%
2018-08,הצפון,4203,מסעדה,169,68,101,4,165,118,162,0,9.94%
2018-08,הצפון,518,מעיליא,50,21,29,3,47,18,48,2,2.94%
2018-08,הצפון,1063,מעלות-תרשיחא,704,317,387,79,625,303,664,35,5.63%
2018-08,הצפון,520,משהד,140,61,79,2,138,98,136,2,4.45%
2018-08,הצפון,9100,נהרייה,1574,740,834,182,1392,685,1492,51,4.89%
2018-08,הצפון,522,נחף,315,138,177,10,305,235,310,6,6.39%
2018-08,הצפון,7300,נצרת,2430,1082,1348,133,2297,1608,2410,11,7.12%
2018-08,הצפון,1061,נצרת עילית,1236,554,682,122,1114,471,1117,87,4.83%
2018-08,הצפון,525,סאג'ור,96,41,55,4,92,56,93,1,5.31%
2018-08,הצפון,7500,סח'נין,1459,638,821,50,1409,1097,1442,11,10.87%
2018-08,הצפון,4501,ע'ג'ר,69,32,37,3,66,38,66,1,6.58%
2018-08,הצפון,530,עיילבון,126,63,63,6,120,71,123,1,4.62%
2018-08,הצפון,511,עילוט,230,91,139,4,226,163,229,0,8.42%
2018-08,הצפון,532,עין מאהל,307,160,147,9,298,223,297,2,5.93%
2018-08,הצפון,7600,עכו,2685,1090,1595,163,2522,1626,2583,33,9.89%
2018-08,הצפון,7700,עפולה,1523,598,925,171,1352,447,1456,55,5.90%
2018-08,הצפון,531,עראבה,970,435,535,31,939,792,962,9,10.13%
2018-08,הצפון,535,פסוטה,84,40,44,10,74,39,82,2,4.90%
2018-08,הצפון,536,פקיעין (בוקייעה),101,58,43,3,98,62,97,2,3.59%
2018-08,הצפון,8000,צפת,1021,486,535,97,924,498,983,23,7.55%
2018-08,הצפון,4100,קצרין,181,77,104,34,147,57,177,4,4.51%
2018-08,הצפון,2800,קריית שמונה,639,288,351,60,579,209,614,21,4.78%
2018-08,הצפון,543,ראמה,220,90,130,16,204,140,211,2,5.56%
2018-08,הצפון,26,ראש פינה,43,11,32,6,37,17,41,0,2.61%
2018-08,הצפון,542,ריינה,423,207,216,15,408,269,414,5,6.31%
2018-08,הצפון,122,רמת ישי,99,30,69,40,59,14,97,0,2.35%
2018-08,הצפון,913,שבלי - אום אל-גנם,148,58,90,8,140,91,142,2,5.68%
2018-08,הצפון,812,שלומי,193,76,117,17,176,76,189,6,5.33%
2018-08,הצפון,538,שעב,311,137,174,6,305,254,308,0,10.84%
2018-08,הצפון,8800,שפרעם,1152,497,655,51,1101,771,1134,19,6.75%
2018-08,חיפה,2710,אום אל-פחם,2275,981,1294,38,2237,1729,2228,31,11.38%
2018-08,חיפה,1020,אור עקיבא,453,201,252,54,399,94,441,9,4.46%
2018-08,חיפה,6000,באקה אל-גרביה,516,267,249,18,498,275,509,14,4.47%
2018-08,חיפה,9800,בנימינה-גבעת עדה*,156,70,86,66,90,17,154,0,2.20%
2018-08,חיפה,1326,"בסמ""ה",294,139,155,7,287,208,292,1,7.58%
2018-08,חיפה,541,ג'סר א-זרקא,196,99,97,2,194,57,192,16,3.44%
2018-08,חיפה,628,ג'ת,165,81,84,6,159,84,163,1,3.18%
2018-08,חיפה,494,דאלית אל-כרמל,391,142,249,12,379,186,370,6,4.80%
2018-08,חיפה,9300,זכרון יעקב,242,100,142,90,152,15,240,6,2.22%
2018-08,חיפה,6500,חדרה,1993,842,1151,272,1721,496,1890,52,3.87%
2018-08,חיפה,4000,חיפה,5153,2400,2753,1158,3995,1937,4854,145,3.46%
2018-08,חיפה,1247,חריש,386,132,254,82,304,50,376,0,20.66%
2018-08,חיפה,2100,טירת כרמל,615,289,326,41,574,300,586,17,5.55%
2018-08,חיפה,654,כפר קרע,356,153,203,17,339,187,352,8,4.27%
2018-08,חיפה,1327,מעלה עירון,586,235,351,11,575,417,576,1,10.43%
2018-08,חיפה,2500,נשר,378,178,200,85,293,108,360,7,2.85%
2018-08,חיפה,534,עספיא,313,132,181,18,295,144,293,1,5.38%
2018-08,חיפה,637,ערערה,466,210,256,20,446,274,454,9,5.72%
2018-08,חיפה,537,פוריידיס,174,92,82,12,162,38,174,6,3.28%
2018-08,חיפה,7800,פרדס חנה-כרכור,672,271,401,205,467,60,662,18,3.34%
2018-08,חיפה,6800,קריית אתא,1404,535,869,129,1275,495,1361,25,4.61%
2018-08,חיפה,9500,קריית ביאליק,837,343,494,128,709,274,817,28,3.86%
2018-08,חיפה,2300,קריית טבעון,185,89,96,71,114,21,179,1,2.10%
2018-08,חיפה,9600,קריית ים,1096,559,537,110,986,487,1058,35,5.06%
2018-08,חיפה,8200,קריית מוצקין,815,341,474,165,650,231,794,16,3.52%
2018-08,חיפה,922,רכסים,196,52,144,11,185,46,185,1,5.35%
2018-08,ירושלים,472,אבו גוש,199,84,115,9,190,137,195,3,6.52%
2018-08,ירושלים,2610,בית שמש,1640,523,1117,91,1549,300,1599,28,5.00%
2018-08,ירושלים,3000,ירושלים,12391,4963,7428,1526,10865,5832,12133,112,4.08%
2018-08,ירושלים,1015,מבשרת ציון,274,131,143,67,207,76,271,3,2.05%
2018-08,ירושלים,1137,קריית יערים,62,21,41,17,45,7,62,0,4.65%
2018-08,תל אביב,2400,אור יהודה,770,327,443,67,703,110,750,28,3.99%
2018-08,תל אביב,565,אזור,169,78,91,31,138,17,165,1,2.58%
2018-08,תל אביב,6100,בני ברק,3045,800,2245,104,2941,506,2946,5,5.21%
2018-08,תל אביב,6200,בת ים,2475,1192,1283,370,2105,671,2361,61,3.36%
2018-08,תל אביב,6300,גבעתיים,719,323,396,349,370,60,710,2,2.35%
2018-08,תל אביב,6400,הרצלייה,1143,490,653,419,724,32,1134,9,2.34%
2018-08,תל אביב,6600,חולון,2961,1283,1678,487,2474,484,2874,39,2.90%
2018-08,תל אביב,2620,קריית אונו,402,171,231,180,222,26,399,7,2.12%
2018-08,תל אביב,8600,רמת גן,2041,848,1193,761,1280,218,2008,14,2.57%
2018-08,תל אביב,2650,רמת השרון,448,178,270,193,255,9,445,2,1.98%
2018-08,תל אביב,5000,תל אביב -יפו,6713,3272,3441,2913,3800,1045,6597,43,2.63%
2018-09,אזור יהודה והשומרון,3760,אורנית,94,40,54,44,50,0,94,0,2.01%
2018-09,אזור יהודה והשומרון,3750,אלפי מנשה,98,39,59,29,69,1,98,1,2.30%
2018-09,אזור יהודה והשומרון,3560,אלקנה,29,15,14,17,12,0,29,0,1.53%
2018-09,אזור יהודה והשומרון,3650,אפרת,132,60,72,66,66,4,132,0,3.17%
2018-09,אזור יהודה והשומרון,3570,אריאל,237,100,137,66,171,18,235,4,2.26%
2018-09,אזור יהודה והשומרון,3574,בית אל,42,17,25,14,28,9,42,0,1.72%
2018-09,אזור יהודה והשומרון,3652,בית אריה,44,20,24,9,35,0,44,2,1.73%
2018-09,אזור יהודה והשומרון,3780,ביתר עילית,518,204,314,20,498,134,511,1,4.20%
2018-09,אזור יהודה והשומרון,3730,גבעת זאב,168,75,93,42,126,27,163,2,2.17%
2018-09,אזור יהודה והשומרון,3769,הר אדר,30,19,11,13,17,4,30,0,1.46%
2018-09,אזור יהודה והשומרון,3797,מודיעין עילית,535,159,376,33,502,22,535,1,4.06%
2018-09,אזור יהודה והשומרון,3616,מעלה אדומים,438,193,245,81,357,87,435,4,2.16%
2018-09,אזור יהודה והשומרון,3660,עמנואל,56,22,34,5,51,15,56,1,5.03%
2018-09,אזור יהודה והשומרון,3557,קדומים,20,12,8,12,8,0,19,0,1.03%
2018-09,אזור יהודה והשומרון,3611,קריית ארבע,77,33,44,14,63,27,74,3,2.35%
2018-09,אזור יהודה והשומרון,3640,קרני שומרון,68,32,36,24,44,0,66,0,1.82%
2018-09,הדרום,31,אופקים,796,290,506,54,742,324,772,18,6.25%
2018-09,הדרום,2600,אילת,852,412,440,41,811,195,812,17,2.48%
2018-09,הדרום,70,אשדוד,4563,1903,2660,616,3947,1700,4380,28,4.12%
2018-09,הדרום,7100,אשקלון,3159,1313,1846,360,2799,1202,2926,25,4.31%
2018-09,הדרום,9000,באר שבע,4842,2214,2628,714,4128,2251,4588,54,4.51%
2018-09,הדרום,2200,דימונה,1397,633,764,70,1327,845,1330,13,7.51%
2018-09,הדרום,1303,חורה,427,191,236,7,420,360,413,3,11.27%
2018-09,הדרום,831,ירוחם,370,174,196,13,357,193,349,8,7.78%
2018-09,הדרום,1059,כסיפה,909,333,576,2,907,819,902,0,19.86%
2018-09,הדרום,1271,להבים,71,43,28,40,31,1,71,0,2.03%
2018-09,הדרום,1060,לקיה,508,225,283,6,502,420,487,1,12.94%
2018-09,הדרום,1268,מיתר,66,20,46,33,33,1,64,0,1.50%
2018-09,הדרום,99,מצפה רמון,225,83,142,19,206,146,215,8,8.87%
2018-09,הדרום,246,נתיבות,898,347,551,67,831,327,860,25,6.24%
2018-09,הדרום,666,עומר,49,24,25,23,26,3,49,1,1.21%
2018-09,הדרום,2560,ערד,544,241,303,66,478,246,520,16,4.32%
2018-09,הדרום,1192,ערערה-בנגב,923,393,530,6,917,822,897,0,22.13%
2018-09,הדרום,2630,קריית גת,1445,593,852,124,1321,537,1384,13,4.99%
2018-09,הדרום,1034,קריית מלאכי,672,271,401,31,641,296,639,15,5.72%
2018-09,הדרום,1161,רהט,1835,737,1098,8,1827,1350,1813,17,10.28%
2018-09,הדרום,1286,שגב-שלום,315,119,196,3,312,224,305,2,12.54%
2018-09,הדרום,1031,שדרות,837,363,474,65,772,413,760,15,6.08%
2018-09,הדרום,1054,תל שבע,622,272,350,3,619,529,586,7,13.52%
2018-09,המרכז,182,אבן יהודה,143,61,82,55,88,16,140,1,2.09%
2018-09,המרכז,41,אליכין,54,21,33,13,41,12,51,1,2.73%
2018-09,המרכז,1309,אלעד,404,149,255,23,381,25,391,5,3.14%
2018-09,המרכז,2530,באר יעקב,296,108,188,84,212,25,289,1,3.17%
2018-09,המרכז,466,בית דגן,98,44,54,19,79,25,95,0,2.67%
2018-09,המרכז,1066,"בני עי""ש",125,59,66,17,108,31,121,0,3.10%
2018-09,המרכז,681,גבעת שמואל,249,123,126,100,149,23,246,1,2.07%
2018-09,המרכז,2550,גדרה,274,109,165,69,205,46,268,1,2.32%
2018-09,המרכז,627,ג'לג'וליה,55,25,30,3,52,23,51,0,1.42%
2018-09,המרכז,166,גן יבנה,290,110,180,61,229,52,280,1,2.47%
2018-09,המרכז,229,גני תקווה,176,74,102,67,109,17,175,1,2.11%
2018-09,המרכז,9700,הוד השרון,634,242,392,328,306,15,628,5,2.13%
2018-09,המרכז,1290,זמר,90,28,62,3,87,62,88,0,3.08%
2018-09,המרכז,2730,טייבה,880,404,476,30,850,512,756,14,4.57%
2018-09,המרכז,2720,טירה,128,66,62,18,110,20,125,4,1.12%
2018-09,המרכז,2660,יבנה,693,293,400,161,532,128,686,9,2.98%
2018-09,המרכז,9400,יהוד,343,139,204,89,254,33,340,3,2.16%
2018-09,המרכז,1224,כוכב יאיר,92,37,55,67,25,0,92,1,1.63%
2018-09,המרכז,633,כפר ברא,13,9,4,1,12,4,13,0,0.96%
2018-09,המרכז,168,כפר יונה,283,123,160,58,225,35,282,3,2.62%
2018-09,המרכז,6900,כפר סבא,1084,462,622,452,632,45,1078,16,2.04%
2018-09,המרכז,634,כפר קאסם,146,67,79,10,136,70,143,0,1.64%
2018-09,המרכז,7000,לוד,1434,660,774,133,1301,578,1408,16,4.08%
2018-09,המרכז,1200,מודיעין-מכבים-רעות*,761,313,448,383,378,26,754,4,1.76%
2018-09,המרכז,28,מזכרת בתיה,149,64,85,48,101,21,147,1,2.10%
2018-09,המרכז,7200,נס ציונה,536,233,303,160,376,92,530,3,2.28%
2018-09,המרכז,7400,נתניה,3506,1576,1930,538,2968,809,3438,31,3.32%
2018-09,המרכז,587,סביון*,19,8,11,10,9,0,19,0,0.98%
2018-09,המרכז,171,פרדסייה,76,27,49,20,56,5,76,0,2.11%
2018-09,המרכז,7900,פתח תקווה,3315,1464,1851,735,2580,603,3252,25,2.64%
2018-09,המרכז,195,קדימה-צורן,245,101,144,84,161,16,244,0,2.31%
2018-09,המרכז,638,קלנסווה,278,132,146,9,269,175,241,7,2.92%
2018-09,המרכז,469,קריית עקרון,202,93,109,26,176,70,197,1,3.40%
2018-09,המרכז,2640,ראש העין,810,355,455,177,633,101,802,3,3.46%
2018-09,המרכז,8300,ראשון לציון,3365,1422,1943,756,2609,620,3347,18,2.45%
2018-09,המרכז,8400,רחובות,1995,865,1130,542,1453,474,1944,19,2.90%
2018-09,המרכז,8500,רמלה,1217,568,649,95,1122,359,1178,27,3.25%
2018-09,המרכז,8700,רעננה,654,301,353,335,319,24,650,6,1.76%
2018-09,המרכז,1304,שוהם,172,76,96,77,95,6,171,1,1.55%
2018-09,המרכז,154,תל מונד,121,49,72,43,78,9,120,0,1.95%
2018-09,הצפון,473,אבו סנאן,475,206,269,2,473,321,467,2,8.37%
2018-09,הצפון,478,אכסאל,375,180,195,15,360,300,374,1,6.81%
2018-09,הצפון,529,אעבלין,334,140,194,17,317,248,329,2,6.15%
2018-09,הצפון,482,בועיינה-נוג'ידאת,195,90,105,12,183,143,195,1,5.36%
2018-09,הצפון,4001,בוקעאתא,278,112,166,9,269,206,270,2,10.34%
2018-09,הצפון,998,ביר אל-מכסור,239,109,130,4,235,158,239,2,6.85%
2018-09,הצפון,480,בית ג'ן,322,84,238,12,310,212,313,0,6.03%
2018-09,הצפון,9200,בית שאן,616,273,343,28,588,267,597,16,6.09%
2018-09,הצפון,944,בסמת טבעון,122,57,65,3,119,74,114,1,3.68%
2018-09,הצפון,483,בענה,282,130,152,11,271,225,273,0,8.49%
2018-09,הצפון,1292,ג'דיידה-מכר,922,399,523,4,918,650,902,4,10.41%
2018-09,הצפון,485,ג'ולס,135,33,102,0,135,76,134,1,4.77%
2018-09,הצפון,487,ג'ש (גוש חלב),45,17,28,5,40,17,44,0,2.72%
2018-09,הצפון,489,דבורייה,208,82,126,10,198,151,204,2,5.01%
2018-09,הצפון,490,דייר אל-אסד,307,135,172,19,288,214,296,2,5.92%
2018-09,הצפון,492,דייר חנא,429,196,233,16,413,293,427,1,9.25%
2018-09,הצפון,975,זרזיר,170,57,113,8,162,87,170,3,5.74%
2018-09,הצפון,496,חורפיש,97,44,53,10,87,46,90,2,3.43%
2018-09,הצפון,2034,חצור הגלילית,233,93,140,25,208,92,221,3,4.74%
2018-09,הצפון,6700,טבריה,1183,532,651,87,1096,507,1050,20,4.96%
2018-09,הצפון,962,טובא-זנגרייה,235,96,139,2,233,147,227,8,7.83%
2018-09,הצפון,498,טורעאן,267,114,153,13,254,209,258,4,4.77%
2018-09,הצפון,8900,טמרה,1113,523,590,42,1071,799,1093,5,8.28%
2018-09,הצפון,1295,יאנוח-ג'ת,104,40,64,7,97,51,98,1,3.58%
2018-09,הצפון,46,יבנאל,77,41,36,6,71,28,68,2,4.49%
2018-09,הצפון,499,יפיע,423,188,235,26,397,289,420,1,5.54%
2018-09,הצפון,240,יקנעם עילית,392,176,216,95,297,72,385,11,3.36%
2018-09,הצפון,502,ירכא,319,133,186,1,318,207,317,0,5.67%
2018-09,הצפון,504,כאבול,332,172,160,8,324,256,324,1,7.15%
2018-09,הצפון,505,כאוכב אבו אל-היג'א,158,61,97,6,152,128,155,1,9.37%
2018-09,הצפון,1296,כסרא-סמיע,146,50,96,1,145,79,142,0,4.24%
2018-09,הצפון,978,כעביה-טבאש-חג'אג'רה,122,45,77,10,112,77,121,0,5.51%
2018-09,הצפון,1263,כפר ורדים,54,18,36,25,29,7,53,0,1.70%
2018-09,הצפון,507,כפר יאסיף,315,140,175,2,313,195,308,3,6.15%
2018-09,הצפון,508,כפר כמא,35,15,20,7,28,9,35,0,2.20%
2018-09,הצפון,509,כפר כנא,607,311,296,34,573,454,587,3,7.06%
2018-09,הצפון,510,כפר מנדא,527,263,264,14,513,388,525,2,7.60%
2018-09,הצפון,47,כפר תבור,48,16,32,18,30,3,47,0,2.16%
2018-09,הצפון,1139,כרמיאל,1271,513,758,292,979,563,1184,10,4.66%
2018-09,הצפון,481,מגאר,781,339,442,18,763,594,761,0,8.79%
2018-09,הצפון,516,מג'ד אל-כרום,428,190,238,17,411,262,418,4,6.60%
2018-09,הצפון,874,מגדל העמק,664,278,386,81,583,206,636,25,4.86%
2018-09,הצפון,4201,מג'דל שמס,332,121,211,10,322,220,317,3,6.87%
2018-09,הצפון,517,מזרעה,121,58,63,5,116,80,114,0,6.01%
2018-09,הצפון,4203,מסעדה,152,58,94,5,147,111,146,1,9.05%
2018-09,הצפון,518,מעיליא,45,21,24,1,44,21,43,0,2.64%
2018-09,הצפון,1063,מעלות-תרשיחא,601,266,335,75,526,270,573,13,4.90%
2018-09,הצפון,520,משהד,148,65,83,4,144,105,144,1,4.70%
2018-09,הצפון,9100,נהרייה,1442,647,795,179,1263,680,1369,26,4.51%
2018-09,הצפון,522,נחף,312,138,174,11,301,232,305,3,6.29%
2018-09,הצפון,7300,נצרת,2223,1023,1200,122,2101,1556,2205,9,6.56%
2018-09,הצפון,1061,נצרת עילית,1072,463,609,119,953,437,968,39,4.22%
2018-09,הצפון,525,סאג'ור,95,40,55,4,91,56,93,1,5.31%
2018-09,הצפון,7500,סח'נין,1376,605,771,47,1329,1051,1364,4,10.35%
2018-09,הצפון,4501,ע'ג'ר,64,26,38,3,61,36,62,1,6.21%
2018-09,הצפון,530,עיילבון,119,61,58,6,113,67,117,0,4.40%
2018-09,הצפון,511,עילוט,200,84,116,3,197,152,200,0,7.43%
2018-09,הצפון,532,עין מאהל,304,158,146,9,295,226,295,2,5.90%
2018-09,הצפון,7600,עכו,2265,997,1268,138,2127,1539,2170,17,8.45%
2018-09,הצפון,7700,עפולה,1303,497,806,181,1122,420,1260,21,5.15%
2018-09,הצפון,531,עראבה,934,428,506,33,901,757,928,4,9.80%
2018-09,הצפון,535,פסוטה,71,31,40,10,61,38,67,0,4.04%
2018-09,הצפון,536,פקיעין (בוקייעה),97,53,44,3,94,61,95,1,3.52%
2018-09,הצפון,8000,צפת,867,424,443,92,775,469,832,12,6.46%
2018-09,הצפון,4100,קצרין,149,64,85,30,119,49,145,6,3.73%
2018-09,הצפון,2800,קריית שמונה,555,246,309,61,494,191,536,8,4.20%
2018-09,הצפון,543,ראמה,200,86,114,14,186,129,192,1,5.09%
2018-09,הצפון,26,ראש פינה,38,11,27,7,31,19,36,0,2.30%
2018-09,הצפון,542,ריינה,389,200,189,16,373,255,381,0,5.83%
2018-09,הצפון,122,רמת ישי,87,30,57,35,52,13,86,0,2.09%
2018-09,הצפון,913,שבלי - אום אל-גנם,129,47,82,6,123,80,126,1,5.08%
2018-09,הצפון,812,שלומי,160,67,93,13,147,72,151,2,4.30%
2018-09,הצפון,538,שעב,301,134,167,4,297,246,299,0,10.55%
2018-09,הצפון,8800,שפרעם,1089,493,596,57,1032,738,1070,7,6.39%
2018-09,חיפה,2710,אום אל-פחם,2138,940,1198,36,2102,1633,2102,21,10.81%
2018-09,חיפה,1020,אור עקיבא,410,172,238,57,353,88,396,1,4.02%
2018-09,חיפה,6000,באקה אל-גרביה,490,256,234,21,469,254,482,8,4.24%
2018-09,חיפה,9800,בנימינה-גבעת עדה*,153,65,88,67,86,16,152,1,2.17%
2018-09,חיפה,1326,"בסמ""ה",287,141,146,8,279,203,283,0,7.37%
2018-09,חיפה,541,ג'סר א-זרקא,165,90,75,1,164,46,161,6,2.90%
2018-09,חיפה,628,ג'ת,158,80,78,8,150,73,157,5,3.06%
2018-09,חיפה,494,דאלית אל-כרמל,366,125,241,16,350,186,345,3,4.49%
2018-09,חיפה,9300,זכרון יעקב,209,90,119,89,120,11,209,0,1.94%
2018-09,חיפה,6500,חדרה,1788,756,1032,259,1529,457,1705,28,3.50%
2018-09,חיפה,4000,חיפה,4563,2174,2389,1091,3472,1788,4318,60,3.09%
2018-09,חיפה,1247,חריש,358,126,232,92,266,46,346,5,19.33%
2018-09,חיפה,2100,טירת כרמל,561,268,293,42,519,278,534,10,5.08%
2018-09,חיפה,654,כפר קרע,357,162,195,20,337,188,352,7,4.27%
2018-09,חיפה,1327,מעלה עירון,538,220,318,8,530,397,531,1,9.69%
2018-09,חיפה,2500,נשר,321,164,157,77,244,90,309,4,2.46%
2018-09,חיפה,534,עספיא,284,121,163,23,261,136,268,1,4.95%
2018-09,חיפה,637,ערערה,451,195,256,20,431,263,436,4,5.51%
2018-09,חיפה,537,פוריידיס,155,84,71,7,148,32,155,3,2.93%
2018-09,חיפה,7800,פרדס חנה-כרכור,593,241,352,194,399,62,581,16,2.95%
2018-09,חיפה,6800,קריית אתא,1132,499,633,129,1003,448,1096,13,3.74%
2018-09,חיפה,9500,קריית ביאליק,757,322,435,131,626,261,741,13,3.51%
2018-09,חיפה,2300,קריית טבעון,184,86,98,74,110,19,180,1,2.11%
2018-09,חיפה,9600,קריית ים,1008,506,502,109,899,464,973,9,4.67%
2018-09,חיפה,8200,קריית מוצקין,755,315,440,163,592,223,743,4,3.30%
2018-09,חיפה,922,רכסים,130,47,83,9,121,45,117,1,3.45%
2018-09,ירושלים,472,אבו גוש,191,85,106,8,183,137,189,2,6.33%
2018-09,ירושלים,2610,בית שמש,1215,442,773,92,1123,267,1187,12,3.76%
2018-09,ירושלים,3000,ירושלים,10181,4495,5686,1387,8794,5551,9959,72,3.37%
2018-09,ירושלים,1015,מבשרת ציון,244,125,119,66,178,69,241,2,1.83%
2018-09,ירושלים,1137,קריית יערים,43,17,26,14,29,6,43,0,3.27%
2018-09,תל אביב,2400,אור יהודה,547,268,279,52,495,100,531,9,2.86%
2018-09,תל אביב,565,אזור,143,71,72,26,117,16,141,0,2.21%
2018-09,תל אביב,6100,בני ברק,1695,687,1008,95,1600,459,1599,4,2.90%
2018-09,תל אביב,6200,בת ים,2190,1047,1143,330,1860,614,2097,16,2.99%
2018-09,תל אביב,6300,גבעתיים,673,299,374,336,337,66,666,2,2.20%
2018-09,תל אביב,6400,הרצלייה,992,447,545,423,569,27,978,1,2.03%
2018-09,תל אביב,6600,חולון,2611,1167,1444,471,2140,428,2554,16,2.59%
2018-09,תל אביב,2620,קריית אונו,347,161,186,163,184,22,344,0,1.83%
2018-09,תל אביב,8600,רמת גן,1832,813,1019,731,1101,201,1806,7,2.32%
2018-09,תל אביב,2650,רמת השרון,375,155,220,178,197,9,372,3,1.66%
2018-09,תל אביב,5000,תל אביב -יפו,6482,3146,3336,2922,3560,1007,6380,34,2.54%
2018-10,אזור יהודה והשומרון,3760,אורנית,99,40,59,45,54,2,99,0,2.12%
2018-10,אזור יהודה והשומרון,3750,אלפי מנשה,105,45,60,32,73,0,105,2,2.46%
2018-10,אזור יהודה והשומרון,3560,אלקנה,41,17,24,23,18,0,41,1,2.15%
2018-10,אזור יהודה והשומרון,3650,אפרת,166,90,76,84,82,4,166,0,3.96%
2018-10,אזור יהודה והשומרון,3570,אריאל,279,120,159,84,195,17,278,10,2.66%
2018-10,אזור יהודה והשומרון,3574,בית אל,50,25,25,14,36,9,50,0,2.04%
2018-10,אזור יהודה והשומרון,3652,בית אריה,51,21,30,5,46,0,51,1,2.00%
2018-10,אזור יהודה והשומרון,3780,ביתר עילית,532,229,303,22,510,135,522,4,4.29%
2018-10,אזור יהודה והשומרון,3730,גבעת זאב,174,82,92,46,128,28,173,1,2.30%
2018-10,אזור יהודה והשומרון,3769,הר אדר,37,23,14,16,21,4,36,0,1.74%
2018-10,אזור יהודה והשומרון,3797,מודיעין עילית,501,171,330,33,468,30,499,4,3.80%
2018-10,אזור יהודה והשומרון,3616,מעלה אדומים,540,251,289,86,454,96,536,17,2.65%
2018-10,אזור יהודה והשומרון,3660,עמנואל,51,22,29,6,45,15,51,0,4.60%
2018-10,אזור יהודה והשומרון,3557,קדומים,27,14,13,14,13,0,27,0,1.46%
2018-10,אזור יהודה והשומרון,3611,קריית ארבע,85,44,41,15,70,28,83,7,2.63%
2018-10,אזור יהודה והשומרון,3640,קרני שומרון,82,42,40,27,55,1,80,1,2.20%
2018-10,הדרום,31,אופקים,890,367,523,56,834,349,860,44,6.91%
2018-10,הדרום,2600,אילת,973,487,486,49,924,228,926,47,2.81%
2018-10,הדרום,70,אשדוד,5076,2158,2918,653,4423,1839,4850,94,4.54%
2018-10,הדרום,7100,אשקלון,3494,1497,1997,389,3105,1312,3219,61,4.72%
2018-10,הדרום,9000,באר שבע,5380,2502,2878,807,4573,2425,5069,89,4.96%
2018-10,הדרום,2200,דימונה,1574,737,837,79,1495,921,1470,24,8.23%
2018-10,הדרום,1303,חורה,493,223,270,9,484,400,467,0,12.56%
2018-10,הדרום,831,ירוחם,401,203,198,14,387,195,377,28,8.35%
2018-10,הדרום,1059,כסיפה,995,382,613,3,992,876,983,11,21.26%
2018-10,הדרום,1271,להבים,70,40,30,43,27,1,70,0,2.00%
2018-10,הדרום,1060,לקיה,575,251,324,5,570,476,543,9,14.22%
2018-10,הדרום,1268,מיתר,68,23,45,35,33,4,65,0,1.52%
2018-10,הדרום,99,מצפה רמון,242,97,145,21,221,150,229,16,9.39%
2018-10,הדרום,246,נתיבות,1038,412,626,70,968,343,978,52,7.03%
2018-10,הדרום,666,עומר,59,28,31,25,34,3,59,1,1.46%
2018-10,הדרום,2560,ערד,609,277,332,69,540,262,581,18,4.80%
2018-10,הדרום,1192,ערערה-בנגב,1000,428,572,7,993,877,974,10,23.58%
2018-10,הדרום,2630,קריית גת,1649,677,972,135,1514,593,1563,49,5.60%
2018-10,הדרום,1034,קריית מלאכי,858,362,496,31,827,323,817,33,7.20%
2018-10,הדרום,1161,רהט,2057,858,1199,8,2049,1444,2024,39,11.34%
2018-10,הדרום,1286,שגב-שלום,318,143,175,3,315,242,310,3,12.72%
2018-10,הדרום,1031,שדרות,920,429,491,65,855,442,830,40,6.61%
2018-10,הדרום,1054,תל שבע,701,324,377,4,697,582,646,9,14.70%
2018-10,המרכז,182,אבן יהודה,161,66,95,58,103,17,158,2,2.35%
2018-10,המרכז,41,אליכין,60,28,32,14,46,12,57,0,3.05%
2018-10,המרכז,1309,אלעד,391,161,230,23,368,29,376,3,3.02%
2018-10,המרכז,2530,באר יעקב,351,137,214,98,253,33,343,8,3.74%
2018-10,המרכז,466,בית דגן,102,52,50,19,83,21,100,0,2.81%
2018-10,המרכז,1066,"בני עי""ש",132,63,69,19,113,36,124,5,3.18%
2018-10,המרכז,681,גבעת שמואל,271,133,138,113,158,26,267,0,2.24%
2018-10,המרכז,2550,גדרה,320,134,186,69,251,51,311,7,2.68%
2018-10,המרכז,627,ג'לג'וליה,69,30,39,3,66,27,63,0,1.75%
2018-10,המרכז,166,גן יבנה,330,120,210,68,262,50,322,5,2.83%
2018-10,המרכז,229,גני תקווה,196,80,116,77,119,21,195,2,2.34%
2018-10,המרכז,9700,הוד השרון,712,285,427,345,367,17,699,13,2.36%
2018-10,המרכז,1290,זמר,95,30,65,5,90,60,92,5,3.21%
2018-10,המרכז,2730,טייבה,907,446,461,31,876,529,771,33,4.65%
2018-10,המרכז,2720,טירה,151,81,70,20,131,24,145,11,1.30%
2018-10,המרכז,2660,יבנה,738,357,381,154,584,142,721,28,3.13%
2018-10,המרכז,9400,יהוד,397,171,226,99,298,38,386,9,2.45%
2018-10,המרכז,1224,כוכב יאיר,100,39,61,65,35,0,100,0,1.77%
2018-10,המרכז,633,כפר ברא,13,7,6,1,12,6,10,0,0.74%
2018-10,המרכז,168,כפר יונה,318,140,178,69,249,40,316,1,2.92%
2018-10,המרכז,6900,כפר סבא,1308,569,739,540,768,57,1291,27,2.44%
2018-10,המרכז,634,כפר קאסם,173,78,95,9,164,78,170,2,1.94%
2018-10,המרכז,7000,לוד,1612,761,851,146,1466,619,1579,42,4.55%
2018-10,המרכז,1200,מודיעין-מכבים-רעות*,877,381,496,412,465,37,867,18,2.01%
2018-10,המרכז,28,מזכרת בתיה,170,69,101,52,118,20,168,6,2.39%
2018-10,המרכז,7200,נס ציונה,598,269,329,176,422,102,584,9,2.51%
2018-10,המרכז,7400,נתניה,3960,1838,2122,576,3384,935,3874,86,3.72%
2018-10,המרכז,587,סביון*,20,7,13,10,10,0,20,0,1.03%
2018-10,המרכז,171,פרדסייה,79,30,49,24,55,3,79,1,2.19%
2018-10,המרכז,7900,פתח תקווה,3762,1711,2051,824,2938,652,3675,52,2.97%
2018-10,המרכז,195,קדימה-צורן,283,115,168,97,186,20,281,1,2.65%
2018-10,המרכז,638,קלנסווה,286,135,151,8,278,172,246,9,2.98%
2018-10,המרכז,469,קריית עקרון,224,103,121,25,199,82,212,5,3.65%
2018-10,המרכז,2640,ראש העין,952,438,514,194,758,106,941,15,4.04%
2018-10,המרכז,8300,ראשון לציון,3859,1653,2206,865,2994,704,3817,50,2.78%
2018-10,המרכז,8400,רחובות,2234,1012,1222,582,1652,531,2159,51,3.21%
2018-10,המרכז,8500,רמלה,1420,690,730,104,1316,421,1368,43,3.75%
2018-10,המרכז,8700,רעננה,759,347,412,376,383,24,754,6,2.04%
2018-10,המרכז,1304,שוהם,176,75,101,94,82,7,175,1,1.59%
2018-10,המרכז,154,תל מונד,136,57,79,50,86,10,136,0,2.21%
2018-10,הצפון,473,אבו סנאן,490,213,277,4,486,333,482,5,8.62%
2018-10,הצפון,478,אכסאל,396,188,208,17,379,319,395,0,7.16%
2018-10,הצפון,529,אעבלין,343,148,195,17,326,248,335,4,6.25%
2018-10,הצפון,482,בועיינה-נוג'ידאת,194,95,99,8,186,141,191,3,5.26%
2018-10,הצפון,4001,בוקעאתא,298,121,177,5,293,208,291,1,11.05%
2018-10,הצפון,998,ביר אל-מכסור,257,115,142,7,250,169,255,3,7.27%
2018-10,הצפון,480,בית ג'ן,343,87,256,13,330,221,329,0,6.32%
2018-10,הצפון,9200,בית שאן,703,312,391,35,668,273,679,34,6.87%
2018-10,הצפון,944,בסמת טבעון,139,68,71,3,136,85,125,6,4.02%
2018-10,הצפון,483,בענה,279,126,153,11,268,230,270,2,8.41%
2018-10,הצפון,1292,ג'דיידה-מכר,976,437,539,7,969,688,958,10,10.99%
2018-10,הצפון,485,ג'ולס,147,42,105,1,146,70,146,2,5.18%
2018-10,הצפון,487,ג'ש (גוש חלב),49,21,28,4,45,19,47,0,2.90%
2018-10,הצפון,489,דבורייה,222,97,125,11,211,154,216,3,5.29%
2018-10,הצפון,490,דייר אל-אסד,302,141,161,21,281,211,293,1,5.86%
2018-10,הצפון,492,דייר חנא,436,196,240,14,422,296,434,2,9.39%
2018-10,הצפון,975,זרזיר,187,74,113,9,178,90,184,3,6.19%
2018-10,הצפון,496,חורפיש,103,41,62,11,92,49,96,7,3.65%
2018-10,הצפון,2034,חצור הגלילית,265,106,159,24,241,97,251,6,5.35%
2018-10,הצפון,6700,טבריה,1372,641,731,100,1272,541,1222,62,5.73%
2018-10,הצפון,962,טובא-זנגרייה,248,112,136,4,244,160,241,7,8.28%
2018-10,הצפון,498,טורעאן,279,122,157,15,264,213,268,4,4.94%
2018-10,הצפון,8900,טמרה,1148,547,601,42,1106,816,1124,13,8.50%
2018-10,הצפון,1295,יאנוח-ג'ת,118,44,74,5,113,57,112,1,4.07%
2018-10,הצפון,46,יבנאל,96,52,44,11,85,33,89,0,5.80%
2018-10,הצפון,499,יפיע,430,197,233,22,408,293,426,4,5.62%
2018-10,הצפון,240,יקנעם עילית,489,226,263,106,383,83,484,28,4.19%
2018-10,הצפון,502,ירכא,348,155,193,0,348,222,343,7,6.11%
2018-10,הצפון,504,כאבול,356,187,169,10,346,266,346,4,7.60%
2018-10,הצפון,505,כאוכב אבו אל-היג'א,166,69,97,9,157,133,164,1,9.86%
2018-10,הצפון,1296,כסרא-סמיע,161,52,109,3,158,82,155,5,4.61%
2018-10,הצפון,978,כעביה-טבאש-חג'אג'רה,139,55,84,10,129,84,137,3,6.19%
2018-10,הצפון,1263,כפר ורדים,70,24,46,29,41,8,67,2,2.14%
2018-10,הצפון,507,כפר יאסיף,352,160,192,4,348,210,345,7,6.84%
2018-10,הצפון,508,כפר כמא,42,16,26,6,36,11,41,0,2.56%
2018-10,הצפון,509,כפר כנא,645,329,316,36,609,468,618,13,7.41%
2018-10,הצפון,510,כפר מנדא,557,276,281,19,538,417,549,1,7.92%
2018-10,הצפון,47,כפר תבור,39,12,27,13,26,3,38,1,1.76%
2018-10,הצפון,1139,כרמיאל,1406,577,829,315,1091,612,1295,38,5.07%
2018-10,הצפון,481,מגאר,866,367,499,24,842,607,845,5,9.67%
2018-10,הצפון,516,מג'ד אל-כרום,436,193,243,22,414,272,424,1,6.68%
2018-10,הצפון,874,מגדל העמק,814,357,457,92,722,219,767,62,5.80%
2018-10,הצפון,4201,מג'דל שמס,345,132,213,11,334,212,331,2,7.16%
2018-10,הצפון,517,מזרעה,125,55,70,4,121,80,118,1,6.20%
2018-10,הצפון,4203,מסעדה,153,56,97,7,146,111,147,3,9.10%
2018-10,הצפון,518,מעיליא,54,25,29,6,48,24,51,0,3.12%
2018-10,הצפון,1063,מעלות-תרשיחא,668,291,377,80,588,283,629,36,5.35%
2018-10,הצפון,520,משהד,140,66,74,3,137,111,135,3,4.42%
2018-10,הצפון,9100,נהרייה,1638,761,877,186,1452,727,1541,61,5.04%
2018-10,הצפון,522,נחף,318,144,174,12,306,235,310,1,6.39%
2018-10,הצפון,7300,נצרת,2299,1067,1232,135,2164,1603,2283,19,6.77%
2018-10,הצפון,1061,נצרת עילית,1291,559,732,128,1163,474,1158,93,5.00%
2018-10,הצפון,525,סאג'ור,103,40,63,6,97,65,100,1,5.68%
2018-10,הצפון,7500,סח'נין,1427,629,798,53,1374,1081,1411,12,10.67%
2018-10,הצפון,4501,ע'ג'ר,69,26,43,4,65,36,68,0,6.77%
2018-10,הצפון,530,עיילבון,134,66,68,3,131,72,131,1,4.90%
2018-10,הצפון,511,עילוט,211,88,123,0,211,162,211,1,7.81%
2018-10,הצפון,532,עין מאהל,303,162,141,11,292,215,295,5,5.90%
2018-10,הצפון,7600,עכו,2472,1083,1389,143,2329,1665,2348,36,9.08%
2018-10,הצפון,7700,עפולה,1552,664,888,211,1341,468,1462,68,5.92%
2018-10,הצפון,531,עראבה,997,463,534,41,956,786,985,11,10.34%
2018-10,הצפון,535,פסוטה,79,34,45,12,67,39,76,3,4.55%
2018-10,הצפון,536,פקיעין (בוקייעה),104,57,47,5,99,65,101,1,3.73%
2018-10,הצפון,8000,צפת,983,480,503,96,887,542,934,20,7.20%
2018-10,הצפון,4100,קצרין,187,80,107,35,152,59,177,5,4.51%
2018-10,הצפון,2800,קריית שמונה,601,270,331,63,538,198,581,27,4.54%
2018-10,הצפון,543,ראמה,202,89,113,15,187,132,194,0,5.14%
2018-10,הצפון,26,ראש פינה,45,15,30,8,37,19,42,0,2.67%
2018-10,הצפון,542,ריינה,398,202,196,18,380,270,386,8,5.91%
2018-10,הצפון,122,רמת ישי,104,35,69,38,66,16,100,2,2.42%
2018-10,הצפון,913,שבלי - אום אל-גנם,138,55,83,6,132,85,136,2,5.46%
2018-10,הצפון,812,שלומי,174,71,103,14,160,78,168,4,4.76%
2018-10,הצפון,538,שעב,328,151,177,6,322,262,324,2,11.34%
2018-10,הצפון,8800,שפרעם,1134,522,612,65,1069,744,1113,11,6.63%
2018-10,חיפה,2710,אום אל-פחם,2226,1002,1224,36,2190,1691,2180,30,11.16%
2018-10,חיפה,1020,אור עקיבא,450,189,261,57,393,88,430,9,4.35%
2018-10,חיפה,6000,באקה אל-גרביה,534,276,258,26,508,256,526,17,4.61%
2018-10,חיפה,9800,בנימינה-גבעת עדה*,178,81,97,77,101,23,177,2,2.52%
2018-10,חיפה,1326,"בסמ""ה",314,161,153,8,306,207,311,4,8.04%
2018-10,חיפה,541,ג'סר א-זרקא,169,95,74,1,168,50,162,7,2.91%
2018-10,חיפה,628,ג'ת,172,90,82,8,164,75,171,4,3.33%
2018-10,חיפה,494,דאלית אל-כרמל,378,143,235,16,362,183,355,7,4.62%
2018-10,חיפה,9300,זכרון יעקב,233,101,132,105,128,11,231,1,2.14%
2018-10,חיפה,6500,חדרה,2017,883,1134,280,1737,525,1899,26,3.89%
2018-10,חיפה,4000,חיפה,5203,2463,2740,1256,3947,2040,4886,146,3.48%
2018-10,חיפה,1247,חריש,400,146,254,102,298,38,392,3,21.35%
2018-10,חיפה,2100,טירת כרמל,619,298,321,46,573,293,590,16,5.58%
2018-10,חיפה,654,כפר קרע,353,153,200,22,331,193,346,5,4.20%
2018-10,חיפה,1327,מעלה עירון,549,233,316,10,539,410,541,10,9.86%
2018-10,חיפה,2500,נשר,395,199,196,88,307,112,378,5,2.99%
2018-10,חיפה,534,עספיא,310,126,184,24,286,142,290,6,5.33%
2018-10,חיפה,637,ערערה,470,219,251,16,454,272,458,16,5.77%
2018-10,חיפה,537,פוריידיס,172,102,70,6,166,32,172,11,3.24%
2018-10,חיפה,7800,פרדס חנה-כרכור,657,292,365,194,463,68,633,14,3.20%
2018-10,חיפה,6800,קריית אתא,1259,562,697,143,1116,491,1215,34,4.13%
2018-10,חיפה,9500,קריית ביאליק,829,349,480,139,690,280,810,24,3.83%
2018-10,חיפה,2300,קריית טבעון,185,84,101,82,103,22,179,2,2.10%
2018-10,חיפה,9600,קריית ים,1113,557,556,129,984,507,1064,39,5.09%
2018-10,חיפה,8200,קריית מוצקין,862,359,503,176,686,232,851,17,3.76%
2018-10,חיפה,922,רכסים,125,53,72,12,113,48,113,1,3.33%
2018-10,ירושלים,472,אבו גוש,201,85,116,11,190,136,198,2,6.61%
2018-10,ירושלים,2610,בית שמש,1267,502,765,97,1170,296,1219,20,3.85%
2018-10,ירושלים,3000,ירושלים,10954,4896,6058,1511,9443,5784,10657,133,3.60%
2018-10,ירושלים,1015,מבשרת ציון,292,148,144,76,216,80,286,6,2.16%
2018-10,ירושלים,1137,קריית יערים,44,19,25,14,30,8,43,1,3.27%
2018-10,תל אביב,2400,אור יהודה,660,334,326,63,597,116,636,39,3.41%
2018-10,תל אביב,565,אזור,163,84,79,27,136,18,161,2,2.52%
2018-10,תל אביב,6100,בני ברק,1722,773,949,100,1622,491,1622,14,2.94%
2018-10,תל אביב,6200,בת ים,2588,1242,1346,380,2208,705,2462,97,3.50%
2018-10,תל אביב,6300,גבעתיים,759,329,430,391,368,76,751,4,2.48%
2018-10,תל אביב,6400,הרצלייה,1144,516,628,459,685,36,1127,10,2.33%
2018-10,תל אביב,6600,חולון,2955,1330,1625,521,2434,467,2869,51,2.90%
2018-10,תל אביב,2620,קריית אונו,382,170,212,178,204,27,378,4,2.01%
2018-10,תל אביב,8600,רמת גן,2043,925,1118,803,1240,239,2011,21,2.57%
2018-10,תל אביב,2650,רמת השרון,445,185,260,202,243,9,440,1,1.95%
2018-10,תל אביב,5000,תל אביב -יפו,7386,3631,3755,3290,4096,1136,7248,91,2.88%
2018-11,אזור יהודה והשומרון,3760,אורנית,113,45,68,44,69,2,112,1,2.39%
2018-11,אזור יהודה והשומרון,3750,אלפי מנשה,95,43,52,25,70,1,95,1,2.23%
2018-11,אזור יהודה והשומרון,3560,אלקנה,39,15,24,21,18,0,39,0,2.05%
2018-11,אזור יהודה והשומרון,3650,אפרת,146,74,72,76,70,6,144,1,3.45%
2018-11,אזור יהודה והשומרון,3570,אריאל,254,115,139,71,183,13,251,9,2.41%
2018-11,אזור יהודה והשומרון,3574,בית אל,44,24,20,12,32,8,44,1,1.80%
2018-11,אזור יהודה והשומרון,3652,בית אריה,55,28,27,6,49,0,55,1,2.15%
2018-11,אזור יהודה והשומרון,3780,ביתר עילית,497,235,262,16,481,137,489,4,4.03%
2018-11,אזור יהודה והשומרון,3730,גבעת זאב,176,89,87,44,132,32,174,2,2.32%
2018-11,אזור יהודה והשומרון,3769,הר אדר,36,23,13,18,18,5,35,0,1.69%
2018-11,אזור יהודה והשומרון,3797,מודיעין עילית,430,168,262,34,396,30,426,2,3.26%
2018-11,אזור יהודה והשומרון,3616,מעלה אדומים,510,233,277,80,430,88,504,20,2.50%
2018-11,אזור יהודה והשומרון,3660,עמנואל,52,26,26,2,50,17,51,0,4.60%
2018-11,אזור יהודה והשומרון,3557,קדומים,29,16,13,19,10,0,29,0,1.56%
2018-11,אזור יהודה והשומרון,3611,קריית ארבע,73,36,37,16,57,27,71,5,2.26%
2018-11,אזור יהודה והשומרון,3640,קרני שומרון,83,43,40,31,52,2,83,4,2.28%
2018-11,הדרום,31,אופקים,810,340,470,48,762,346,776,37,6.28%
2018-11,הדרום,2600,אילת,948,482,466,50,898,208,898,39,2.73%
2018-11,הדרום,70,אשדוד,4905,2146,2759,618,4287,1818,4694,89,4.40%
2018-11,הדרום,7100,אשקלון,3340,1472,1868,365,2975,1293,3058,71,4.50%
2018-11,הדרום,9000,באר שבע,5062,2353,2709,776,4286,2358,4770,98,4.68%
2018-11,הדרום,2200,דימונה,1497,710,787,69,1428,906,1407,31,7.91%
2018-11,הדרום,1303,חורה,481,219,262,9,472,388,455,2,12.28%
2018-11,הדרום,831,ירוחם,372,181,191,18,354,201,344,16,7.67%
2018-11,הדרום,1059,כסיפה,975,378,597,4,971,873,966,1,20.97%
2018-11,הדרום,1271,להבים,62,38,24,40,22,1,62,0,1.77%
2018-11,הדרום,1060,לקיה,552,248,304,4,548,464,530,3,13.93%
2018-11,הדרום,1268,מיתר,69,23,46,37,32,5,67,0,1.57%
2018-11,הדרום,99,מצפה רמון,221,95,126,16,205,136,209,14,8.64%
2018-11,הדרום,246,נתיבות,868,385,483,53,815,343,821,46,5.97%
2018-11,הדרום,666,עומר,58,27,31,25,33,5,56,2,1.39%
2018-11,הדרום,2560,ערד,600,292,308,67,533,261,574,33,4.75%
2018-11,הדרום,1192,ערערה-בנגב,964,422,542,15,949,847,935,15,22.85%
2018-11,הדרום,2630,קריית גת,1560,680,880,122,1438,576,1486,56,5.34%
2018-11,הדרום,1034,קריית מלאכי,784,363,421,27,757,317,748,46,6.63%
2018-11,הדרום,1161,רהט,1992,822,1170,9,1983,1417,1964,44,11.04%
2018-11,הדרום,1286,שגב-שלום,311,128,183,3,308,233,300,6,12.36%
2018-11,הדרום,1031,שדרות,905,431,474,61,844,430,826,28,6.58%
2018-11,הדרום,1054,תל שבע,684,317,367,3,681,566,640,4,14.59%
2018-11,המרכז,182,אבן יהודה,156,66,90,58,98,14,155,0,2.31%
2018-11,המרכז,41,אליכין,64,29,35,16,48,13,61,1,3.25%
2018-11,המרכז,1309,אלעד,342,148,194,27,315,23,329,6,2.65%
2018-11,המרכז,2530,באר יעקב,315,121,194,88,227,29,312,3,3.42%
2018-11,המרכז,466,בית דגן,96,54,42,15,81,21,95,3,2.67%
2018-11,המרכז,1066,"בני עי""ש",138,65,73,20,118,35,129,7,3.30%
2018-11,המרכז,681,גבעת שמואל,246,115,131,98,148,27,243,1,2.04%
2018-11,המרכז,2550,גדרה,292,120,172,61,231,46,285,5,2.46%
2018-11,המרכז,627,ג'לג'וליה,71,34,37,4,67,27,70,2,1.94%
2018-11,המרכז,166,גן יבנה,307,128,179,51,256,51,297,4,2.62%
2018-11,המרכז,229,גני תקווה,178,74,104,66,112,17,178,0,2.14%
2018-11,המרכז,9700,הוד השרון,632,269,363,304,328,12,624,9,2.11%
2018-11,המרכז,1290,זמר,97,35,62,4,93,61,94,2,3.28%
2018-11,המרכז,2730,טייבה,889,437,452,26,863,540,745,26,4.50%
2018-11,המרכז,2720,טירה,126,78,48,16,110,19,120,11,1.08%
2018-11,המרכז,2660,יבנה,693,337,356,138,555,130,683,32,2.97%
2018-11,המרכז,9400,יהוד,384,185,199,94,290,34,379,16,2.40%
2018-11,המרכז,1224,כוכב יאיר,98,38,60,61,37,1,98,0,1.73%
2018-11,המרכז,633,כפר ברא,17,9,8,2,15,4,17,0,1.25%
2018-11,המרכז,168,כפר יונה,292,122,170,57,235,34,289,10,2.68%
2018-11,המרכז,6900,כפר סבא,1201,528,673,480,721,55,1186,30,2.24%
2018-11,המרכז,634,כפר קאסם,179,84,95,8,171,78,175,6,2.00%
2018-11,המרכז,7000,לוד,1574,765,809,140,1434,620,1530,40,4.42%
2018-11,המרכז,1200,מודיעין-מכבים-רעות*,816,352,464,378,438,28,801,11,1.86%
2018-11,המרכז,28,מזכרת בתיה,151,61,90,48,103,18,146,3,2.09%
2018-11,המרכז,7200,נס ציונה,559,256,303,151,408,106,548,8,2.36%
2018-11,המרכז,7400,נתניה,3792,1830,1962,548,3244,935,3718,74,3.58%
2018-11,המרכז,587,סביון*,15,5,10,9,6,0,15,0,0.78%
2018-11,המרכז,171,פרדסייה,83,33,50,27,56,3,83,0,2.30%
2018-11,המרכז,7900,פתח תקווה,3490,1610,1880,759,2731,621,3403,56,2.76%
2018-11,המרכז,195,קדימה-צורן,270,106,164,92,178,17,269,2,2.54%
2018-11,המרכז,638,קלנסווה,276,138,138,7,269,169,241,12,2.92%
2018-11,המרכז,469,קריית עקרון,209,104,105,21,188,77,203,4,3.50%
2018-11,המרכז,2640,ראש העין,863,415,448,180,683,86,854,17,3.68%
2018-11,המרכז,8300,ראשון לציון,3617,1569,2048,804,2813,651,3576,51,2.61%
2018-11,המרכז,8400,רחובות,2093,944,1149,523,1570,523,2012,53,3.00%
2018-11,המרכז,8500,רמלה,1318,645,673,94,1224,401,1279,56,3.52%
2018-11,המרכז,8700,רעננה,721,347,374,347,374,21,717,12,1.94%
2018-11,המרכז,1304,שוהם,173,74,99,86,87,6,171,0,1.55%
2018-11,המרכז,154,תל מונד,126,56,70,43,83,10,126,1,2.05%
2018-11,הצפון,473,אבו סנאן,499,224,275,5,494,326,490,3,8.75%
2018-11,הצפון,478,אכסאל,385,182,203,18,367,308,383,2,6.96%
2018-11,הצפון,529,אעבלין,350,154,196,17,333,247,341,2,6.36%
2018-11,הצפון,482,בועיינה-נוג'ידאת,206,106,100,8,198,139,202,3,5.54%
2018-11,הצפון,4001,בוקעאתא,284,110,174,4,280,194,278,1,10.61%
2018-11,הצפון,998,ביר אל-מכסור,257,116,141,7,250,171,253,3,7.22%
2018-11,הצפון,480,בית ג'ן,332,89,243,9,323,205,321,2,6.17%
2018-11,הצפון,9200,בית שאן,657,307,350,25,632,266,636,35,6.46%
2018-11,הצפון,944,בסמת טבעון,142,76,66,2,140,84,133,0,4.26%
2018-11,הצפון,483,בענה,280,121,159,10,270,227,270,2,8.41%
2018-11,הצפון,1292,ג'דיידה-מכר,935,418,517,7,928,657,921,17,10.61%
2018-11,הצפון,485,ג'ולס,143,40,103,1,142,65,142,0,5.04%
2018-11,הצפון,487,ג'ש (גוש חלב),43,21,22,2,41,18,43,3,2.66%
2018-11,הצפון,489,דבורייה,210,92,118,11,199,146,205,3,5.04%
2018-11,הצפון,490,דייר אל-אסד,305,145,160,18,287,210,294,2,5.88%
2018-11,הצפון,492,דייר חנא,436,193,243,13,423,301,433,2,9.37%
2018-11,הצפון,975,זרזיר,172,72,100,5,167,88,172,9,5.81%
2018-11,הצפון,496,חורפיש,92,42,50,10,82,45,85,1,3.24%
2018-11,הצפון,2034,חצור הגלילית,226,89,137,19,207,91,213,2,4.57%
2018-11,הצפון,6700,טבריה,1328,637,691,86,1242,543,1183,56,5.56%
2018-11,הצפון,962,טובא-זנגרייה,238,113,125,4,234,147,233,2,8.02%
2018-11,הצפון,498,טורעאן,286,129,157,20,266,208,279,5,5.14%
2018-11,הצפון,8900,טמרה,1119,536,583,38,1081,806,1101,11,8.34%
2018-11,הצפון,1295,יאנוח-ג'ת,126,48,78,5,121,56,119,3,4.32%
2018-11,הצפון,46,יבנאל,100,53,47,8,92,41,92,0,5.99%
2018-11,הצפון,499,יפיע,446,206,240,18,428,297,444,4,5.84%
2018-11,הצפון,240,יקנעם עילית,448,204,244,91,357,83,438,20,3.81%
2018-11,הצפון,502,ירכא,356,160,196,0,356,222,351,5,6.24%
2018-11,הצפון,504,כאבול,354,181,173,12,342,270,342,3,7.51%
2018-11,הצפון,505,כאוכב אבו אל-היג'א,165,68,97,7,158,134,163,2,9.81%
2018-11,הצפון,1296,כסרא-סמיע,180,65,115,4,176,86,172,5,5.09%
2018-11,הצפון,978,כעביה-טבאש-חג'אג'רה,129,53,76,10,119,83,127,0,5.77%
2018-11,הצפון,1263,כפר ורדים,64,27,37,24,40,4,63,2,2.02%
2018-11,הצפון,507,כפר יאסיף,346,154,192,4,342,212,339,4,6.73%
2018-11,הצפון,508,כפר כמא,37,14,23,5,32,11,33,0,2.07%
2018-11,הצפון,509,כפר כנא,623,320,303,35,588,467,597,14,7.17%
2018-11,הצפון,510,כפר מנדא,530,260,270,15,515,411,525,1,7.60%
2018-11,הצפון,47,כפר תבור,35,11,24,12,23,3,33,0,1.53%
2018-11,הצפון,1139,כרמיאל,1335,567,768,288,1047,602,1242,38,4.87%
2018-11,הצפון,481,מגאר,840,361,479,13,827,597,823,8,9.44%
2018-11,הצפון,516,מג'ד אל-כרום,420,185,235,18,402,266,411,0,6.49%
2018-11,הצפון,874,מגדל העמק,735,333,402,80,655,221,696,55,5.29%
2018-11,הצפון,4201,מג'דל שמס,337,129,208,11,326,210,324,6,7.02%
2018-11,הצפון,517,מזרעה,137,60,77,6,131,86,132,0,6.89%
2018-11,הצפון,4203,מסעדה,157,57,100,7,150,108,150,2,9.27%
2018-11,הצפון,518,מעיליא,54,27,27,7,47,21,53,0,3.24%
2018-11,הצפון,1063,מעלות-תרשיחא,668,287,381,92,576,271,629,36,5.35%
2018-11,הצפון,520,משהד,139,66,73,4,135,107,136,2,4.45%
2018-11,הצפון,9100,נהרייה,1617,765,852,176,1441,736,1514,58,4.96%
2018-11,הצפון,522,נחף,326,143,183,10,316,234,317,0,6.52%
2018-11,הצפון,7300,נצרת,2274,1048,1226,111,2163,1607,2261,13,6.71%
2018-11,הצפון,1061,נצרת עילית,1251,568,683,115,1136,484,1125,89,4.87%
2018-11,הצפון,525,סאג'ור,108,43,65,5,103,65,103,3,5.84%
2018-11,הצפון,7500,סח'נין,1404,609,795,58,1346,1073,1389,12,10.52%
2018-11,הצפון,4501,ע'ג'ר,70,28,42,4,66,34,69,0,6.86%
2018-11,הצפון,530,עיילבון,138,68,70,7,131,68,135,1,5.05%
2018-11,הצפון,511,עילוט,213,86,127,1,212,165,213,1,7.87%
2018-11,הצפון,532,עין מאהל,298,157,141,11,287,218,290,0,5.80%
2018-11,הצפון,7600,עכו,2447,1090,1357,148,2299,1661,2336,38,9.03%
2018-11,הצפון,7700,עפולה,1419,596,823,184,1235,455,1345,56,5.47%
2018-11,הצפון,531,עראבה,995,466,529,42,953,785,985,7,10.34%
2018-11,הצפון,535,פסוטה,76,33,43,11,65,38,71,1,4.27%
2018-11,הצפון,536,פקיעין (בוקייעה),114,60,54,10,104,58,113,3,4.16%
2018-11,הצפון,8000,צפת,1006,496,510,108,898,555,953,20,7.33%
2018-11,הצפון,4100,קצרין,174,77,97,29,145,56,167,4,4.27%
2018-11,הצפון,2800,קריית שמונה,592,270,322,54,538,189,570,25,4.45%
2018-11,הצפון,543,ראמה,216,89,127,15,201,144,207,2,5.46%
2018-11,הצפון,26,ראש פינה,50,18,32,11,39,17,48,0,3.04%
2018-11,הצפון,542,ריינה,400,207,193,21,379,269,388,9,5.94%
2018-11,הצפון,122,רמת ישי,102,36,66,39,63,15,100,4,2.42%
2018-11,הצפון,913,שבלי - אום אל-גנם,146,63,83,6,140,85,143,4,5.72%
2018-11,הצפון,812,שלומי,165,70,95,14,151,74,160,6,4.55%
2018-11,הצפון,538,שעב,325,148,177,5,320,251,321,2,11.24%
2018-11,הצפון,8800,שפרעם,1124,523,601,50,1074,752,1101,19,6.57%
2018-11,חיפה,2710,אום אל-פחם,2224,1021,1203,34,2190,1691,2176,39,11.15%
2018-11,חיפה,1020,אור עקיבא,467,192,275,61,406,93,456,15,4.60%
2018-11,חיפה,6000,באקה אל-גרביה,498,254,244,23,475,256,489,15,4.30%
2018-11,חיפה,9800,בנימינה-גבעת עדה*,157,67,90,68,89,21,157,1,2.24%
2018-11,חיפה,1326,"בסמ""ה",302,151,151,8,294,196,300,3,7.77%
2018-11,חיפה,541,ג'סר א-זרקא,175,106,69,2,173,47,168,7,3.02%
2018-11,חיפה,628,ג'ת,178,98,80,9,169,83,176,6,3.42%
2018-11,חיפה,494,דאלית אל-כרמל,377,145,232,18,359,184,355,8,4.62%
2018-11,חיפה,9300,זכרון יעקב,233,90,143,109,124,10,233,0,2.16%
2018-11,חיפה,6500,חדרה,1947,856,1091,266,1681,506,1829,45,3.75%
2018-11,חיפה,4000,חיפה,5025,2453,2572,1233,3792,1970,4726,148,3.37%
2018-11,חיפה,1247,חריש,424,150,274,136,288,50,408,1,22.03%
2018-11,חיפה,2100,טירת כרמל,621,299,322,43,578,296,594,21,5.62%
2018-11,חיפה,654,כפר קרע,333,155,178,22,311,185,325,6,3.95%
2018-11,חיפה,1327,מעלה עירון,525,241,284,14,511,392,516,8,9.44%
2018-11,חיפה,2500,נשר,370,194,176,87,283,99,359,10,2.84%
2018-11,חיפה,534,עספיא,304,127,177,22,282,139,283,6,5.21%
2018-11,חיפה,637,ערערה,452,210,242,16,436,264,440,9,5.55%
2018-11,חיפה,537,פוריידיס,193,106,87,8,185,39,193,4,3.62%
2018-11,חיפה,7800,פרדס חנה-כרכור,609,284,325,192,417,64,600,18,3.04%
2018-11,חיפה,6800,קריית אתא,1216,569,647,131,1085,464,1177,22,4.01%
2018-11,חיפה,9500,קריית ביאליק,790,353,437,123,667,291,764,33,3.62%
2018-11,חיפה,2300,קריית טבעון,178,80,98,74,104,25,173,2,2.03%
2018-11,חיפה,9600,קריית ים,1048,518,530,119,929,478,997,28,4.78%
2018-11,חיפה,8200,קריית מוצקין,813,359,454,161,652,237,795,23,3.52%
2018-11,חיפה,922,רכסים,119,51,68,14,105,39,112,2,3.31%
2018-11,ירושלים,472,אבו גוש,201,93,108,10,191,135,199,5,6.64%
2018-11,ירושלים,2610,בית שמש,1082,489,593,88,994,290,1034,39,3.29%
2018-11,ירושלים,3000,ירושלים,10608,4830,5778,1395,9213,5783,10303,159,3.49%
2018-11,ירושלים,1015,מבשרת ציון,270,134,136,67,203,78,264,5,2.00%
2018-11,ירושלים,1137,קריית יערים,45,20,25,12,33,8,45,0,3.42%
2018-11,תל אביב,2400,אור יהודה,641,335,306,61,580,115,611,39,3.28%
2018-11,תל אביב,565,אזור,173,82,91,31,142,19,170,1,2.66%
2018-11,תל אביב,6100,בני ברק,1584,776,808,94,1490,499,1478,16,2.68%
2018-11,תל אביב,6200,בת ים,2467,1181,1286,363,2104,690,2345,87,3.34%
2018-11,תל אביב,6300,גבעתיים,729,311,418,363,366,76,719,7,2.37%
2018-11,תל אביב,6400,הרצלייה,1060,474,586,400,660,32,1044,10,2.16%
2018-11,תל אביב,6600,חולון,2858,1296,1562,484,2374,472,2782,47,2.81%
2018-11,תל אביב,2620,קריית אונו,376,173,203,177,199,30,372,4,1.98%
2018-11,תל אביב,8600,רמת גן,1946,892,1054,755,1191,237,1908,25,2.45%
2018-11,תל אביב,2650,רמת השרון,425,177,248,191,234,8,420,5,1.87%
2018-11,תל אביב,5000,תל אביב -יפו,6959,3444,3515,3008,3951,1132,6816,112,2.71%
2018-12,אזור יהודה והשומרון,3760,אורנית,113,42,71,47,66,1,113,0,0.0241
2018-12,אזור יהודה והשומרון,3750,אלפי מנשה,79,31,48,24,55,2,79,0,0.0186
2018-12,אזור יהודה והשומרון,3560,אלקנה,46,20,26,24,22,0,46,0,0.0241
2018-12,אזור יהודה והשומרון,3650,אפרת,156,64,92,86,70,10,156,0,0.0373
2018-12,אזור יהודה והשומרון,3570,אריאל,243,105,138,66,177,13,240,9,0.0231
2018-12,אזור יהודה והשומרון,3574,בית אל,38,20,18,9,29,9,37,1,0.0152
2018-12,אזור יהודה והשומרון,3652,בית אריה,45,24,21,7,38,1,45,0,0.0177
2018-12,אזור יהודה והשומרון,3780,ביתר עילית,472,234,238,17,455,130,462,2,0.0381
2018-12,אזור יהודה והשומרון,3730,גבעת זאב,186,93,93,48,138,36,184,1,0.0245
2018-12,אזור יהודה והשומרון,3769,הר אדר,34,21,13,18,16,5,33,0,0.016
2018-12,אזור יהודה והשומרון,3797,מודיעין עילית,442,182,260,37,405,33,437,2,0.0334
2018-12,אזור יהודה והשומרון,3616,מעלה אדומים,498,235,263,86,412,93,493,12,0.0244
2018-12,אזור יהודה והשומרון,3660,עמנואל,48,23,25,3,45,13,48,2,0.0434
2018-12,אזור יהודה והשומרון,3557,קדומים,34,22,12,21,13,0,33,1,0.0178
2018-12,אזור יהודה והשומרון,3611,קריית ארבע,78,36,42,17,61,27,75,3,0.0238
2018-12,אזור יהודה והשומרון,3640,קרני שומרון,78,38,40,30,48,3,75,2,0.0206
2018-12,הדרום,31,אופקים,808,341,467,51,757,341,776,28,0.0628
2018-12,הדרום,2600,אילת,973,515,458,57,916,206,930,48,0.0283
2018-12,הדרום,70,אשדוד,4822,2114,2708,590,4232,1795,4618,98,0.0433
2018-12,הדרום,7100,אשקלון,3167,1459,1708,330,2837,1253,2901,60,0.0428
2018-12,הדרום,9000,באר שבע,4999,2338,2661,764,4235,2382,4702,86,0.0462
2018-12,הדרום,2200,דימונה,1496,695,801,68,1428,890,1410,30,0.0792
2018-12,הדרום,1303,חורה,489,217,272,7,482,398,459,4,0.1238
2018-12,הדרום,831,ירוחם,372,181,191,24,348,195,350,21,0.078
2018-12,הדרום,1059,כסיפה,994,391,603,3,991,885,982,10,0.2125
2018-12,הדרום,1271,להבים,64,33,31,42,22,2,64,1,0.0183
2018-12,הדרום,1060,לקיה,565,265,300,1,564,468,537,2,0.1408
2018-12,הדרום,1268,מיתר,67,23,44,38,29,5,65,2,0.0152
2018-12,הדרום,99,מצפה רמון,218,92,126,18,200,135,211,10,0.0872
2018-12,הדרום,246,נתיבות,859,383,476,54,805,350,815,40,0.0593
2018-12,הדרום,666,עומר,50,23,27,23,27,5,49,0,0.0121
2018-12,הדרום,2560,ערד,591,285,306,61,530,256,563,27,0.0466
2018-12,הדרום,1192,ערערה-בנגב,961,422,539,16,945,865,932,1,0.2279
2018-12,הדרום,2630,קריית גת,1544,695,849,125,1419,578,1472,62,0.053
2018-12,הדרום,1034,קריית מלאכי,791,359,432,31,760,310,753,32,0.0667
2018-12,הדרום,1161,רהט,2010,856,1154,9,2001,1392,1980,29,0.1112
2018-12,הדרום,1286,שגב-שלום,323,140,183,3,320,242,311,6,0.1276
2018-12,הדרום,1031,שדרות,898,440,458,64,834,426,823,29,0.0656
2018-12,הדרום,1054,תל שבע,668,317,351,7,661,543,625,8,0.1429
2018-12,המרכז,182,אבן יהודה,158,72,86,66,92,12,158,1,0.0235
2018-12,המרכז,41,אליכין,65,31,34,16,49,10,61,2,0.0325
2018-12,המרכז,1309,אלעד,333,153,180,28,305,24,324,5,0.0261
2018-12,המרכז,2530,באר יעקב,311,123,188,85,226,28,308,5,0.0338
2018-12,המרכז,466,בית דגן,92,50,42,15,77,20,91,0,0.0256
2018-12,המרכז,1066,"בני עי""ש",134,64,70,18,116,30,127,3,0.0325
2018-12,המרכז,681,גבעת שמואל,243,115,128,92,151,30,240,2,0.0202
2018-12,המרכז,2550,גדרה,287,131,156,56,231,49,279,10,0.0241
2018-12,המרכז,627,ג'לג'וליה,78,39,39,5,73,33,74,1,0.0205
2018-12,המרכז,166,גן יבנה,305,127,178,60,245,50,297,2,0.0262
2018-12,המרכז,229,גני תקווה,184,79,105,71,113,24,183,2,0.022
2018-12,המרכז,9700,הוד השרון,613,254,359,274,339,12,604,9,0.0205
2018-12,המרכז,1290,זמר,98,37,61,6,92,60,95,4,0.0331
2018-12,המרכז,2730,טייבה,878,442,436,28,850,533,751,29,0.0454
2018-12,המרכז,2720,טירה,162,98,64,15,147,22,158,13,0.0141
2018-12,המרכז,2660,יבנה,695,340,355,150,545,133,687,29,0.0298
2018-12,המרכז,9400,יהוד,384,185,199,98,286,33,379,8,0.024
2018-12,המרכז,1224,כוכב יאיר,108,40,68,65,43,1,107,3,0.0189
2018-12,המרכז,633,כפר ברא,14,8,6,0,14,3,14,1,0.0103
2018-12,המרכז,168,כפר יונה,283,125,158,55,228,32,281,4,0.0261
2018-12,המרכז,6900,כפר סבא,1128,515,613,443,685,51,1110,16,0.021
2018-12,המרכז,634,כפר קאסם,168,81,87,8,160,68,162,5,0.0185
2018-12,המרכז,7000,לוד,1489,726,763,130,1359,597,1458,38,0.0422
2018-12,המרכז,1200,מודיעין-מכבים-רעות*,794,346,448,355,439,29,783,13,0.0182
2018-12,המרכז,28,מזכרת בתיה,139,60,79,48,91,16,138,5,0.0198
2018-12,המרכז,7200,נס ציונה,548,247,301,140,408,102,535,7,0.023
2018-12,המרכז,7400,נתניה,3771,1849,1922,486,3285,912,3695,86,0.0355
2018-12,המרכז,587,סביון*,17,8,9,9,8,0,17,0,0.0088
2018-12,המרכז,171,פרדסייה,84,33,51,30,54,3,84,0,0.0233
2018-12,המרכז,7900,פתח תקווה,3403,1575,1828,739,2664,610,3330,51,0.027
2018-12,המרכז,195,קדימה-צורן,268,104,164,87,181,17,267,5,0.0253
2018-12,המרכז,638,קלנסווה,294,153,141,8,286,175,258,11,0.0312
2018-12,המרכז,469,קריית עקרון,226,123,103,15,211,82,211,10,0.0363
2018-12,המרכז,2640,ראש העין,827,390,437,167,660,82,811,13,0.035
2018-12,המרכז,8300,ראשון לציון,3607,1592,2015,772,2835,661,3563,49,0.026
2018-12,המרכז,8400,רחובות,2003,925,1078,487,1516,497,1940,50,0.029
2018-12,המרכז,8500,רמלה,1359,676,683,96,1263,420,1312,48,0.036
2018-12,המרכז,8700,רעננה,738,350,388,345,393,32,730,12,0.0197
2018-12,המרכז,1304,שוהם,173,79,94,78,95,4,170,1,0.0155
2018-12,המרכז,154,תל מונד,121,58,63,40,81,11,120,0,0.0195
2018-12,הצפון,473,אבו סנאן,476,212,264,5,471,323,468,6,0.0839
2018-12,הצפון,478,אכסאל,393,189,204,21,372,317,389,1,0.0706
2018-12,הצפון,529,אעבלין,351,152,199,17,334,248,341,6,0.0636
2018-12,הצפון,482,בועיינה-נוג'ידאת,216,113,103,9,207,143,211,3,0.0578
2018-12,הצפון,4001,בוקעאתא,289,121,168,6,283,196,281,3,0.1071
2018-12,הצפון,998,ביר אל-מכסור,254,120,134,5,249,167,252,1,0.0719
2018-12,הצפון,480,בית ג'ן,341,98,243,11,330,202,330,1,0.0634
2018-12,הצפון,9200,בית שאן,658,310,348,32,626,264,631,39,0.0641
2018-12,הצפון,944,בסמת טבעון,149,80,69,2,147,83,138,0,0.0441
2018-12,הצפון,483,בענה,300,139,161,13,287,231,289,0,0.0895
2018-12,הצפון,1292,ג'דיידה-מכר,929,419,510,8,921,654,908,11,0.1048
2018-12,הצפון,485,ג'ולס,156,47,109,2,154,69,155,3,0.0548
2018-12,הצפון,487,ג'ש (גוש חלב),41,21,20,2,39,18,40,0,0.0248
2018-12,הצפון,489,דבורייה,212,103,109,8,204,149,209,3,0.0513
2018-12,הצפון,490,דייר אל-אסד,307,142,165,17,290,210,297,0,0.0593
2018-12,הצפון,492,דייר חנא,455,207,248,13,442,312,454,2,0.0978
2018-12,הצפון,975,זרזיר,167,76,91,4,163,88,161,7,0.0546
2018-12,הצפון,496,חורפיש,93,41,52,9,84,47,85,3,0.0324
2018-12,הצפון,2034,חצור הגלילית,217,89,128,19,198,84,208,6,0.0447
2018-12,הצפון,6700,טבריה,1291,643,648,82,1209,531,1175,51,0.0552
2018-12,הצפון,962,טובא-זנגרייה,254,117,137,7,247,154,246,8,0.0843
2018-12,הצפון,498,טורעאן,297,134,163,22,275,205,292,6,0.0536
2018-12,הצפון,8900,טמרה,1101,531,570,30,1071,801,1078,16,0.0818
2018-12,הצפון,1295,יאנוח-ג'ת,122,46,76,5,117,56,117,5,0.0425
2018-12,הצפון,46,יבנאל,85,49,36,6,79,34,79,0,0.0518
2018-12,הצפון,499,יפיע,447,207,240,19,428,295,443,2,0.0583
2018-12,הצפון,240,יקנעם עילית,428,194,234,91,337,79,419,25,0.0365
2018-12,הצפון,502,ירכא,360,163,197,1,359,210,356,3,0.0632
2018-12,הצפון,504,כאבול,353,176,177,7,346,269,336,4,0.0739
2018-12,הצפון,505,כאוכב אבו אל-היג'א,152,60,92,5,147,125,151,3,0.0915
2018-12,הצפון,1296,כסרא-סמיע,188,69,119,9,179,81,178,9,0.0526
2018-12,הצפון,978,כעביה-טבאש-חג'אג'רה,150,65,85,10,140,88,149,3,0.067
2018-12,הצפון,1263,כפר ורדים,54,24,30,21,33,2,53,0,0.017
2018-12,הצפון,507,כפר יאסיף,348,150,198,5,343,212,339,5,0.0673
2018-12,הצפון,508,כפר כמא,41,16,25,5,36,11,37,1,0.0232
2018-12,הצפון,509,כפר כנא,631,329,302,38,593,470,608,8,0.073
2018-12,הצפון,510,כפר מנדא,559,277,282,15,544,419,551,3,0.0795
2018-12,הצפון,47,כפר תבור,38,11,27,11,27,2,37,1,0.0171
2018-12,הצפון,1139,כרמיאל,1335,588,747,280,1055,599,1238,40,0.0486
2018-12,הצפון,481,מגאר,846,369,477,17,829,604,830,10,0.0951
2018-12,הצפון,516,מג'ד אל-כרום,433,187,246,15,418,271,425,1,0.067
2018-12,הצפון,874,מגדל העמק,728,352,376,70,658,209,686,58,0.0522
2018-12,הצפון,4201,מג'דל שמס,337,135,202,8,329,204,320,3,0.0694
2018-12,הצפון,517,מזרעה,136,58,78,5,131,85,130,3,0.0679
2018-12,הצפון,4203,מסעדה,159,56,103,7,152,105,154,3,0.0949
2018-12,הצפון,518,מעיליא,50,26,24,9,41,19,48,0,0.0294
2018-12,הצפון,1063,מעלות-תרשיחא,664,306,358,96,568,264,629,31,0.0535
2018-12,הצפון,520,משהד,138,63,75,4,134,106,135,5,0.0442
2018-12,הצפון,9100,נהרייה,1605,772,833,161,1444,726,1510,54,0.0495
2018-12,הצפון,522,נחף,354,157,197,11,343,246,346,1,0.0707
2018-12,הצפון,7300,נצרת,2236,1033,1203,109,2127,1583,2223,17,0.0661
2018-12,הצפון,1061,נצרת עילית,1212,564,648,117,1095,474,1103,75,0.0478
2018-12,הצפון,525,סאג'ור,113,45,68,6,107,65,109,1,0.0616
2018-12,הצפון,7500,סח'נין,1414,635,779,51,1363,1067,1397,11,0.1057
2018-12,הצפון,4501,ע'ג'ר,79,34,45,5,74,37,78,0,0.0768
2018-12,הצפון,530,עיילבון,140,67,73,7,133,72,138,0,0.0515
2018-12,הצפון,511,עילוט,210,86,124,1,209,160,210,0,0.0777
2018-12,הצפון,532,עין מאהל,313,167,146,11,302,221,304,1,0.0607
2018-12,הצפון,7600,עכו,2411,1096,1315,152,2259,1641,2297,31,0.089
2018-12,הצפון,7700,עפולה,1426,621,805,185,1241,441,1347,54,0.0548
2018-12,הצפון,531,עראבה,994,467,527,35,959,779,983,9,0.1032
2018-12,הצפון,535,פסוטה,74,32,42,15,59,36,70,1,0.0421
2018-12,הצפון,536,פקיעין (בוקייעה),107,56,51,9,98,59,106,2,0.0391
2018-12,הצפון,8000,צפת,972,490,482,103,869,521,929,19,0.0716
2018-12,הצפון,4100,קצרין,178,80,98,33,145,58,171,2,0.0437
2018-12,הצפון,2800,קריית שמונה,591,271,320,61,530,187,568,34,0.0444
2018-12,הצפון,543,ראמה,213,94,119,18,195,137,203,2,0.0536
2018-12,הצפון,26,ראש פינה,48,19,29,11,37,19,46,0,0.0292
2018-12,הצפון,542,ריינה,402,215,187,18,384,266,392,5,0.0599
2018-12,הצפון,122,רמת ישי,102,42,60,39,63,13,101,2,0.0244
2018-12,הצפון,913,שבלי - אום אל-גנם,150,71,79,7,143,83,146,3,0.0584
2018-12,הצפון,812,שלומי,166,73,93,14,152,76,161,5,0.0458
2018-12,הצפון,538,שעב,342,157,185,5,337,255,339,3,0.118
2018-12,הצפון,8800,שפרעם,1126,518,608,49,1077,744,1095,17,0.0653
2018-12,חיפה,2710,אום אל-פחם,2247,1042,1205,34,2213,1694,2194,33,0.1123
2018-12,חיפה,1020,אור עקיבא,455,202,253,58,397,98,442,17,0.0447
2018-12,חיפה,6000,באקה אל-גרביה,502,262,240,20,482,255,494,20,0.0434
2018-12,חיפה,9800,בנימינה-גבעת עדה*,167,71,96,77,90,16,165,3,0.0235
2018-12,חיפה,1326,"בסמ""ה",305,157,148,7,298,196,300,8,0.0777
2018-12,חיפה,541,ג'סר א-זרקא,173,104,69,2,171,43,168,6,0.0302
2018-12,חיפה,628,ג'ת,177,101,76,14,163,81,176,6,0.0342
2018-12,חיפה,494,דאלית אל-כרמל,398,157,241,20,378,193,374,5,0.0485
2018-12,חיפה,9300,זכרון יעקב,221,92,129,102,119,15,220,2,0.0204
2018-12,חיפה,6500,חדרה,1863,846,1017,241,1622,506,1764,35,0.0362
2018-12,חיפה,4000,חיפה,4898,2413,2485,1202,3696,1955,4604,154,0.0329
2018-12,חיפה,1247,חריש,404,146,258,118,286,48,394,4,0.2144
2018-12,חיפה,2100,טירת כרמל,627,317,310,42,585,298,603,17,0.057
2018-12,חיפה,654,כפר קרע,337,160,177,25,312,177,330,7,0.0401
2018-12,חיפה,1327,מעלה עירון,520,243,277,11,509,389,511,10,0.0936
2018-12,חיפה,2500,נשר,359,180,179,86,273,98,340,4,0.027
2018-12,חיפה,534,עספיא,318,135,183,23,295,135,299,6,0.0549
2018-12,חיפה,637,ערערה,463,221,242,19,444,263,450,9,0.0567
2018-12,חיפה,537,פוריידיס,201,114,87,8,193,41,196,4,0.0368
2018-12,חיפה,7800,פרדס חנה-כרכור,591,265,326,185,406,58,580,14,0.0294
2018-12,חיפה,6800,קריית אתא,1228,591,637,127,1101,467,1192,39,0.0406
2018-12,חיפה,9500,קריית ביאליק,767,329,438,121,646,285,748,27,0.0354
2018-12,חיפה,2300,קריית טבעון,182,84,98,76,106,19,182,2,0.0214
2018-12,חיפה,9600,קריית ים,1026,499,527,103,923,478,978,29,0.047
2018-12,חיפה,8200,קריית מוצקין,815,361,454,164,651,231,790,19,0.035
2018-12,חיפה,922,רכסים,115,53,62,16,99,38,108,1,0.0319
2018-12,ירושלים,472,אבו גוש,203,97,106,9,194,145,200,2,0.0667
2018-12,ירושלים,2610,בית שמש,1072,485,587,78,994,281,1031,40,0.0328
2018-12,ירושלים,3000,ירושלים,10565,4851,5714,1391,9174,5822,10286,132,0.0348
2018-12,ירושלים,1015,מבשרת ציון,286,149,137,71,215,72,282,4,0.0213
2018-12,ירושלים,1137,קריית יערים,39,16,23,10,29,7,38,0,0.029
2018-12,תל אביב,2400,אור יהודה,647,320,327,68,579,119,607,35,0.0326
2018-12,תל אביב,565,אזור,168,77,91,29,139,14,165,3,0.0258
2018-12,תל אביב,6100,בני ברק,1538,760,778,93,1445,484,1439,22,0.0261
2018-12,תל אביב,6200,בת ים,2453,1191,1262,351,2102,694,2330,77,0.0332
2018-12,תל אביב,6300,גבעתיים,709,312,397,351,358,81,696,4,0.023
2018-12,תל אביב,6400,הרצלייה,1043,476,567,409,634,27,1034,12,0.0214
2018-12,תל אביב,6600,חולון,2788,1245,1543,461,2327,472,2718,46,0.0275
2018-12,תל אביב,2620,קריית אונו,368,173,195,170,198,28,363,6,0.0193
2018-12,תל אביב,8600,רמת גן,1844,844,1000,733,1111,224,1809,38,0.0232
2018-12,תל אביב,2650,רמת השרון,416,168,248,181,235,7,410,1,0.0182
2018-12,תל אביב,5000,תל אביב -יפו,6884,3425,3459,3041,3843,1088,6742,100,0.0268
